""	"Ident"
"AAACCTGCACCAGGCT"	"TPC_3"
"AAACCTGCAGCATGAG"	"TPC_3"
"AAACCTGCAGCTGGCT"	"TPC_1"
"AAACCTGGTAAATACG"	"DCT-like_2"
"AAACCTGGTAGAAAGG"	"DCT-like_1"
"AAACGGGAGCAGACTG"	"DCT-like_2"
"AAACGGGCATGAACCT"	"Prolif.TPC"
"AAACGGGGTCATGCAT"	"TPC_3"
"AAACGGGGTCGGATCC"	"DCT-like_1"
"AAACGGGTCATCGCTC"	"TPC_3"
"AAACGGGTCGGTCCGA"	"TPC_1"
"AAACGGGTCTCAAACG"	"DCT-like_1"
"AAAGATGGTGCTAGCC"	"TPC_1"
"AAAGATGTCTGGAGCC"	"DCT-like_1"
"AAAGCAAAGGGTGTTG"	"TPC_2"
"AAAGCAACAGTCGTGC"	"DCT-like_1"
"AAAGCAACATTTGCTT"	"TPC_2"
"AAAGCAAGTTGACGTT"	"TPC_1"
"AAAGTAGAGAAGGTTT"	"DCT-like_1"
"AAAGTAGCAGACGTAG"	"DCT-like_2"
"AAAGTAGCATTTGCCC"	"DCT-like_2"
"AAAGTAGTCATCACCC"	"TPC_2"
"AAATGCCAGCTTTGGT"	"Epith.:HighMT"
"AAATGCCCACCCTATC"	"TPC_2"
"AAATGCCCAGGGTTAG"	"TPC_2"
"AAATGCCCATGGAATA"	"Epith.:HighRibo"
"AAATGCCCATGTCGAT"	"TPC_1"
"AAATGCCGTGCGATAG"	"DCT-like_1"
"AACACGTCAGACGCCT"	"DCT-like_1"
"AACACGTGTGTCTGAT"	"Prolif.TPC"
"AACACGTTCCTATGTT"	"DCT-like_1"
"AACACGTTCCTTCAAT"	"Prolif.TPC"
"AACACGTTCTGTCTCG"	"DCT-like_2"
"AACCATGAGGAGTTGC"	"TPC_1"
"AACCATGCAGGTGCCT"	"DCT-like_1"
"AACCATGCATCCGCGA"	"Epith.:HighMT"
"AACCATGCATTTCACT"	"TPC_1"
"AACCATGGTATGAAAC"	"Prolif.TPC"
"AACCATGGTCGGCTCA"	"DCT-like_1"
"AACCATGTCGGAATCT"	"Prolif.TPC"
"AACCGCGAGGAGTACC"	"DCT-like_2"
"AACCGCGCAAGCCTAT"	"TPC_1"
"AACCGCGTCTGCCAGG"	"PEC-like_1"
"AACGTTGAGTTGTCGT"	"TPC_1"
"AACGTTGCACGGCTAC"	"TPC_3"
"AACGTTGCAGTACACT"	"Prolif.TPC"
"AACGTTGCATTGGGCC"	"TPC_3"
"AACTCAGAGAATCTCC"	"Prolif.TPC"
"AACTCAGAGATAGCAT"	"PEC-like_1"
"AACTCAGAGGCTAGGT"	"PEC-like_1"
"AACTCAGGTCTAGCGC"	"PEC-like_1"
"AACTCAGTCCAGAGGA"	"TPC_1"
"AACTCAGTCCGAATGT"	"TPC_1"
"AACTCCCAGGGCTCTC"	"TPC_3"
"AACTCCCCATTAGGCT"	"DCT-like_2"
"AACTCCCGTGCCTTGG"	"TPC_3"
"AACTCCCTCAGCTCTC"	"TPC_1"
"AACTCCCTCGAACGGA"	"DCT-like_2"
"AACTCCCTCGAGCCCA"	"TPC_1"
"AACTCTTAGTCGTTTG"	"TPC_2"
"AACTCTTAGTGGTAAT"	"DCT-like_2"
"AACTCTTAGTGTTGAA"	"Prolif.TPC"
"AACTCTTCAGCTGTTA"	"DCT-like_1"
"AACTCTTGTATGAAAC"	"DCT-like_2"
"AACTCTTGTTGATTCG"	"DCT-like_2"
"AACTCTTTCTTGTTTG"	"Prolif.TPC"
"AACTGGTAGACGCACA"	"PEC-like_2"
"AACTGGTAGTGAAGAG"	"DCT-like_2"
"AACTGGTAGTTGAGAT"	"DCT-like_2"
"AACTGGTCACGGCCAT"	"PEC-like_1"
"AACTGGTCATTGGTAC"	"DCT-like_1"
"AACTTTCAGAGCAATT"	"PEC-like_2"
"AACTTTCCACGTAAGG"	"DCT-like_2"
"AACTTTCCACTGTCGG"	"Prolif.TPC"
"AACTTTCCATCACAAC"	"TPC_1"
"AACTTTCCATCGGGTC"	"TPC_3"
"AAGACCTCAAGGGTCA"	"TPC_2"
"AAGCCGCAGACAGACC"	"TPC_1"
"AAGCCGCAGAGAGCTC"	"TPC_1"
"AAGCCGCAGTGAATTG"	"Epith.:HighRibo"
"AAGCCGCGTCCAGTAT"	"Epith.:HighRibo"
"AAGCCGCGTCTCACCT"	"DCT-like_2"
"AAGCCGCTCGAGCCCA"	"TPC_3"
"AAGGAGCAGGGAAACA"	"Prolif.TPC"
"AAGGAGCCATACTCTT"	"Epith.:HighRibo"
"AAGGAGCTCGCCATAA"	"Epith.:HighMT"
"AAGGCAGAGCATCATC"	"DCT-like_2"
"AAGGCAGCAAGCGATG"	"TPC_3"
"AAGGCAGGTCAACTGT"	"TPC_1"
"AAGGCAGGTCTTCGTC"	"TPC_1"
"AAGGCAGGTGGACGAT"	"TPC_1"
"AAGGCAGTCCTTCAAT"	"TPC_2"
"AAGGCAGTCGCGGATC"	"TPC_3"
"AAGGTTCAGAGCTTCT"	"TPC_1"
"AAGGTTCAGGCGACAT"	"DCT-like_2"
"AAGGTTCCAATGGATA"	"TPC_2"
"AAGGTTCCATTATCTC"	"TPC_1"
"AAGGTTCTCACTTCAT"	"Epith.:HighRibo"
"AAGTCTGCAAGGACAC"	"PEC-like_2"
"AAGTCTGCAATGCCAT"	"DCT-like_1"
"AAGTCTGCAGGCGATA"	"DCT-like_1"
"AAGTCTGCATCGACGC"	"TPC_2"
"AAGTCTGGTACCGCTG"	"TPC_2"
"AAGTCTGGTCGTTGTA"	"TPC_1"
"AAGTCTGGTTTGACTG"	"DCT-like_1"
"AAGTCTGTCGAATCCA"	"TPC_1"
"AATCCAGCACATCCGG"	"TPC_3"
"AATCCAGCAGTAAGCG"	"TPC_3"
"AATCCAGTCTAACTTC"	"Epith.:HighMT"
"AATCGGTAGGGCATGT"	"Prolif.TPC"
"AATCGGTCAGCGTCCA"	"DCT-like_2"
"AATCGGTCATAGACTC"	"TPC_3"
"AATCGGTGTAGGGTAC"	"TPC_1"
"AATCGGTGTGAGGCTA"	"TPC_3"
"AATCGGTGTTCTGGTA"	"DCT-like_1"
"AATCGGTTCACCGGGT"	"TPC_1"
"ACACCAAAGGCTATCT"	"DCT-like_1"
"ACACCAAAGTTGAGAT"	"DCT-like_2"
"ACACCAACAGGTCTCG"	"DCT-like_2"
"ACACCAAGTCACTTCC"	"DCT-like_2"
"ACACCAAGTCTCTTTA"	"TPC_1"
"ACACCAATCTGGCGTG"	"TPC_3"
"ACACCAATCTTGTTTG"	"TPC_1"
"ACACCCTAGAGAACAG"	"TPC_2"
"ACACCCTAGAGGGATA"	"TPC_3"
"ACACCCTAGATGTGTA"	"Epith.:HighRibo"
"ACACCCTAGGTAGCTG"	"DCT-like_2"
"ACACCCTCAAGTAATG"	"TPC_3"
"ACACCCTCAGAGTGTG"	"TPC_1"
"ACACCCTCAGCCTTGG"	"TPC_2"
"ACACCCTGTAGTACCT"	"DCT-like_1"
"ACACCCTTCACTTACT"	"DCT-like_1"
"ACACCCTTCGAGAGCA"	"PEC-like_1"
"ACACCCTTCGCCAAAT"	"DCT-like_2"
"ACACCCTTCGCTTGTC"	"TPC_3"
"ACACCGGAGCTTATCG"	"DCT-like_1"
"ACACCGGAGTATCGAA"	"PEC-like_1"
"ACACCGGAGTTCGCGC"	"DCT-like_1"
"ACACTGAGTTAAGACA"	"Epith.:HighMT"
"ACAGCCGAGCTAGTCT"	"TPC_2"
"ACAGCCGCATATGCTG"	"Prolif.TPC"
"ACAGCCGGTACTTAGC"	"Prolif.TPC"
"ACAGCCGTCACCACCT"	"Prolif.TPC"
"ACAGCCGTCTCGTTTA"	"TPC_2"
"ACAGCTAAGCGTGAAC"	"PEC-like_1"
"ACAGCTAGTGATAAAC"	"DCT-like_2"
"ACAGCTAGTTCCACGG"	"Prolif.TPC"
"ACAGCTATCTGGTTCC"	"DCT-like_2"
"ACATACGCAGCCTTGG"	"DCT-like_1"
"ACATACGGTCAGATAA"	"TPC_2"
"ACATACGGTGCAACGA"	"TPC_2"
"ACATACGTCCCTCAGT"	"Epith.:HighRibo"
"ACATACGTCTCGCTTG"	"TPC_1"
"ACATCAGAGACACTAA"	"TPC_1"
"ACATCAGTCAACGGCC"	"TPC_2"
"ACATGGTAGACCCACC"	"TPC_1"
"ACATGGTAGAGTAAGG"	"TPC_1"
"ACATGGTAGGAATCGC"	"TPC_1"
"ACATGGTGTAGCGTGA"	"DCT-like_2"
"ACATGGTGTGTATGGG"	"TPC_1"
"ACCAGTACAGACACTT"	"DCT-like_1"
"ACCAGTAGTTATTCTC"	"TPC_2"
"ACCAGTATCTGGTGTA"	"Epith.:HighMT"
"ACCCACTAGTGTCTCA"	"TPC_1"
"ACCCACTCAATCCAAC"	"DCT-like_1"
"ACCCACTTCCACTCCA"	"TPC_1"
"ACCCACTTCCTGTAGA"	"TPC_2"
"ACCCACTTCTTGACGA"	"TPC_2"
"ACCGTAATCGTTGACA"	"DCT-like_2"
"ACCTTTACAAGCTGGA"	"TPC_2"
"ACCTTTACAGTAAGCG"	"DCT-like_2"
"ACCTTTACATCAGTAC"	"Prolif.TPC"
"ACCTTTAGTCTTGTCC"	"PEC-like_2"
"ACCTTTATCAAACAAG"	"TPC_1"
"ACCTTTATCAACACTG"	"TPC_1"
"ACGAGCCAGCACCGTC"	"TPC_1"
"ACGAGCCAGCCGATTT"	"TPC_1"
"ACGAGCCCAGGGAGAG"	"DCT-like_2"
"ACGAGCCGTGAGGGAG"	"TPC_2"
"ACGAGCCTCAAGAAGT"	"DCT-like_1"
"ACGAGGAAGCATGGCA"	"TPC_2"
"ACGAGGAAGCCAGAAC"	"DCT-like_2"
"ACGAGGAAGGTAAACT"	"TPC_2"
"ACGAGGATCAAGATCC"	"DCT-like_1"
"ACGAGGATCACTTATC"	"TPC_1"
"ACGAGGATCTGATTCT"	"TPC_1"
"ACGATACAGCAGATCG"	"TPC_3"
"ACGATACGTACAGACG"	"Prolif.TPC"
"ACGATACTCGTAGATC"	"DCT-like_1"
"ACGATACTCTCTTATG"	"TPC_3"
"ACGATGTAGGCGCTCT"	"TPC_2"
"ACGATGTAGGTGCAAC"	"TPC_3"
"ACGATGTCACCAGGTC"	"DCT-like_1"
"ACGATGTCACGACTCG"	"DCT-like_1"
"ACGATGTCATCCGTGG"	"TPC_1"
"ACGCAGCAGAGTGAGA"	"PEC-like_1"
"ACGCAGCCAGCCTTTC"	"PEC-like_1"
"ACGCAGCCATCTCCCA"	"TPC_1"
"ACGCAGCTCCCAACGG"	"TPC_1"
"ACGCAGCTCGACCAGC"	"TPC_1"
"ACGCCAGCACCGGAAA"	"Epith.:HighRibo"
"ACGCCAGGTCCCTTGT"	"PEC-like_2"
"ACGCCGAAGATCTGCT"	"Prolif.TPC"
"ACGCCGAAGCTCAACT"	"TPC_2"
"ACGCCGAAGGATGGTC"	"DCT-like_2"
"ACGCCGAAGGCCCTCA"	"TPC_2"
"ACGCCGAAGGCGCTCT"	"TPC_2"
"ACGCCGACAGGTCCAC"	"DCT-like_2"
"ACGGAGAAGCGATATA"	"TPC_2"
"ACGGAGAGTCCGAACC"	"DCT-like_1"
"ACGGAGAGTCGACTAT"	"Epith.:HighMT"
"ACGGAGATCTTCGAGA"	"TPC_1"
"ACGGCCAAGTACGACG"	"TPC_3"
"ACGGCCACAGACACTT"	"TPC_2"
"ACGGCCACATAGAAAC"	"TPC_1"
"ACGGCCAGTAAGTTCC"	"Prolif.TPC"
"ACGGCCAGTAATCGTC"	"DCT-like_2"
"ACGGCCATCCACGAAT"	"DCT-like_2"
"ACGGGCTCAAAGTCAA"	"TPC_1"
"ACGGGCTCACCCAGTG"	"DCT-like_1"
"ACGGGCTGTCACCTAA"	"TPC_1"
"ACGGGCTTCATATCGG"	"TPC_2"
"ACGGGTCAGGGAAACA"	"DCT-like_1"
"ACGGGTCGTACCCAAT"	"TPC_2"
"ACGTCAAAGCTGCGAA"	"Prolif.TPC"
"ACGTCAACATGGATGG"	"TPC_3"
"ACTATCTAGCTAACAA"	"DCT-like_2"
"ACTATCTGTCGCGGTT"	"DCT-like_2"
"ACTATCTTCAAGGCTT"	"DCT-like_2"
"ACTATCTTCATTATCC"	"Epith.:HighMT"
"ACTATCTTCCATTCTA"	"DCT-like_2"
"ACTGAACAGCTATGCT"	"DCT-like_1"
"ACTGAACAGCTGTTCA"	"DCT-like_1"
"ACTGAACAGGTGATTA"	"PEC-like_1"
"ACTGAACCACACTGCG"	"TPC_1"
"ACTGAACCACAGTCGC"	"DCT-like_1"
"ACTGAACCACCTCGGA"	"TPC_3"
"ACTGAACGTACAGACG"	"TPC_1"
"ACTGAACGTACGACCC"	"DCT-like_2"
"ACTGAACGTCCTGCTT"	"TPC_3"
"ACTGAACTCAGGTAAA"	"Prolif.TPC"
"ACTGAGTGTATATGGA"	"Prolif.TPC"
"ACTGAGTGTTCCACAA"	"TPC_3"
"ACTGAGTGTTCTGTTT"	"TPC_3"
"ACTGAGTTCCGTCAAA"	"TPC_1"
"ACTGAGTTCGTCACGG"	"TPC_3"
"ACTGATGAGCTAGGCA"	"DCT-like_1"
"ACTGATGCAACACGCC"	"DCT-like_2"
"ACTGATGGTGTGGCTC"	"DCT-like_2"
"ACTGATGGTTCTGGTA"	"Epith.:HighRibo"
"ACTGATGTCAACGAAA"	"Prolif.TPC"
"ACTGATGTCACAGGCC"	"PEC-like_1"
"ACTGCTCAGTGTCTCA"	"TPC_1"
"ACTGCTCCAATGACCT"	"TPC_2"
"ACTGCTCCATATGGTC"	"TPC_3"
"ACTGCTCGTCATGCAT"	"TPC_1"
"ACTGTCCAGAAACGAG"	"DCT-like_1"
"ACTGTCCAGCGTTGCC"	"TPC_1"
"ACTGTCCTCGAACGGA"	"PEC-like_1"
"ACTGTCCTCTGCTGCT"	"TPC_1"
"ACTTACTCAGGCGATA"	"DCT-like_1"
"ACTTACTGTTGCGCAC"	"TPC_2"
"ACTTGTTAGTTCGCGC"	"DCT-like_1"
"ACTTGTTTCAGTTTGG"	"TPC_1"
"ACTTTCAAGGAGCGAG"	"Epith.:HighRibo"
"ACTTTCAAGGAGTCTG"	"PEC-like_1"
"ACTTTCACAATGGACG"	"TPC_1"
"ACTTTCACACCGAATT"	"TPC_1"
"ACTTTCACACGGCTAC"	"TPC_3"
"ACTTTCAGTCGCGAAA"	"TPC_1"
"ACTTTCAGTTACGGAG"	"DCT-like_1"
"ACTTTCATCAGAGACG"	"DCT-like_1"
"ACTTTCATCAGGTTCA"	"DCT-like_2"
"AGAATAGAGTCATCCA"	"DCT-like_2"
"AGAATAGCAAAGAATC"	"TPC_1"
"AGAATAGCAAGACACG"	"PEC-like_2"
"AGAATAGCACCCATGG"	"DCT-like_1"
"AGAATAGCACGAGAGT"	"DCT-like_2"
"AGAATAGCATGCCCGA"	"TPC_2"
"AGAATAGTCTTACCTA"	"DCT-like_2"
"AGACGTTCACATGGGA"	"TPC_3"
"AGACGTTCACTCTGTC"	"TPC_2"
"AGACGTTGTACCGGCT"	"DCT-like_1"
"AGACGTTTCCCAACGG"	"PEC-like_1"
"AGACGTTTCGATCCCT"	"TPC_1"
"AGACGTTTCTGCGTAA"	"TPC_3"
"AGAGCGAGTATATCCG"	"DCT-like_2"
"AGAGCGAGTTTAGGAA"	"DCT-like_2"
"AGAGCTTAGGACACCA"	"DCT-like_2"
"AGAGCTTGTAAATGAC"	"TPC_2"
"AGAGCTTGTCAATGTC"	"DCT-like_2"
"AGAGTGGCAATAGCGG"	"TPC_1"
"AGAGTGGGTAGAGGAA"	"TPC_2"
"AGAGTGGGTCAAAGAT"	"DCT-like_2"
"AGAGTGGGTGCCTTGG"	"TPC_1"
"AGATCTGAGAAGGTGA"	"PEC-like_1"
"AGATCTGGTATCAGTC"	"DCT-like_1"
"AGATCTGGTTCAGTAC"	"TPC_1"
"AGATCTGGTTGCCTCT"	"TPC_1"
"AGATTGCAGATATACG"	"TPC_1"
"AGATTGCCAGGAACGT"	"TPC_1"
"AGATTGCGTACTTGAC"	"Epith.:HighRibo"
"AGATTGCTCCGCATAA"	"DCT-like_2"
"AGCAGCCAGCGTAATA"	"TPC_3"
"AGCAGCCAGCTGAAAT"	"DCT-like_2"
"AGCAGCCAGTGCGATG"	"TPC_1"
"AGCAGCCGTCGGGTCT"	"Prolif.TPC"
"AGCATACAGAGCTTCT"	"Prolif.TPC"
"AGCATACCATTCCTGC"	"DCT-like_2"
"AGCATACTCAACCATG"	"TPC_1"
"AGCATACTCGCCCTTA"	"Epith.:HighMT"
"AGCATACTCGTCCGTT"	"DCT-like_2"
"AGCCTAAAGAAACCTA"	"DCT-like_2"
"AGCCTAAAGATGTTAG"	"TPC_3"
"AGCCTAACACGGCTAC"	"TPC_1"
"AGCCTAAGTACAAGTA"	"Prolif.TPC"
"AGCCTAAGTACAGTTC"	"TPC_1"
"AGCCTAAGTACCGTAT"	"TPC_2"
"AGCCTAATCAATACCG"	"DCT-like_1"
"AGCCTAATCGCATGGC"	"TPC_1"
"AGCCTAATCTCACATT"	"DCT-like_1"
"AGCGGTCCAAGGACTG"	"PEC-like_2"
"AGCGGTCCATATACCG"	"DCT-like_1"
"AGCGGTCCATCCGTGG"	"TPC_2"
"AGCGGTCCATCTCCCA"	"TPC_1"
"AGCGGTCGTGCGGTAA"	"DCT-like_2"
"AGCGGTCTCTCTAAGG"	"TPC_1"
"AGCGTATAGAGACTTA"	"DCT-like_2"
"AGCGTATAGCTAGTGG"	"DCT-like_2"
"AGCGTATAGGAGTCTG"	"Prolif.TPC"
"AGCGTATCAGTATAAG"	"TPC_3"
"AGCGTATGTGCACCAC"	"DCT-like_2"
"AGCGTATGTTGTCTTT"	"TPC_1"
"AGCGTCGAGCCTCGTG"	"Prolif.TPC"
"AGCGTCGAGGTTCCTA"	"DCT-like_1"
"AGCGTCGAGTACTTGC"	"TPC_3"
"AGCGTCGGTGTGACGA"	"Prolif.TPC"
"AGCTCCTAGAAGCCCA"	"TPC_2"
"AGCTCCTAGACTAAGT"	"TPC_2"
"AGCTCCTGTGTCAATC"	"TPC_1"
"AGCTCCTTCAACGGCC"	"TPC_3"
"AGCTCTCAGCCGCCTA"	"TPC_1"
"AGCTCTCCACGGCGTT"	"TPC_3"
"AGCTCTCGTAGTGAAT"	"DCT-like_2"
"AGCTTGACAACTGCTA"	"PEC-like_1"
"AGCTTGACATCGGACC"	"DCT-like_2"
"AGCTTGAGTTCGCGAC"	"Prolif.TPC"
"AGCTTGATCATCGGAT"	"DCT-like_2"
"AGCTTGATCGGAAACG"	"DCT-like_1"
"AGCTTGATCTAAGCCA"	"TPC_3"
"AGCTTGATCTATGTGG"	"TPC_3"
"AGGCCACAGTACGTTC"	"TPC_3"
"AGGCCACAGTGAAGAG"	"TPC_1"
"AGGCCACCAGAAGCAC"	"PEC-like_1"
"AGGCCACCAGACACTT"	"TPC_1"
"AGGCCACGTAAAGTCA"	"TPC_3"
"AGGCCACTCTCGTTTA"	"TPC_1"
"AGGCCGTAGAAGATTC"	"DCT-like_2"
"AGGCCGTAGGTAGCTG"	"DCT-like_2"
"AGGCCGTGTCCGAGTC"	"TPC_1"
"AGGCCGTGTGTGCGTC"	"Prolif.TPC"
"AGGCCGTGTTCCAACA"	"DCT-like_1"
"AGGCCGTTCTGTTGAG"	"TPC_1"
"AGGGAGTAGGTGATAT"	"DCT-like_1"
"AGGGAGTGTAAGTAGT"	"DCT-like_2"
"AGGGAGTTCACCAGGC"	"TPC_3"
"AGGGAGTTCGATGAGG"	"TPC_1"
"AGGGATGAGTTCGATC"	"TPC_2"
"AGGGATGCACCACCAG"	"DCT-like_2"
"AGGGATGGTCGCCATG"	"TPC_1"
"AGGGATGGTTGGACCC"	"TPC_2"
"AGGGATGTCCCAACGG"	"DCT-like_1"
"AGGGTGAAGAGTCGGT"	"Prolif.TPC"
"AGGGTGAAGATGTGGC"	"TPC_2"
"AGGGTGACACGCCAGT"	"TPC_1"
"AGGGTGACAGGGAGAG"	"TPC_2"
"AGGGTGACATAGTAAG"	"TPC_1"
"AGGGTGAGTCGATTGT"	"Prolif.TPC"
"AGGGTGAGTCTGGAGA"	"Prolif.TPC"
"AGGGTGAGTTGGTAAA"	"TPC_1"
"AGGGTGATCGGCGCAT"	"TPC_2"
"AGGTCATAGCCAGTTT"	"TPC_1"
"AGGTCATAGCTATGCT"	"DCT-like_2"
"AGGTCATCATCATCCC"	"Prolif.TPC"
"AGGTCATTCCACGTGG"	"TPC_1"
"AGGTCCGCAGATTGCT"	"DCT-like_2"
"AGGTCCGGTACAGCAG"	"TPC_2"
"AGGTCCGGTGAGCGAT"	"TPC_1"
"AGGTCCGGTGAGTATA"	"TPC_1"
"AGGTCCGGTTCTGGTA"	"DCT-like_1"
"AGTAGTCAGGGCTCTC"	"DCT-like_2"
"AGTAGTCGTCTTCAAG"	"Prolif.TPC"
"AGTCTTTCAACTTGAC"	"TPC_2"
"AGTGAGGCAGTGGGAT"	"DCT-like_1"
"AGTGAGGCATCCGGGT"	"DCT-like_2"
"AGTGAGGTCAAACGGG"	"TPC_1"
"AGTGAGGTCTTCTGGC"	"TPC_1"
"AGTGGGAAGAGCAATT"	"TPC_3"
"AGTGGGACAAGGTTCT"	"DCT-like_2"
"AGTGGGAGTGATGATA"	"Epith.:HighRibo"
"AGTGGGAGTTCATGGT"	"Epith.:HighRibo"
"AGTGGGATCCTGTAGA"	"DCT-like_2"
"AGTGTCAAGCTAGTGG"	"DCT-like_1"
"AGTGTCAAGGTGATAT"	"DCT-like_1"
"AGTGTCAAGTACGTTC"	"PEC-like_1"
"AGTGTCAAGTTTCCTT"	"DCT-like_2"
"AGTGTCACATGACATC"	"DCT-like_2"
"AGTGTCATCCTATGTT"	"DCT-like_1"
"AGTTGGTAGAGCTTCT"	"TPC_2"
"AGTTGGTCAGGTGGAT"	"TPC_1"
"AGTTGGTTCGCGGATC"	"TPC_2"
"ATAACGCAGCGAAGGG"	"Prolif.TPC"
"ATAACGCCAGTCACTA"	"TPC_3"
"ATAACGCGTCCATGAT"	"DCT-like_2"
"ATAACGCTCATGGTCA"	"TPC_1"
"ATAACGCTCCGTCATC"	"DCT-like_2"
"ATAAGAGAGCGACGTA"	"DCT-like_2"
"ATAAGAGAGTCTCCTC"	"TPC_3"
"ATAAGAGCACGGCGTT"	"TPC_3"
"ATAAGAGCATCACCCT"	"DCT-like_2"
"ATAAGAGCATCGGACC"	"DCT-like_1"
"ATAAGAGGTACCGGCT"	"TPC_1"
"ATAAGAGGTCAATGTC"	"TPC_2"
"ATAAGAGTCATCGGAT"	"PEC-like_2"
"ATAAGAGTCTGCGACG"	"TPC_1"
"ATAGACCAGTAGGCCA"	"TPC_2"
"ATAGACCCAAACGCGA"	"DCT-like_2"
"ATAGACCCACGGTTTA"	"DCT-like_2"
"ATAGACCCAGGAATGC"	"TPC_1"
"ATAGACCCATTCACTT"	"TPC_1"
"ATAGACCTCAGTTCGA"	"Epith.:HighMT"
"ATAGACCTCCAGTAGT"	"DCT-like_2"
"ATCACGAGTACCGCTG"	"Prolif.TPC"
"ATCACGAGTCAAAGAT"	"TPC_3"
"ATCACGAGTGAGCGAT"	"DCT-like_2"
"ATCACGATCAACTCTT"	"Epith.:HighRibo"
"ATCACGATCAAGGCTT"	"DCT-like_1"
"ATCACGATCGACCAGC"	"DCT-like_2"
"ATCACGATCGGAAATA"	"TPC_2"
"ATCACGATCTTCATGT"	"TPC_2"
"ATCATCTAGCCTTGAT"	"TPC_1"
"ATCATCTAGGGTTTCT"	"Prolif.TPC"
"ATCATCTCAGGGTACA"	"TPC_2"
"ATCATCTTCAGAGGTG"	"Prolif.TPC"
"ATCATCTTCCAGAAGG"	"DCT-like_1"
"ATCATGGAGTAGCGGT"	"TPC_2"
"ATCATGGCAATCCGAT"	"TPC_1"
"ATCATGGGTACCCAAT"	"Prolif.TPC"
"ATCATGGGTAGCGTCC"	"TPC_3"
"ATCCACCAGTCTTGCA"	"TPC_1"
"ATCCACCCAATGTAAG"	"TPC_1"
"ATCCACCCACTCTGTC"	"TPC_3"
"ATCCACCCAGACAAGC"	"PEC-like_1"
"ATCCACCCATCGTCGG"	"TPC_1"
"ATCCACCGTAGCCTCG"	"TPC_1"
"ATCCGAACACCAGGCT"	"DCT-like_1"
"ATCCGAAGTTCGAATC"	"PEC-like_2"
"ATCGAGTAGACAGACC"	"Prolif.TPC"
"ATCGAGTCACAGGAGT"	"TPC_3"
"ATCGAGTCAGTAAGCG"	"TPC_1"
"ATCGAGTGTGTAACGG"	"TPC_2"
"ATCGAGTTCACAGTAC"	"Prolif.TPC"
"ATCTACTCAATCTGCA"	"TPC_2"
"ATCTACTCACATTCGA"	"PEC-like_2"
"ATCTACTCATTCCTGC"	"DCT-like_1"
"ATCTGCCAGCGTCTAT"	"TPC_2"
"ATCTGCCAGGTGCAAC"	"DCT-like_1"
"ATCTGCCAGTATTGGA"	"TPC_3"
"ATCTGCCCACGTCAGC"	"TPC_2"
"ATCTGCCCAGAGCCAA"	"TPC_2"
"ATCTGCCCATTGAGCT"	"TPC_1"
"ATCTGCCGTAAGAGAG"	"TPC_3"
"ATCTGCCGTCCAACTA"	"TPC_2"
"ATCTGCCGTTTAGCTG"	"TPC_1"
"ATCTGCCTCTATGTGG"	"Prolif.TPC"
"ATGAGGGAGAGTAAGG"	"DCT-like_1"
"ATGAGGGAGTACGTTC"	"DCT-like_1"
"ATGAGGGCAGAGTGTG"	"TPC_3"
"ATGAGGGCATAGAAAC"	"Prolif.TPC"
"ATGAGGGGTTAGTGGG"	"TPC_1"
"ATGAGGGTCGTATCAG"	"PEC-like_1"
"ATGAGGGTCTGTCAAG"	"TPC_2"
"ATGCGATCAAATACAG"	"TPC_2"
"ATGGGAGAGAGTGAGA"	"TPC_1"
"ATGGGAGAGATCCCGC"	"TPC_1"
"ATGGGAGAGTATCTCG"	"TPC_2"
"ATGGGAGAGTATTGGA"	"Prolif.TPC"
"ATGGGAGCAGGTTTCA"	"DCT-like_2"
"ATGGGAGTCACTTACT"	"Prolif.TPC"
"ATGTGTGAGAGTCTGG"	"TPC_3"
"ATGTGTGCACAAGTAA"	"DCT-like_1"
"ATGTGTGGTATCGCAT"	"DCT-like_1"
"ATGTGTGTCAGCTCTC"	"TPC_1"
"ATGTGTGTCTTGCATT"	"DCT-like_2"
"ATTACTCAGGACACCA"	"TPC_1"
"ATTACTCTCCTGCAGG"	"DCT-like_1"
"ATTACTCTCGCAAACT"	"TPC_2"
"ATTATCCAGAGCCCAA"	"DCT-like_2"
"ATTCTACAGAGTCTGG"	"TPC_2"
"ATTCTACTCACCTCGT"	"TPC_2"
"ATTCTACTCGGCGCTA"	"DCT-like_1"
"ATTGGACAGCTAGTTC"	"TPC_2"
"ATTGGACAGTACGTAA"	"Prolif.TPC"
"ATTGGACCAAGAGTCG"	"TPC_1"
"ATTGGACCAGGTGGAT"	"PEC-like_1"
"ATTGGACCATCCGTGG"	"DCT-like_1"
"ATTGGACCATGTTGAC"	"TPC_1"
"ATTGGACGTCATACTG"	"TPC_3"
"ATTGGACTCTTATCTG"	"TPC_1"
"ATTGGTGCAAGAAGAG"	"TPC_1"
"ATTGGTGCAGTACACT"	"Prolif.TPC"
"ATTGGTGCAGTATAAG"	"TPC_1"
"ATTGGTGTCACTGGGC"	"TPC_1"
"ATTGGTGTCGAATCCA"	"TPC_1"
"ATTGGTGTCGGGAGTA"	"PEC-like_2"
"ATTTCTGAGATGTTAG"	"TPC_3"
"ATTTCTGAGCGATAGC"	"DCT-like_1"
"ATTTCTGCAGGCTCAC"	"PEC-like_1"
"ATTTCTGGTCTTGCGG"	"TPC_2"
"CAACCAACACAGACAG"	"TPC_2"
"CAACCAACACCGAAAG"	"TPC_2"
"CAACCAAGTCTGATCA"	"TPC_2"
"CAACCTCAGGCTAGAC"	"DCT-like_1"
"CAACCTCCATCCGGGT"	"DCT-like_1"
"CAACCTCGTCCAGTTA"	"PEC-like_1"
"CAACCTCGTGAGCGAT"	"TPC_1"
"CAACCTCGTGTGACCC"	"DCT-like_2"
"CAACCTCTCGGCTACG"	"TPC_1"
"CAACCTCTCTTGTTTG"	"TPC_3"
"CAACTAGGTAACGACG"	"Prolif.TPC"
"CAACTAGGTAATTGGA"	"TPC_3"
"CAACTAGGTAGGCATG"	"Epith.:HighRibo"
"CAACTAGGTTGGGACA"	"DCT-like_1"
"CAACTAGTCAGGCAAG"	"TPC_2"
"CAACTAGTCGTGGTCG"	"DCT-like_2"
"CAAGAAACAACACGCC"	"TPC_1"
"CAAGAAACACGCCAGT"	"Prolif.TPC"
"CAAGAAACATCACGAT"	"DCT-like_2"
"CAAGAAATCCGTCATC"	"Prolif.TPC"
"CAAGAAATCGAACTGT"	"DCT-like_1"
"CAAGAAATCGGATGGA"	"TPC_3"
"CAAGATCAGCTAGTTC"	"DCT-like_1"
"CAAGATCTCCGATATG"	"TPC_2"
"CAAGGCCAGAACAATC"	"DCT-like_1"
"CAAGGCCGTAAATGTG"	"Epith.:HighMT"
"CAAGGCCGTTCGTGAT"	"TPC_1"
"CAAGGCCTCGGATGTT"	"DCT-like_2"
"CAAGTTGAGATATGGT"	"TPC_1"
"CAAGTTGCATGCCTTC"	"PEC-like_2"
"CAAGTTGGTCTCATCC"	"DCT-like_1"
"CAAGTTGGTTCGTGAT"	"TPC_2"
"CAAGTTGGTTGTTTGG"	"Epith.:HighMT"
"CAAGTTGTCTGCCAGG"	"DCT-like_2"
"CACAAACCACAACTGT"	"TPC_1"
"CACAAACGTCGAACAG"	"TPC_1"
"CACAAACTCAAGGTAA"	"DCT-like_1"
"CACAAACTCTCCAGGG"	"TPC_1"
"CACACAAAGGTGACCA"	"DCT-like_2"
"CACACAAAGTCCGGTC"	"Prolif.TPC"
"CACACAAGTGAAGGCT"	"DCT-like_2"
"CACACCTAGCGTGAAC"	"TPC_1"
"CACACCTAGTAGCCGA"	"TPC_1"
"CACACCTAGTGTGAAT"	"Prolif.TPC"
"CACACCTCACAACGCC"	"DCT-like_2"
"CACACCTCACGGCGTT"	"DCT-like_1"
"CACACCTCAGTCTTCC"	"TPC_2"
"CACACCTGTTACGACT"	"TPC_2"
"CACACCTGTTGTGGCC"	"DCT-like_2"
"CACACCTTCCGGCACA"	"TPC_1"
"CACACTCAGAAGGGTA"	"DCT-like_1"
"CACACTCAGATCCCGC"	"Prolif.TPC"
"CACACTCCACTTACGA"	"DCT-like_2"
"CACACTCCAGGTTTCA"	"TPC_2"
"CACACTCCATCCCACT"	"Prolif.TPC"
"CACACTCGTTAGGGTG"	"PEC-like_1"
"CACAGGCCAAGGCTCC"	"TPC_1"
"CACAGGCGTACTTAGC"	"Prolif.TPC"
"CACAGGCTCATGCATG"	"TPC_2"
"CACAGTAAGATCTGCT"	"DCT-like_1"
"CACAGTAAGCTGCAAG"	"Epith.:HighMT"
"CACAGTACAGCAGTTT"	"TPC_2"
"CACAGTAGTCTAGCGC"	"TPC_3"
"CACAGTATCCGGGTGT"	"TPC_2"
"CACATAGCAGATGGCA"	"PEC-like_1"
"CACATAGCATCACAAC"	"TPC_3"
"CACATAGGTTGGTAAA"	"DCT-like_1"
"CACATAGTCACCACCT"	"DCT-like_2"
"CACATAGTCCCATTTA"	"PEC-like_1"
"CACATTTAGACTAAGT"	"TPC_2"
"CACATTTAGTACGACG"	"TPC_2"
"CACATTTAGTTTGCGT"	"TPC_1"
"CACATTTCAAGGACAC"	"TPC_2"
"CACATTTCAGCCTTGG"	"DCT-like_2"
"CACATTTCATGTTCCC"	"DCT-like_2"
"CACATTTTCGTACGGC"	"TPC_1"
"CACCACTAGTACGACG"	"TPC_3"
"CACCACTCAGGATCGA"	"DCT-like_1"
"CACCACTGTAAGTGGC"	"TPC_2"
"CACCAGGAGAAGGTGA"	"Epith.:HighMT"
"CACCAGGAGACTCGGA"	"TPC_2"
"CACCAGGTCCGTTGCT"	"TPC_2"
"CACCAGGTCGTAGGAG"	"TPC_1"
"CACCTTGGTAAGGGCT"	"TPC_2"
"CACCTTGGTACAAGTA"	"DCT-like_2"
"CACCTTGGTCTACCTC"	"Prolif.TPC"
"CACCTTGTCAATCACG"	"TPC_3"
"CACTCCAAGCACCGCT"	"TPC_2"
"CACTCCAAGCACCGTC"	"Epith.:HighMT"
"CACTCCACAATGGTCT"	"TPC_2"
"CACTCCACATAAAGGT"	"DCT-like_2"
"CACTCCAGTAATAGCA"	"Prolif.TPC"
"CAGAATCAGGATATAC"	"TPC_2"
"CAGAATCCAATGGATA"	"DCT-like_1"
"CAGAATCCATCATCCC"	"TPC_2"
"CAGAATCGTATTCGTG"	"TPC_3"
"CAGAGAGAGACTGGGT"	"PEC-like_1"
"CAGAGAGCACGGCCAT"	"TPC_1"
"CAGAGAGCAGAGCCAA"	"TPC_3"
"CAGAGAGTCGTTTGCC"	"TPC_1"
"CAGAGAGTCTTACCTA"	"DCT-like_1"
"CAGATCAAGCTGTCTA"	"TPC_1"
"CAGATCAAGTTTGCGT"	"TPC_2"
"CAGATCACACCATGTA"	"TPC_1"
"CAGATCACACCCATTC"	"TPC_1"
"CAGATCAGTAGCTGCC"	"TPC_2"
"CAGCAGCAGGTGGGTT"	"TPC_1"
"CAGCAGCAGTGGACGT"	"Prolif.TPC"
"CAGCAGCCACCAACCG"	"DCT-like_1"
"CAGCAGCCACTTAAGC"	"DCT-like_1"
"CAGCAGCCATCTCCCA"	"TPC_1"
"CAGCAGCTCATCGGAT"	"DCT-like_1"
"CAGCAGCTCGAGAACG"	"PEC-like_1"
"CAGCATAGTGGTACAG"	"DCT-like_2"
"CAGCATATCGCTAGCG"	"TPC_2"
"CAGCCGAAGAGGGATA"	"TPC_3"
"CAGCCGAAGATACACA"	"TPC_2"
"CAGCCGAAGGGCTCTC"	"Epith.:HighMT"
"CAGCCGAAGTCCTCCT"	"TPC_2"
"CAGCCGAAGTGTTTGC"	"Prolif.TPC"
"CAGCCGACAAGCTGGA"	"TPC_3"
"CAGCCGACACAAGCCC"	"TPC_3"
"CAGCCGAGTGGTCTCG"	"TPC_3"
"CAGCCGATCAACACAC"	"Prolif.TPC"
"CAGCCGATCAACGCTA"	"Prolif.TPC"
"CAGCGACCACCGAAAG"	"TPC_1"
"CAGCGACCAGAGTGTG"	"DCT-like_1"
"CAGCGACCAGATCTGT"	"TPC_1"
"CAGCGACGTTCAGACT"	"TPC_3"
"CAGCGACTCTGTCTCG"	"TPC_2"
"CAGCTAAAGAATAGGG"	"TPC_1"
"CAGCTAAAGATGTGTA"	"TPC_1"
"CAGCTAAAGATGTTAG"	"TPC_1"
"CAGCTAAAGGGAAACA"	"TPC_1"
"CAGCTAAGTAACGCGA"	"DCT-like_2"
"CAGCTAAGTCATACTG"	"TPC_3"
"CAGCTAATCACGACTA"	"Prolif.TPC"
"CAGCTAATCATGTAGC"	"Prolif.TPC"
"CAGCTGGAGTTACCCA"	"DCT-like_1"
"CAGCTGGCAGGTCGTC"	"TPC_2"
"CAGCTGGTCAGTTTGG"	"Prolif.TPC"
"CAGGTGCAGTCGTACT"	"TPC_1"
"CAGGTGCAGTTCGCAT"	"PEC-like_1"
"CAGGTGCCACATTCGA"	"DCT-like_2"
"CAGGTGCCACGGCTAC"	"PEC-like_2"
"CAGGTGCCAGAGTGTG"	"Prolif.TPC"
"CAGGTGCGTCGCGTGT"	"TPC_1"
"CAGGTGCGTTCCATGA"	"Prolif.TPC"
"CAGGTGCGTTTAGGAA"	"PEC-like_1"
"CAGTAACCATTACCTT"	"TPC_3"
"CAGTAACGTACCAGTT"	"DCT-like_2"
"CAGTAACGTGATGCCC"	"DCT-like_2"
"CAGTCCTAGGCAGGTT"	"DCT-like_1"
"CAGTCCTCAAGCTGTT"	"TPC_2"
"CAGTCCTTCCTAAGTG"	"TPC_2"
"CAGTCCTTCTTACCTA"	"Prolif.TPC"
"CATATGGAGCTGCAAG"	"Prolif.TPC"
"CATATGGAGTCAAGCG"	"DCT-like_2"
"CATATTCAGTGAATTG"	"Epith.:HighMT"
"CATATTCCAACAACCT"	"PEC-like_2"
"CATATTCCAAGACGTG"	"TPC_2"
"CATATTCGTGGTCCGT"	"DCT-like_2"
"CATCAAGAGAGCTATA"	"Prolif.TPC"
"CATCAAGAGAGGTTAT"	"TPC_1"
"CATCAAGCAGCTTAAC"	"TPC_1"
"CATCAAGCAGTTTACG"	"DCT-like_1"
"CATCAAGTCACGCATA"	"TPC_1"
"CATCAAGTCGCTTAGA"	"PEC-like_2"
"CATCAAGTCGGCTTGG"	"Prolif.TPC"
"CATCAGAGTCATTAGC"	"DCT-like_1"
"CATCAGATCGGTGTTA"	"DCT-like_2"
"CATCCACAGAAAGTGG"	"TPC_3"
"CATCCACAGGACGAAA"	"TPC_2"
"CATCCACCATCCCACT"	"TPC_1"
"CATCCACGTATTACCG"	"TPC_2"
"CATCGAAAGCCCAGCT"	"TPC_1"
"CATCGAACAGGGTTAG"	"TPC_1"
"CATCGAACATCTACGA"	"TPC_1"
"CATCGGGAGCTGTCTA"	"TPC_2"
"CATCGGGAGTCCGTAT"	"DCT-like_2"
"CATCGGGCACAAGTAA"	"TPC_1"
"CATCGGGCAGCGTCCA"	"Prolif.TPC"
"CATCGGGGTGATAAAC"	"TPC_1"
"CATCGGGGTTCTGAAC"	"TPC_3"
"CATCGGGGTTTAGCTG"	"TPC_3"
"CATCGGGTCGGATGTT"	"DCT-like_2"
"CATGACAAGCTAGGCA"	"PEC-like_1"
"CATGACAAGGTAGCTG"	"DCT-like_1"
"CATGACAAGTGCTGCC"	"DCT-like_2"
"CATGACACACCGTTGG"	"Prolif.TPC"
"CATGACACATGGAATA"	"TPC_2"
"CATGACAGTATTCGTG"	"Prolif.TPC"
"CATGCCTAGTGGAGTC"	"TPC_1"
"CATGCCTCAAGGGTCA"	"DCT-like_2"
"CATGCCTCACCATCCT"	"TPC_1"
"CATGCCTGTGCCTGTG"	"TPC_1"
"CATGCCTGTTGGTAAA"	"DCT-like_1"
"CATGCCTTCACTATTC"	"DCT-like_1"
"CATGCCTTCGTGTAGT"	"DCT-like_1"
"CATGCCTTCTGGGCCA"	"PEC-like_1"
"CATGGCGAGGACTGGT"	"DCT-like_2"
"CATGGCGCACGAAATA"	"TPC_3"
"CATTATCAGGCGTACA"	"TPC_2"
"CATTATCCATGCAACT"	"Prolif.TPC"
"CATTATCGTGTCAATC"	"DCT-like_2"
"CATTCGCAGTTTCCTT"	"DCT-like_1"
"CATTCGCCATCGGACC"	"TPC_2"
"CATTCGCGTACGCACC"	"PEC-like_2"
"CATTCGCGTAGGCTGA"	"TPC_1"
"CATTCGCTCGAATGCT"	"TPC_2"
"CATTCGCTCGTACCGG"	"TPC_1"
"CCAATCCAGCTAACAA"	"DCT-like_1"
"CCAATCCAGTCAAGCG"	"TPC_3"
"CCAATCCCATCTCCCA"	"TPC_3"
"CCAATCCTCTAACCGA"	"TPC_1"
"CCAATCCTCTAAGCCA"	"DCT-like_2"
"CCACCTACACGGCGTT"	"TPC_1"
"CCACCTACATCGGAAG"	"DCT-like_1"
"CCACCTAGTCGGGTCT"	"TPC_2"
"CCACCTAGTTGTCGCG"	"TPC_3"
"CCACCTATCATGTGGT"	"Prolif.TPC"
"CCACGGAAGATGTGGC"	"TPC_2"
"CCACGGAGTGTTAAGA"	"TPC_3"
"CCACTACAGAAACCTA"	"TPC_3"
"CCACTACAGTGTACGG"	"DCT-like_1"
"CCACTACCAGTAAGAT"	"DCT-like_2"
"CCACTACGTGGCTCCA"	"DCT-like_2"
"CCACTACGTGTTGAGG"	"DCT-like_1"
"CCAGCGACATGCCCGA"	"DCT-like_1"
"CCAGCGAGTTACGACT"	"TPC_1"
"CCAGCGAGTTGGTGGA"	"TPC_2"
"CCAGCGATCCAAAGTC"	"TPC_1"
"CCATGTCGTGACGGTA"	"DCT-like_1"
"CCATGTCTCCTTTCTC"	"TPC_3"
"CCATTCGAGAAAGTGG"	"TPC_1"
"CCATTCGCAAGTAATG"	"TPC_2"
"CCATTCGCAGGGCATA"	"Prolif.TPC"
"CCATTCGCATGGATGG"	"DCT-like_1"
"CCATTCGTCACTATTC"	"Prolif.TPC"
"CCATTCGTCCACGACG"	"TPC_1"
"CCATTCGTCTCAAGTG"	"Epith.:HighMT"
"CCCAATCAGGAGTAGA"	"DCT-like_2"
"CCCAATCAGTGAAGTT"	"TPC_2"
"CCCAATCCATTGGTAC"	"DCT-like_1"
"CCCAATCGTATAGGGC"	"Epith.:HighMT"
"CCCAATCGTTGACGTT"	"TPC_2"
"CCCAGTTAGAGTAAGG"	"DCT-like_2"
"CCCAGTTAGGCCCTTG"	"TPC_2"
"CCCAGTTGTCAAAGCG"	"TPC_1"
"CCCAGTTTCCACGAAT"	"TPC_1"
"CCCAGTTTCGACAGCC"	"PEC-like_1"
"CCCAGTTTCGGAAACG"	"TPC_2"
"CCCAGTTTCTGTCAAG"	"Prolif.TPC"
"CCCATACAGTCTTGCA"	"DCT-like_2"
"CCCATACCAGGTCGTC"	"Prolif.TPC"
"CCCATACTCCATGAGT"	"Prolif.TPC"
"CCCTCCTCAAACCTAC"	"Prolif.TPC"
"CCCTCCTGTTGGTAAA"	"TPC_1"
"CCCTCCTTCGCATGAT"	"Prolif.TPC"
"CCCTCCTTCTCGAGTA"	"DCT-like_1"
"CCGGGATCAAGTTGTC"	"TPC_1"
"CCGGGATCAGGGTATG"	"Prolif.TPC"
"CCGGGATGTCCGTCAG"	"TPC_3"
"CCGGGATGTGAAGGCT"	"Prolif.TPC"
"CCGGGATGTGCCTGGT"	"DCT-like_1"
"CCGGGATGTGTCCTCT"	"TPC_2"
"CCGGTAGCAGATAATG"	"DCT-like_2"
"CCGGTAGTCATTTGGG"	"PEC-like_2"
"CCGGTAGTCGATAGAA"	"Prolif.TPC"
"CCGTACTAGCAGCCTC"	"TPC_2"
"CCGTACTAGCATGGCA"	"Epith.:HighMT"
"CCGTACTAGGACGAAA"	"TPC_1"
"CCGTACTAGGGTTTCT"	"DCT-like_1"
"CCGTACTCACAACGCC"	"TPC_3"
"CCGTACTGTGCCTTGG"	"TPC_1"
"CCGTACTGTGTCTGAT"	"DCT-like_2"
"CCGTACTGTTCGCTAA"	"TPC_2"
"CCGTACTTCACGATGT"	"TPC_2"
"CCGTGGACATACCATG"	"TPC_1"
"CCGTGGATCATGTCTT"	"TPC_3"
"CCGTTCACAGCCTATA"	"TPC_1"
"CCGTTCACAGCTGCAC"	"TPC_1"
"CCGTTCACATGCTGGC"	"TPC_1"
"CCGTTCAGTCTCGTTC"	"TPC_2"
"CCTAAAGAGTGCCAGA"	"DCT-like_2"
"CCTAAAGCATCGGAAG"	"TPC_3"
"CCTAAAGTCAACGGGA"	"DCT-like_2"
"CCTAAAGTCCTCATTA"	"Prolif.TPC"
"CCTAAAGTCTCTGAGA"	"TPC_1"
"CCTACACAGCGTCAAG"	"TPC_1"
"CCTACACAGCGTTGCC"	"TPC_2"
"CCTACACAGCTAGCCC"	"Prolif.TPC"
"CCTACACAGTCCGTAT"	"TPC_2"
"CCTACACGTGAGTATA"	"PEC-like_2"
"CCTACACTCCAGAAGG"	"TPC_1"
"CCTACACTCCTTCAAT"	"TPC_3"
"CCTACCACAAGTCATC"	"PEC-like_1"
"CCTACCACAGATCGGA"	"TPC_1"
"CCTACCAGTGAGCGAT"	"TPC_3"
"CCTACCATCAGCTTAG"	"DCT-like_1"
"CCTAGCTAGGGATCTG"	"PEC-like_1"
"CCTAGCTTCAATCACG"	"TPC_1"
"CCTAGCTTCAGAGCTT"	"Epith.:HighMT"
"CCTATTAGTCATGCCG"	"TPC_2"
"CCTATTATCTGATTCT"	"TPC_1"
"CCTATTATCTGTCTAT"	"TPC_1"
"CCTCAGTAGGATGCGT"	"TPC_3"
"CCTCAGTAGTGGTAAT"	"TPC_1"
"CCTCAGTAGTGTGAAT"	"TPC_3"
"CCTCAGTCACATCCGG"	"DCT-like_1"
"CCTCAGTCATTCCTCG"	"TPC_1"
"CCTCAGTGTGCTAGCC"	"DCT-like_2"
"CCTCAGTGTGGTTTCA"	"PEC-like_1"
"CCTCAGTGTTACCGAT"	"DCT-like_2"
"CCTCAGTGTTCAGCGC"	"DCT-like_2"
"CCTCAGTTCAGTCAGT"	"Prolif.TPC"
"CCTCAGTTCGCTTAGA"	"Prolif.TPC"
"CCTCTGAAGCTAGTTC"	"DCT-like_2"
"CCTCTGAAGGTGCTAG"	"DCT-like_1"
"CCTCTGAAGTACACCT"	"Epith.:HighRibo"
"CCTCTGAAGTAGCGGT"	"PEC-like_1"
"CCTCTGACACCCAGTG"	"TPC_1"
"CCTCTGACACCGGAAA"	"DCT-like_1"
"CCTCTGAGTAGCGCTC"	"TPC_3"
"CCTCTGATCAGGCAAG"	"TPC_1"
"CCTTACGAGATGCCTT"	"DCT-like_2"
"CCTTACGAGCCCGAAA"	"Epith.:HighRibo"
"CCTTACGAGTATCGAA"	"DCT-like_2"
"CCTTACGCAAGCGCTC"	"TPC_2"
"CCTTACGCACCCAGTG"	"DCT-like_2"
"CCTTACGTCAGAGGTG"	"TPC_1"
"CCTTCCCAGACAGACC"	"DCT-like_1"
"CCTTCCCCAAATACAG"	"DCT-like_2"
"CCTTCCCCACGGACAA"	"Epith.:HighRibo"
"CCTTCCCCAGTGACAG"	"TPC_1"
"CCTTCCCCAGTGAGTG"	"TPC_1"
"CCTTCCCGTACGCTGC"	"TPC_2"
"CCTTCCCTCTACGAGT"	"TPC_1"
"CCTTCCCTCTTAGCCC"	"DCT-like_1"
"CCTTCGACACAGCGTC"	"DCT-like_2"
"CCTTCGACAGGACGTA"	"TPC_2"
"CCTTCGACATCGGTTA"	"TPC_1"
"CCTTCGACATTCTTAC"	"Epith.:HighMT"
"CCTTCGAGTAGAGCTG"	"TPC_3"
"CCTTCGAGTGCAGACA"	"TPC_1"
"CCTTTCTCATACTCTT"	"DCT-like_2"
"CCTTTCTTCGGGAGTA"	"DCT-like_2"
"CCTTTCTTCTCGTTTA"	"DCT-like_2"
"CGAACATAGCCGCCTA"	"TPC_2"
"CGAACATAGGTAGCTG"	"DCT-like_1"
"CGAACATCACCTATCC"	"TPC_1"
"CGAACATGTACCCAAT"	"Epith.:HighRibo"
"CGAACATGTGAAGGCT"	"Prolif.TPC"
"CGAACATGTTCCAACA"	"DCT-like_1"
"CGAACATGTTGCGCAC"	"TPC_2"
"CGAACATTCCTAGTGA"	"TPC_1"
"CGAATGTAGGTCATCT"	"Epith.:HighMT"
"CGAATGTGTAAGTTCC"	"TPC_3"
"CGAATGTGTATTACCG"	"PEC-like_1"
"CGAATGTGTCTTCTCG"	"TPC_1"
"CGAATGTGTGTATGGG"	"Epith.:HighRibo"
"CGACCTTAGAAACCAT"	"DCT-like_2"
"CGACCTTCACGAAAGC"	"Prolif.TPC"
"CGACCTTGTGACCAAG"	"DCT-like_2"
"CGACCTTGTGTGTGCC"	"TPC_2"
"CGACCTTTCTCCAACC"	"TPC_2"
"CGACTTCAGACTAAGT"	"TPC_1"
"CGACTTCAGGATGTAT"	"DCT-like_2"
"CGACTTCCAATCTGCA"	"DCT-like_1"
"CGACTTCCAATTCCTT"	"TPC_2"
"CGAGAAGCAAATCCGT"	"DCT-like_1"
"CGAGAAGCAATCGGTT"	"TPC_1"
"CGAGAAGCACACAGAG"	"Epith.:HighRibo"
"CGAGAAGCAGTGACAG"	"TPC_1"
"CGAGAAGGTAGAAAGG"	"DCT-like_2"
"CGAGAAGTCAGCTCTC"	"TPC_1"
"CGAGAAGTCGAATGCT"	"TPC_2"
"CGAGCACAGTGACATA"	"DCT-like_2"
"CGAGCACCATCAGTCA"	"DCT-like_2"
"CGAGCACGTCTTCGTC"	"TPC_3"
"CGAGCCACAATACGCT"	"Prolif.TPC"
"CGAGCCAGTGCAGTAG"	"TPC_2"
"CGAGCCATCGAACTGT"	"TPC_2"
"CGAGCCATCGGTTAAC"	"TPC_2"
"CGATCGGAGCGTGAAC"	"Prolif.TPC"
"CGATCGGAGCTACCTA"	"TPC_1"
"CGATCGGCACAACGTT"	"TPC_1"
"CGATCGGCAGTGACAG"	"TPC_2"
"CGATCGGTCTGTCAAG"	"DCT-like_1"
"CGATGGCAGCACCGTC"	"TPC_1"
"CGATGGCAGGACATTA"	"TPC_1"
"CGATGGCAGTGCTGCC"	"DCT-like_1"
"CGATGGCCATATACCG"	"TPC_2"
"CGATGGCCATGGTAGG"	"DCT-like_1"
"CGATGGCTCATATCGG"	"TPC_1"
"CGATGTAAGTCGTTTG"	"Epith.:HighRibo"
"CGATGTACACGGTAGA"	"TPC_2"
"CGATGTATCGTCACGG"	"TPC_3"
"CGATTGACAATGGAGC"	"DCT-like_1"
"CGATTGACACGGCCAT"	"Prolif.TPC"
"CGATTGACAGTCTTCC"	"PEC-like_2"
"CGATTGATCCAATGGT"	"DCT-like_2"
"CGCCAAGAGTGGAGAA"	"Epith.:HighRibo"
"CGCCAAGGTTCACCTC"	"DCT-like_2"
"CGCGGTACACATGACT"	"DCT-like_1"
"CGCGGTACAGTTCATG"	"TPC_1"
"CGCGGTAGTCGAACAG"	"TPC_1"
"CGCGGTAGTGATAAGT"	"TPC_2"
"CGCGGTAGTTATGTGC"	"DCT-like_1"
"CGCGGTATCACCATAG"	"TPC_1"
"CGCGGTATCCAGAAGG"	"TPC_1"
"CGCGTTTTCCGTAGGC"	"TPC_2"
"CGCTATCAGCAGCGTA"	"TPC_1"
"CGCTATCGTTCCGGCA"	"TPC_2"
"CGCTATCTCCTCTAGC"	"TPC_1"
"CGCTATCTCTTACCTA"	"Epith.:HighMT"
"CGCTGGAAGCTAGTCT"	"TPC_3"
"CGCTGGAAGGATGGAA"	"TPC_3"
"CGCTGGAAGGATGGTC"	"DCT-like_2"
"CGCTGGACACAGCCCA"	"TPC_2"
"CGCTGGACATGAGCGA"	"DCT-like_2"
"CGCTGGAGTAACGTTC"	"TPC_2"
"CGCTGGAGTGCAGGTA"	"Epith.:HighMT"
"CGCTTCATCGCGTTTC"	"Epith.:HighRibo"
"CGCTTCATCTACTCAT"	"DCT-like_1"
"CGGACACGTCCAACTA"	"DCT-like_2"
"CGGACACTCGTAGATC"	"TPC_2"
"CGGACGTAGCTAAACA"	"Epith.:HighRibo"
"CGGACGTAGCTAACTC"	"TPC_1"
"CGGACGTCACGGTAGA"	"DCT-like_2"
"CGGACGTGTTATGTGC"	"TPC_3"
"CGGACGTTCTATCGCC"	"TPC_2"
"CGGACTGGTGCGGTAA"	"TPC_1"
"CGGACTGTCAGTTCGA"	"PEC-like_2"
"CGGACTGTCCGAGCCA"	"TPC_2"
"CGGAGCTCAGATGGCA"	"DCT-like_2"
"CGGAGCTCATGCCTAA"	"TPC_3"
"CGGAGCTGTAAGCACG"	"TPC_1"
"CGGAGCTGTCGAGTTT"	"TPC_3"
"CGGAGCTGTTACTGAC"	"TPC_2"
"CGGAGTCAGCCACGCT"	"DCT-like_1"
"CGGAGTCAGGCCGAAT"	"TPC_1"
"CGGAGTCCAATAGCAA"	"PEC-like_2"
"CGGAGTCTCATGTCTT"	"TPC_1"
"CGGAGTCTCGGTGTCG"	"DCT-like_2"
"CGGAGTCTCTGCTTGC"	"Prolif.TPC"
"CGGCTAGAGACAGGCT"	"DCT-like_2"
"CGGCTAGAGCGGATCA"	"TPC_2"
"CGGCTAGAGCGTGTCC"	"Prolif.TPC"
"CGGCTAGGTATAGGGC"	"DCT-like_1"
"CGGCTAGGTATCACCA"	"PEC-like_1"
"CGGCTAGTCTTCGGTC"	"PEC-like_2"
"CGGGTCAGTTCGGGCT"	"TPC_1"
"CGGTTAAGTAAGAGAG"	"Prolif.TPC"
"CGGTTAAGTGAGCGAT"	"TPC_1"
"CGGTTAAGTGGTACAG"	"TPC_3"
"CGGTTAATCCCAACGG"	"TPC_3"
"CGTAGCGAGACTGTAA"	"TPC_3"
"CGTAGCGAGTGGTCCC"	"TPC_2"
"CGTAGCGAGTTACGGG"	"DCT-like_2"
"CGTAGCGGTAGCGCAA"	"TPC_1"
"CGTAGCGGTTAGATGA"	"PEC-like_2"
"CGTAGGCAGAAGGTGA"	"TPC_1"
"CGTAGGCCACTGTGTA"	"TPC_1"
"CGTAGGCCAGGCAGTA"	"TPC_1"
"CGTAGGCCATAAAGGT"	"TPC_1"
"CGTAGGCCATGTAAGA"	"TPC_1"
"CGTAGGCCATTCTTAC"	"Prolif.TPC"
"CGTAGGCCATTGTGCA"	"TPC_1"
"CGTAGGCTCAACACAC"	"TPC_2"
"CGTCACTAGGGCTTCC"	"Prolif.TPC"
"CGTCACTCACGCTTTC"	"TPC_1"
"CGTCACTGTCTCACCT"	"TPC_1"
"CGTCACTGTGAGTGAC"	"PEC-like_2"
"CGTCACTTCGGAGCAA"	"DCT-like_2"
"CGTCAGGAGCTGCAAG"	"TPC_3"
"CGTCAGGAGGCAGGTT"	"Prolif.TPC"
"CGTCAGGCAAGTAATG"	"PEC-like_2"
"CGTCAGGCAGCGTTCG"	"Prolif.TPC"
"CGTCAGGCATGTCCTC"	"TPC_1"
"CGTCAGGTCAAAGACA"	"TPC_1"
"CGTCCATAGAAGGTTT"	"Prolif.TPC"
"CGTCCATAGAGTGAGA"	"TPC_3"
"CGTCCATAGGGTGTTG"	"DCT-like_1"
"CGTCCATTCGGCATCG"	"TPC_3"
"CGTCTACAGGTGCAAC"	"PEC-like_2"
"CGTCTACAGTACCGGA"	"Prolif.TPC"
"CGTCTACCACGACTCG"	"TPC_1"
"CGTCTACGTGAGGGAG"	"TPC_2"
"CGTCTACGTGGACGAT"	"TPC_1"
"CGTGAGCAGATGGCGT"	"TPC_2"
"CGTGAGCAGCAATCTC"	"DCT-like_2"
"CGTGAGCAGCGCCTCA"	"TPC_2"
"CGTGAGCGTGCGGTAA"	"DCT-like_2"
"CGTGAGCTCCAAAGTC"	"DCT-like_1"
"CGTGAGCTCCTGTAGA"	"PEC-like_1"
"CGTGTAAAGTAGGCCA"	"DCT-like_1"
"CGTGTAATCAGGTTCA"	"TPC_3"
"CGTGTAATCCGAGCCA"	"PEC-like_2"
"CGTGTAATCTTGACGA"	"TPC_3"
"CGTGTCTAGGGTGTTG"	"TPC_1"
"CGTGTCTCAAGCTGGA"	"TPC_3"
"CGTGTCTCAGACGCCT"	"DCT-like_2"
"CGTTAGAAGAGCCTAG"	"DCT-like_1"
"CGTTAGACAGACTCGC"	"TPC_3"
"CGTTAGAGTCTCTCGT"	"Prolif.TPC"
"CGTTAGAGTTTGGCGC"	"DCT-like_1"
"CGTTCTGAGGGATCTG"	"TPC_1"
"CGTTCTGCACCTGGTG"	"TPC_3"
"CGTTCTGCATCAGTAC"	"DCT-like_2"
"CGTTCTGGTGAGGGAG"	"DCT-like_1"
"CGTTCTGTCCGTCAAA"	"DCT-like_2"
"CGTTGGGAGTATCTCG"	"TPC_1"
"CGTTGGGAGTGCGATG"	"TPC_1"
"CGTTGGGCAATAAGCA"	"DCT-like_2"
"CGTTGGGCACGCATCG"	"DCT-like_1"
"CGTTGGGGTCTGGTCG"	"Prolif.TPC"
"CTAACTTAGTTAACGA"	"DCT-like_1"
"CTAACTTTCGCCATAA"	"TPC_3"
"CTAAGACAGAGACGAA"	"TPC_1"
"CTAAGACAGTCTCCTC"	"Prolif.TPC"
"CTAAGACCAATCCAAC"	"TPC_1"
"CTAAGACCACCTTGTC"	"Epith.:HighRibo"
"CTAAGACGTAAATGTG"	"DCT-like_1"
"CTAATGGCATAAGACA"	"TPC_2"
"CTAATGGGTTCCTCCA"	"Prolif.TPC"
"CTACACCAGACGCAAC"	"DCT-like_2"
"CTACACCAGATGCGAC"	"TPC_3"
"CTACACCAGTGGTAGC"	"TPC_2"
"CTACACCCAGGGATTG"	"TPC_1"
"CTACACCGTACGACCC"	"TPC_3"
"CTACACCGTTCCGTCT"	"DCT-like_1"
"CTACATTAGACAGACC"	"DCT-like_2"
"CTACATTAGGACTGGT"	"DCT-like_1"
"CTACATTAGTAGATGT"	"TPC_3"
"CTACATTCAAACGTGG"	"TPC_1"
"CTACATTCAGTAACGG"	"TPC_1"
"CTACATTTCTCCCTGA"	"DCT-like_2"
"CTACCCAAGGAGTTGC"	"DCT-like_1"
"CTACCCAAGGATGGAA"	"TPC_1"
"CTACCCAAGGGTCTCC"	"DCT-like_1"
"CTACCCAAGTACGCGA"	"TPC_2"
"CTACCCAGTAGAGCTG"	"DCT-like_2"
"CTACCCATCGTTTATC"	"TPC_2"
"CTACGTCAGTGTACTC"	"TPC_1"
"CTACGTCCATGTCTCC"	"DCT-like_1"
"CTACGTCGTAGCGATG"	"PEC-like_2"
"CTACGTCTCCTATTCA"	"TPC_2"
"CTAGAGTAGCAGCCTC"	"DCT-like_1"
"CTAGAGTAGCTGAAAT"	"DCT-like_1"
"CTAGAGTTCACCACCT"	"TPC_3"
"CTAGCCTAGGAGCGTT"	"TPC_1"
"CTAGCCTAGGTGTTAA"	"DCT-like_2"
"CTAGCCTAGTGCGTGA"	"DCT-like_2"
"CTAGCCTCAATGGATA"	"DCT-like_1"
"CTAGCCTGTCACAAGG"	"Epith.:HighRibo"
"CTAGCCTGTCTAGCCG"	"DCT-like_2"
"CTAGCCTTCGGCCGAT"	"Prolif.TPC"
"CTAGCCTTCTGTCTCG"	"Prolif.TPC"
"CTAGTGAAGATCGATA"	"TPC_2"
"CTAGTGAAGCCACGCT"	"Prolif.TPC"
"CTAGTGAAGCTGAACG"	"PEC-like_1"
"CTAGTGACAAACGCGA"	"TPC_1"
"CTAGTGACACCAGATT"	"Prolif.TPC"
"CTAGTGACACCGAATT"	"TPC_1"
"CTAGTGACACTGTTAG"	"DCT-like_1"
"CTCACACAGAACAATC"	"TPC_1"
"CTCACACAGCGTGAGT"	"PEC-like_1"
"CTCACACAGGGAGTAA"	"DCT-like_1"
"CTCACACCAAGCCGCT"	"TPC_1"
"CTCACACCACTGTTAG"	"TPC_2"
"CTCACACCATGCTGGC"	"DCT-like_2"
"CTCACACTCGCATGGC"	"DCT-like_1"
"CTCAGAACATACGCTA"	"TPC_1"
"CTCAGAACATCCCACT"	"DCT-like_1"
"CTCAGAACATGAAGTA"	"Prolif.TPC"
"CTCAGAAGTCTAAAGA"	"Epith.:HighRibo"
"CTCAGAAGTTTAGCTG"	"TPC_2"
"CTCATTAGTTGCCTCT"	"TPC_2"
"CTCATTATCGCCCTTA"	"TPC_1"
"CTCATTATCGGGAGTA"	"DCT-like_1"
"CTCCTAGAGGACATTA"	"DCT-like_1"
"CTCCTAGCAGGCTCAC"	"Epith.:HighRibo"
"CTCCTAGCATACGCCG"	"DCT-like_1"
"CTCCTAGCATTCACTT"	"DCT-like_1"
"CTCCTAGGTGCGGTAA"	"TPC_1"
"CTCCTAGGTTCACGGC"	"DCT-like_2"
"CTCCTAGGTTCCGGCA"	"TPC_3"
"CTCCTAGTCGCAAGCC"	"TPC_1"
"CTCCTAGTCTAACTCT"	"DCT-like_2"
"CTCGAAAAGATGTGGC"	"DCT-like_2"
"CTCGAAACAAGGGTCA"	"TPC_1"
"CTCGAAACAGGCGATA"	"TPC_2"
"CTCGAAAGTTCGGGCT"	"Prolif.TPC"
"CTCGAAATCCGTAGGC"	"DCT-like_2"
"CTCGAAATCCTCATTA"	"Prolif.TPC"
"CTCGAAATCTACCTGC"	"TPC_1"
"CTCGAGGAGACTAGGC"	"TPC_3"
"CTCGAGGCAGAAGCAC"	"TPC_1"
"CTCGAGGCAGAGTGTG"	"TPC_1"
"CTCGAGGCAGCCTATA"	"TPC_1"
"CTCGAGGCATGCTAGT"	"TPC_1"
"CTCGAGGGTCGCGGTT"	"TPC_1"
"CTCGAGGGTGTTCTTT"	"DCT-like_2"
"CTCGAGGTCAGCTCTC"	"DCT-like_1"
"CTCGAGGTCCTCGCAT"	"DCT-like_2"
"CTCGAGGTCTTATCTG"	"TPC_1"
"CTCGGAGCACAGTCGC"	"TPC_1"
"CTCGGAGGTGAAATCA"	"TPC_2"
"CTCGGAGTCAAGGCTT"	"Prolif.TPC"
"CTCGGGAAGTAGCGGT"	"TPC_3"
"CTCGGGATCCTGCTTG"	"TPC_2"
"CTCGGGATCTCTAAGG"	"TPC_1"
"CTCGTACGTGAGGGAG"	"Epith.:HighRibo"
"CTCGTACGTTTGGCGC"	"TPC_2"
"CTCGTCAAGCTCCCAG"	"TPC_3"
"CTCGTCAGTTTAGGAA"	"DCT-like_1"
"CTCGTCATCCTAGGGC"	"Prolif.TPC"
"CTCGTCATCTAACTTC"	"TPC_3"
"CTCTAATAGGCCATAG"	"TPC_3"
"CTCTAATAGTCCCACG"	"TPC_3"
"CTCTAATAGTGGGATC"	"Prolif.TPC"
"CTCTAATAGTTGAGAT"	"DCT-like_1"
"CTCTAATGTTTCCACC"	"DCT-like_2"
"CTCTAATTCAGGCAAG"	"TPC_2"
"CTCTAATTCCCTCTTT"	"Epith.:HighRibo"
"CTCTAATTCGAATCCA"	"TPC_2"
"CTCTACGAGAGACTTA"	"Epith.:HighRibo"
"CTCTACGAGCGTTTAC"	"DCT-like_2"
"CTCTACGCAGACGCTC"	"TPC_1"
"CTCTACGCATGCATGT"	"TPC_3"
"CTCTACGGTATTCTCT"	"DCT-like_1"
"CTCTACGGTGGTCCGT"	"TPC_3"
"CTCTACGTCGCATGAT"	"DCT-like_2"
"CTCTGGTAGACTGTAA"	"TPC_3"
"CTCTGGTAGCAAATCA"	"TPC_3"
"CTCTGGTAGGGTCTCC"	"TPC_2"
"CTCTGGTCAGATGGGT"	"TPC_1"
"CTCTGGTTCCGTACAA"	"TPC_1"
"CTGAAACAGCCGATTT"	"DCT-like_1"
"CTGAAACGTAGGCATG"	"Epith.:HighRibo"
"CTGAAACTCTGATTCT"	"TPC_3"
"CTGAAACTCTGTCCGT"	"TPC_1"
"CTGAAGTAGTAGGTGC"	"Prolif.TPC"
"CTGAAGTCAACTGCTA"	"DCT-like_2"
"CTGAAGTCAAGAAGAG"	"DCT-like_2"
"CTGAAGTCAATGAATG"	"TPC_1"
"CTGAAGTCACCGAAAG"	"TPC_3"
"CTGAAGTCATACTACG"	"TPC_3"
"CTGAAGTGTTTGTTGG"	"Epith.:HighRibo"
"CTGATAGAGCCACGCT"	"DCT-like_1"
"CTGATAGAGGACAGAA"	"DCT-like_2"
"CTGATAGCAAATACAG"	"DCT-like_1"
"CTGATAGCAAGAGTCG"	"DCT-like_1"
"CTGATAGGTAGCGTAG"	"DCT-like_2"
"CTGATAGTCGCAGGCT"	"TPC_3"
"CTGATAGTCTCACATT"	"DCT-like_2"
"CTGATCCAGACTAGAT"	"PEC-like_2"
"CTGATCCCAGTGGGAT"	"TPC_3"
"CTGATCCGTAGGCTGA"	"TPC_1"
"CTGCCTACAGTCGATT"	"PEC-like_2"
"CTGCCTAGTTCCTCCA"	"PEC-like_2"
"CTGCCTATCAGAGGTG"	"TPC_3"
"CTGCCTATCCTCAATT"	"TPC_1"
"CTGCGGACAATCCAAC"	"TPC_3"
"CTGCGGACACTTCGAA"	"TPC_1"
"CTGCGGACAGTGACAG"	"DCT-like_2"
"CTGCGGACATTACGAC"	"DCT-like_1"
"CTGCGGAGTTCGTGAT"	"DCT-like_2"
"CTGCGGAGTTTGACAC"	"TPC_3"
"CTGCTGTAGCAGGCTA"	"TPC_1"
"CTGGTCTAGGGAGTAA"	"TPC_1"
"CTGGTCTAGGGCACTA"	"TPC_1"
"CTGGTCTCACATTTCT"	"DCT-like_1"
"CTGGTCTCAGTAGAGC"	"DCT-like_2"
"CTGGTCTGTAAGGGCT"	"Prolif.TPC"
"CTGGTCTGTAGATTAG"	"TPC_1"
"CTGGTCTTCGTATCAG"	"DCT-like_2"
"CTGTGCTAGAACTCGG"	"TPC_1"
"CTGTGCTAGATCCCAT"	"TPC_1"
"CTGTGCTAGGTAGCCA"	"TPC_3"
"CTGTGCTCATGACGGA"	"TPC_2"
"CTGTGCTGTAAATGTG"	"DCT-like_2"
"CTGTTTACAAACAACA"	"TPC_2"
"CTGTTTACAGCTTCGG"	"TPC_1"
"CTGTTTAGTTCTGGTA"	"DCT-like_2"
"CTGTTTATCGCGTTTC"	"Epith.:HighRibo"
"CTTAACTCAGCCTATA"	"DCT-like_2"
"CTTAACTCATTACGAC"	"TPC_1"
"CTTAACTGTGCTGTAT"	"Epith.:HighRibo"
"CTTAACTGTTAAGGGC"	"TPC_1"
"CTTACCGAGAGCCCAA"	"DCT-like_2"
"CTTACCGAGTTAGGTA"	"TPC_1"
"CTTACCGCAAGCTGGA"	"TPC_1"
"CTTACCGCAGTCACTA"	"TPC_1"
"CTTACCGCATACCATG"	"Prolif.TPC"
"CTTACCGGTGAAGGCT"	"TPC_1"
"CTTACCGGTGACCAAG"	"Epith.:HighMT"
"CTTACCGTCCACTGGG"	"DCT-like_1"
"CTTAGGAAGTCCGTAT"	"TPC_2"
"CTTAGGAAGTGTCCCG"	"TPC_3"
"CTTAGGACATCGGAAG"	"PEC-like_1"
"CTTAGGACATCGGTTA"	"DCT-like_1"
"CTTCTCTAGTTCGCGC"	"DCT-like_1"
"CTTCTCTCAGACAAGC"	"TPC_3"
"CTTCTCTGTTAGGGTG"	"Epith.:HighRibo"
"CTTCTCTGTTTACTCT"	"PEC-like_2"
"CTTCTCTTCCTAGGGC"	"Prolif.TPC"
"CTTCTCTTCTGACCTC"	"DCT-like_1"
"CTTGGCTAGATGGCGT"	"TPC_2"
"CTTGGCTAGTCGTTTG"	"TPC_1"
"CTTGGCTCAGGGTACA"	"TPC_1"
"CTTGGCTTCCCGGATG"	"DCT-like_1"
"CTTGGCTTCTCGATGA"	"TPC_1"
"CTTTGCGCAAGTACCT"	"DCT-like_1"
"CTTTGCGCACAGTCGC"	"DCT-like_2"
"CTTTGCGGTACCAGTT"	"Prolif.TPC"
"CTTTGCGGTATAGGTA"	"DCT-like_1"
"CTTTGCGGTCGAAAGC"	"PEC-like_1"
"CTTTGCGGTGCCTGCA"	"TPC_1"
"CTTTGCGTCAACACAC"	"DCT-like_1"
"CTTTGCGTCTACTTAC"	"DCT-like_1"
"GAAACTCAGGGCTCTC"	"Prolif.TPC"
"GAAACTCCAAGGTTCT"	"DCT-like_1"
"GAAACTCGTTCTGGTA"	"PEC-like_2"
"GAAACTCGTTGAGTTC"	"DCT-like_2"
"GAAATGAAGATAGTCA"	"DCT-like_2"
"GAAATGAAGTTCGATC"	"TPC_3"
"GAAATGACAAGAAAGG"	"DCT-like_1"
"GAAATGACACGTCTCT"	"TPC_3"
"GAAATGAGTTCAGCGC"	"PEC-like_2"
"GAAATGATCCCAGGTG"	"TPC_2"
"GAAATGATCGTAGATC"	"TPC_1"
"GAACATCAGAGTTGGC"	"TPC_1"
"GAACATCAGCGCTTAT"	"TPC_2"
"GAACATCCACGACGAA"	"TPC_1"
"GAACATCGTAAATGAC"	"DCT-like_2"
"GAACATCGTGATGTGG"	"TPC_3"
"GAACATCTCATAACCG"	"TPC_3"
"GAACATCTCCTGTAGA"	"TPC_1"
"GAACCTACAATTCCTT"	"Epith.:HighRibo"
"GAACCTACACTTGGAT"	"Prolif.TPC"
"GAACCTACAGTGAGTG"	"TPC_2"
"GAACCTATCCATGAAC"	"DCT-like_1"
"GAACCTATCTGACCTC"	"DCT-like_1"
"GAACGGAAGATATACG"	"TPC_1"
"GAACGGAAGATGTGGC"	"TPC_3"
"GAACGGACAATCCAAC"	"Prolif.TPC"
"GAAGCAGAGACTTTCG"	"TPC_3"
"GAAGCAGAGCAATATG"	"Prolif.TPC"
"GAAGCAGAGGCTAGCA"	"TPC_2"
"GAAGCAGCACGGCGTT"	"DCT-like_2"
"GAAGCAGGTGCACGAA"	"DCT-like_1"
"GAATAAGCAAGAAAGG"	"DCT-like_1"
"GAATAAGCATAAGACA"	"Prolif.TPC"
"GAATAAGGTAAATGAC"	"Prolif.TPC"
"GAATAAGTCAGAGGTG"	"PEC-like_1"
"GAATGAAAGGATCGCA"	"TPC_3"
"GAATGAAAGTCCTCCT"	"TPC_1"
"GAATGAACATTCACTT"	"TPC_1"
"GAATGAATCCTTGACC"	"TPC_1"
"GAATGAATCGAGAGCA"	"DCT-like_1"
"GACACGCAGCCTATGT"	"DCT-like_2"
"GACACGCAGCGTTCCG"	"TPC_1"
"GACACGCAGCTAAGAT"	"TPC_2"
"GACACGCCATCGACGC"	"Epith.:HighMT"
"GACACGCGTTCATGGT"	"TPC_2"
"GACACGCTCAGTTTGG"	"TPC_1"
"GACACGCTCTGCAAGT"	"TPC_1"
"GACAGAGAGGACACCA"	"TPC_3"
"GACAGAGAGGTCATCT"	"TPC_3"
"GACAGAGGTTCAGCGC"	"TPC_1"
"GACAGAGGTTGTTTGG"	"TPC_2"
"GACAGAGTCTAACTGG"	"TPC_1"
"GACAGAGTCTTCATGT"	"TPC_1"
"GACCAATAGATGTCGG"	"PEC-like_1"
"GACCAATAGCTTCGCG"	"DCT-like_1"
"GACCAATAGGGAACGG"	"Prolif.TPC"
"GACCAATGTCCTCTTG"	"TPC_3"
"GACCAATGTCTAACGT"	"TPC_1"
"GACCAATGTGCACTTA"	"TPC_2"
"GACCAATTCGCGATCG"	"TPC_1"
"GACCTGGAGCTGTTCA"	"TPC_2"
"GACCTGGCAAAGAATC"	"DCT-like_2"
"GACCTGGCATGGTCTA"	"TPC_1"
"GACCTGGGTACATGTC"	"DCT-like_1"
"GACCTGGGTAGCCTAT"	"Prolif.TPC"
"GACCTGGTCAACACCA"	"TPC_3"
"GACCTGGTCATCGCTC"	"Epith.:HighRibo"
"GACGCGTAGGCCATAG"	"TPC_1"
"GACGCGTGTGACTACT"	"TPC_1"
"GACGCGTGTGGTAACG"	"TPC_2"
"GACGCGTTCCCTTGTG"	"DCT-like_2"
"GACGCGTTCTATCCCG"	"DCT-like_1"
"GACGGCTAGCCTATGT"	"DCT-like_2"
"GACGGCTCAAACCTAC"	"DCT-like_1"
"GACGGCTCAGGTCTCG"	"PEC-like_1"
"GACGGCTGTCTAAACC"	"TPC_1"
"GACGGCTTCTGGTGTA"	"TPC_1"
"GACGTGCCAAGTTCTG"	"DCT-like_1"
"GACGTGCCACTATCTT"	"Epith.:HighRibo"
"GACGTGCGTAAGGATT"	"TPC_2"
"GACGTGCGTCTGCGGT"	"DCT-like_1"
"GACGTGCGTTCGGCAC"	"TPC_2"
"GACGTGCTCAGGCCCA"	"DCT-like_1"
"GACGTGCTCAGTCAGT"	"TPC_1"
"GACGTGCTCGAACGGA"	"TPC_1"
"GACGTGCTCGAATCCA"	"TPC_1"
"GACGTTAAGGATCGCA"	"DCT-like_2"
"GACGTTACAGGCAGTA"	"DCT-like_2"
"GACGTTAGTCATCCCT"	"PEC-like_1"
"GACGTTAGTGAGTGAC"	"TPC_2"
"GACGTTAGTGATAAAC"	"DCT-like_1"
"GACGTTAGTGTGACGA"	"Prolif.TPC"
"GACGTTATCGAGAACG"	"Prolif.TPC"
"GACTAACAGATGCGAC"	"TPC_3"
"GACTAACCAAGTTGTC"	"DCT-like_1"
"GACTAACCACCTCGTT"	"TPC_2"
"GACTAACGTCCGAACC"	"DCT-like_2"
"GACTAACTCTATCCCG"	"Epith.:HighRibo"
"GACTAACTCTTACCTA"	"TPC_3"
"GACTACACACATGACT"	"TPC_3"
"GACTACACACTGCCAG"	"TPC_1"
"GACTACAGTAGAGCTG"	"DCT-like_1"
"GACTACATCTGGAGCC"	"PEC-like_1"
"GACTGCGAGAGTTGGC"	"TPC_1"
"GACTGCGAGGCTCATT"	"TPC_1"
"GACTGCGAGGTGTTAA"	"DCT-like_1"
"GACTGCGCACCGAAAG"	"DCT-like_1"
"GACTGCGCAGACGCAA"	"TPC_1"
"GACTGCGCATAGACTC"	"TPC_2"
"GACTGCGGTCAGCTAT"	"Prolif.TPC"
"GAGCAGATCCGCATAA"	"TPC_2"
"GAGGTGACAGATCCAT"	"DCT-like_2"
"GAGGTGACAGTTTACG"	"DCT-like_1"
"GAGGTGAGTCCCTACT"	"TPC_1"
"GAGTCCGCAAGAAGAG"	"Prolif.TPC"
"GAGTCCGCATGCTAGT"	"TPC_1"
"GAGTCCGGTCTAGCGC"	"TPC_1"
"GAGTCCGGTTCGGGCT"	"TPC_1"
"GAGTCCGTCTCCTATA"	"DCT-like_2"
"GATCAGTCATACTACG"	"TPC_1"
"GATCAGTGTACTCTCC"	"TPC_1"
"GATCAGTGTGTATGGG"	"DCT-like_2"
"GATCGATAGCTAGCCC"	"TPC_1"
"GATCGATAGGGCTTGA"	"TPC_1"
"GATCGATCACGGTTTA"	"TPC_2"
"GATCGATCATCACGTA"	"DCT-like_1"
"GATCGATGTAAAGTCA"	"TPC_1"
"GATCGATGTTATGTGC"	"TPC_1"
"GATCGATGTTGAGGTG"	"DCT-like_2"
"GATCGATTCCGTACAA"	"DCT-like_2"
"GATCGCGAGATGTGTA"	"TPC_1"
"GATCGCGAGCGATGAC"	"TPC_3"
"GATCGCGCAGTAAGAT"	"TPC_2"
"GATCGCGGTTTGACAC"	"TPC_2"
"GATCGCGTCACTATTC"	"TPC_1"
"GATCGCGTCCACGACG"	"Prolif.TPC"
"GATCGTAAGATGCCAG"	"Epith.:HighRibo"
"GATCGTAAGCCTTGAT"	"PEC-like_1"
"GATCGTAAGGAGTTTA"	"TPC_1"
"GATCGTACAACGCACC"	"PEC-like_2"
"GATCGTACAGGTCTCG"	"DCT-like_1"
"GATCGTAGTAAATGAC"	"TPC_1"
"GATCGTAGTTTGTGTG"	"TPC_1"
"GATCTAGCATAGACTC"	"DCT-like_1"
"GATCTAGGTCTAGTGT"	"TPC_1"
"GATCTAGTCTTTAGGG"	"TPC_2"
"GATGAAAAGGTAGCCA"	"Prolif.TPC"
"GATGAAACACAACTGT"	"TPC_1"
"GATGAAACATCCCACT"	"TPC_1"
"GATGAAATCCAAGTAC"	"TPC_1"
"GATGAGGAGGTAGCTG"	"DCT-like_2"
"GATGAGGCAGAGTGTG"	"DCT-like_2"
"GATGAGGCAGGCGATA"	"DCT-like_2"
"GATGAGGTCGCCAAAT"	"TPC_3"
"GATGCTACAAAGTGCG"	"TPC_3"
"GATGCTAGTTCACCTC"	"DCT-like_1"
"GATGCTATCAGAGCTT"	"TPC_3"
"GATGCTATCCGCTGTT"	"Prolif.TPC"
"GATTCAGAGATAGGAG"	"TPC_1"
"GATTCAGCAATCAGAA"	"DCT-like_1"
"GATTCAGCAATCGGTT"	"TPC_1"
"GATTCAGCACCCATTC"	"TPC_1"
"GATTCAGGTTACGTCA"	"Prolif.TPC"
"GCAAACTAGTACGTTC"	"DCT-like_2"
"GCAAACTCAGCAGTTT"	"TPC_2"
"GCAAACTCAGGCGATA"	"TPC_1"
"GCAAACTGTCGAAAGC"	"TPC_1"
"GCAAACTGTGCAGTAG"	"DCT-like_2"
"GCAAACTTCACCATAG"	"DCT-like_1"
"GCAAACTTCTCAAGTG"	"DCT-like_2"
"GCAAACTTCTGACCTC"	"TPC_1"
"GCAATCAAGCTATGCT"	"TPC_1"
"GCAATCAAGTAGATGT"	"TPC_2"
"GCAATCACAATGGAGC"	"DCT-like_2"
"GCAATCAGTTATCGGT"	"DCT-like_2"
"GCAATCATCGGCCGAT"	"Prolif.TPC"
"GCACATACACGCGAAA"	"TPC_1"
"GCACATACAGCATACT"	"DCT-like_2"
"GCACATACAGGGCATA"	"TPC_2"
"GCACATACATCCGGGT"	"DCT-like_2"
"GCACATACATCGTCGG"	"TPC_1"
"GCACATAGTAAATGTG"	"DCT-like_1"
"GCACATAGTCATACTG"	"DCT-like_1"
"GCACATATCGCCCTTA"	"TPC_1"
"GCACTCTAGGGCTTCC"	"TPC_2"
"GCACTCTGTTCCACTC"	"TPC_2"
"GCACTCTTCTCTTGAT"	"DCT-like_2"
"GCACTCTTCTGTCTCG"	"DCT-like_1"
"GCAGCCAAGGGAACGG"	"DCT-like_2"
"GCAGCCACAACACGCC"	"TPC_3"
"GCAGCCAGTATATGAG"	"Prolif.TPC"
"GCAGCCAGTTACGACT"	"TPC_1"
"GCAGCCAGTTTGGCGC"	"Prolif.TPC"
"GCAGCCATCCGTACAA"	"DCT-like_2"
"GCAGCCATCTCCGGTT"	"PEC-like_1"
"GCAGTTAAGAAGGTTT"	"PEC-like_1"
"GCAGTTAAGGGAACGG"	"TPC_1"
"GCAGTTAAGTTAACGA"	"DCT-like_2"
"GCAGTTACATGTAAGA"	"TPC_1"
"GCAGTTAGTTCAGGCC"	"TPC_2"
"GCAGTTAGTTGCTCCT"	"TPC_2"
"GCATACAAGTAGATGT"	"PEC-like_1"
"GCATACACATCTCCCA"	"TPC_1"
"GCATACATCTGTCAAG"	"TPC_2"
"GCATGATAGTTAAGTG"	"Prolif.TPC"
"GCATGATAGTTGTAGA"	"TPC_2"
"GCATGATCAAGCCGCT"	"TPC_1"
"GCATGATGTACTTAGC"	"TPC_2"
"GCATGATGTCTTCTCG"	"DCT-like_1"
"GCATGATTCCAGAAGG"	"DCT-like_1"
"GCATGATTCCGATATG"	"DCT-like_2"
"GCATGCGAGATGGCGT"	"TPC_3"
"GCATGCGCATCCCACT"	"TPC_1"
"GCATGCGGTATATCCG"	"TPC_3"
"GCATGCGGTTACGGAG"	"TPC_1"
"GCATGTAAGTTTCCTT"	"TPC_3"
"GCATGTACAGACGCAA"	"TPC_1"
"GCATGTAGTCCGACGT"	"TPC_1"
"GCATGTATCTACTTAC"	"TPC_3"
"GCCAAATAGGACAGAA"	"TPC_2"
"GCCAAATGTCACTGGC"	"Prolif.TPC"
"GCCAAATGTCATATCG"	"DCT-like_1"
"GCCAAATTCCCTAATT"	"Prolif.TPC"
"GCCAAATTCCTACAGA"	"TPC_2"
"GCCTCTAAGCCGGTAA"	"TPC_2"
"GCCTCTAAGCGTGTCC"	"DCT-like_2"
"GCCTCTAAGCTGCCCA"	"TPC_1"
"GCCTCTACAATCTACG"	"TPC_3"
"GCCTCTAGTCGGGTCT"	"DCT-like_1"
"GCCTCTAGTGAGTATA"	"DCT-like_1"
"GCCTCTAGTGTCTGAT"	"TPC_2"
"GCGACCAAGGAATGGA"	"TPC_3"
"GCGACCACAGACGCCT"	"PEC-like_2"
"GCGAGAACAATGGACG"	"DCT-like_2"
"GCGAGAACAGTATGCT"	"TPC_1"
"GCGAGAAGTACTCGCG"	"TPC_1"
"GCGAGAAGTCATATCG"	"Prolif.TPC"
"GCGAGAAGTCGCATAT"	"TPC_2"
"GCGAGAAGTCGTTGTA"	"TPC_1"
"GCGAGAATCGCCAGCA"	"TPC_2"
"GCGAGAATCGTACGGC"	"Prolif.TPC"
"GCGCAACCAACACCTA"	"TPC_2"
"GCGCAACCACTGCCAG"	"TPC_1"
"GCGCAACCATGTCTCC"	"TPC_1"
"GCGCAACGTAATCGTC"	"DCT-like_1"
"GCGCAACGTATTCTCT"	"DCT-like_2"
"GCGCAACGTGCCTGGT"	"TPC_1"
"GCGCAACGTGTTCGAT"	"DCT-like_2"
"GCGCAACTCGCCATAA"	"DCT-like_2"
"GCGCCAACATCTATGG"	"TPC_1"
"GCGCCAATCTAACCGA"	"TPC_2"
"GCGCGATAGCACCGTC"	"DCT-like_1"
"GCGCGATAGGATGGAA"	"TPC_3"
"GCGCGATAGGCAATTA"	"TPC_1"
"GCGCGATAGGCTAGCA"	"TPC_1"
"GCGCGATAGTGGTCCC"	"Epith.:HighMT"
"GCGCGATGTAAACCTC"	"TPC_1"
"GCGGGTTAGCCGATTT"	"Epith.:HighRibo"
"GCGGGTTAGCTTTGGT"	"PEC-like_1"
"GCGGGTTCATGATCCA"	"DCT-like_2"
"GCTCCTACAATCCGAT"	"TPC_2"
"GCTCCTACACAGGAGT"	"DCT-like_2"
"GCTCCTAGTGTGGCTC"	"TPC_1"
"GCTCCTAGTTAGTGGG"	"TPC_1"
"GCTCCTATCTCGAGTA"	"Prolif.TPC"
"GCTCTGTCATGTTCCC"	"TPC_2"
"GCTCTGTTCACCCGAG"	"Prolif.TPC"
"GCTGCAGCAGGTCCAC"	"Prolif.TPC"
"GCTGCAGCATGACGGA"	"TPC_3"
"GCTGCAGCATTCGACA"	"TPC_2"
"GCTGCAGGTCAACATC"	"TPC_3"
"GCTGCAGGTGTGGTTT"	"DCT-like_2"
"GCTGCAGGTTCGCGAC"	"Prolif.TPC"
"GCTGCAGTCCATTCTA"	"TPC_2"
"GCTGCAGTCCCTTGCA"	"TPC_1"
"GCTGCAGTCGTCTGAA"	"DCT-like_1"
"GCTGCAGTCTTTAGGG"	"TPC_1"
"GCTGCGAGTGCAGTAG"	"DCT-like_2"
"GCTGCGATCGGAAACG"	"DCT-like_2"
"GCTGCTTAGGATATAC"	"TPC_2"
"GCTGCTTAGTGGTAAT"	"DCT-like_2"
"GCTGCTTCAACTGCGC"	"DCT-like_2"
"GCTGCTTCAGGACGTA"	"TPC_1"
"GCTGCTTGTCACTGGC"	"Prolif.TPC"
"GCTGCTTGTCATGCCG"	"TPC_3"
"GCTGCTTGTCCATGAT"	"TPC_1"
"GCTGCTTGTCGCATCG"	"DCT-like_1"
"GCTGCTTGTCTTTCAT"	"TPC_3"
"GCTGCTTTCATGTAGC"	"DCT-like_2"
"GCTGGGTAGAGGGCTT"	"TPC_1"
"GCTGGGTAGGTCATCT"	"TPC_1"
"GCTTCCAAGAGGGCTT"	"DCT-like_2"
"GCTTCCAAGGTCGGAT"	"DCT-like_1"
"GCTTCCACAAGCGTAG"	"DCT-like_1"
"GCTTCCACACCTGGTG"	"DCT-like_2"
"GCTTCCAGTCATCGGC"	"TPC_1"
"GCTTCCATCGCCATAA"	"PEC-like_1"
"GCTTGAACACGGCGTT"	"TPC_3"
"GCTTGAACAGTACACT"	"TPC_1"
"GCTTGAAGTTACGACT"	"DCT-like_2"
"GCTTGAAGTTCACCTC"	"DCT-like_1"
"GCTTGAATCTAGCACA"	"TPC_2"
"GGAAAGCGTGGACGAT"	"TPC_1"
"GGAAAGCTCTTCAACT"	"TPC_2"
"GGAACTTAGCGTGAAC"	"Prolif.TPC"
"GGAACTTAGTCTCCTC"	"TPC_1"
"GGAACTTCAGGATTGG"	"TPC_1"
"GGAACTTTCACTTACT"	"Prolif.TPC"
"GGAATAAAGACAGACC"	"TPC_3"
"GGAATAAAGGGATACC"	"DCT-like_2"
"GGAATAACACGGCCAT"	"TPC_2"
"GGAATAACAGGGTACA"	"Epith.:HighRibo"
"GGAATAACAGTACACT"	"DCT-like_1"
"GGAATAATCCCTAACC"	"TPC_2"
"GGAATAATCTGTTGAG"	"DCT-like_1"
"GGACAAGAGCAGGCTA"	"TPC_1"
"GGACAAGAGGCGACAT"	"TPC_2"
"GGACAAGAGGTGCTTT"	"DCT-like_1"
"GGACAAGTCAAGCCTA"	"Epith.:HighRibo"
"GGACAAGTCCATGCTC"	"DCT-like_1"
"GGACAGAAGTTCGCGC"	"DCT-like_2"
"GGACAGACAAAGCGGT"	"TPC_2"
"GGACAGACATATACGC"	"TPC_1"
"GGACAGATCTCCCTGA"	"PEC-like_2"
"GGACAGATCTTACCTA"	"TPC_2"
"GGACATTAGCCGCCTA"	"DCT-like_1"
"GGACATTGTGCACGAA"	"TPC_1"
"GGACATTGTTGATTGC"	"DCT-like_2"
"GGACATTTCAGGCCCA"	"TPC_1"
"GGACGTCAGTGATCGG"	"DCT-like_1"
"GGACGTCAGTTACGGG"	"TPC_3"
"GGACGTCTCGCGATCG"	"DCT-like_1"
"GGAGCAAAGAACTCGG"	"Prolif.TPC"
"GGAGCAAAGTGGGCTA"	"TPC_2"
"GGAGCAACAAGGACAC"	"Prolif.TPC"
"GGAGCAACAATGACCT"	"DCT-like_2"
"GGAGCAACAGCGTAAG"	"DCT-like_1"
"GGAGCAATCAACCAAC"	"DCT-like_1"
"GGAGCAATCACAACGT"	"Prolif.TPC"
"GGAGCAATCAGCTCGG"	"TPC_3"
"GGAGCAATCATGTAGC"	"TPC_1"
"GGATGTTAGCGTGTCC"	"TPC_2"
"GGATGTTAGTCTTGCA"	"PEC-like_1"
"GGATGTTTCACCTCGT"	"DCT-like_1"
"GGATTACAGTCCGGTC"	"TPC_1"
"GGATTACCAATGCCAT"	"DCT-like_2"
"GGATTACCAGATCGGA"	"TPC_1"
"GGATTACGTAGCCTCG"	"TPC_3"
"GGATTACTCGGAAACG"	"Prolif.TPC"
"GGCAATTAGTACTTGC"	"DCT-like_2"
"GGCAATTAGTGAACGC"	"TPC_2"
"GGCAATTCAAGTAGTA"	"DCT-like_1"
"GGCAATTCATCTGGTA"	"Prolif.TPC"
"GGCAATTGTAGGCTGA"	"TPC_3"
"GGCCGATAGAGCTGCA"	"DCT-like_2"
"GGCCGATAGCGTTTAC"	"TPC_1"
"GGCCGATGTGCGATAG"	"TPC_3"
"GGCCGATTCCGTTGCT"	"TPC_3"
"GGCCGATTCGCGCCAA"	"Prolif.TPC"
"GGCGACTGTGTCGCTG"	"TPC_3"
"GGCGACTTCAACACTG"	"Epith.:HighRibo"
"GGCGTGTAGTAACCCT"	"TPC_2"
"GGCGTGTAGTAGCGGT"	"TPC_2"
"GGCGTGTCATTATCTC"	"TPC_2"
"GGCTCGAAGCACCGCT"	"TPC_3"
"GGCTCGAAGCTGTTCA"	"TPC_2"
"GGCTCGAAGGAGTTGC"	"PEC-like_2"
"GGCTCGACAATACGCT"	"DCT-like_1"
"GGCTCGATCCTCATTA"	"TPC_2"
"GGCTGGTCATGGGAAC"	"DCT-like_1"
"GGCTGGTGTCTCCCTA"	"TPC_1"
"GGCTGGTGTTATCGGT"	"TPC_1"
"GGGAATGCACAGACTT"	"TPC_3"
"GGGAATGCAGTCGTGC"	"DCT-like_2"
"GGGAATGCATAGTAAG"	"DCT-like_2"
"GGGAATGGTTGGGACA"	"Prolif.TPC"
"GGGACCTAGAAGCCCA"	"TPC_1"
"GGGACCTAGTGACTCT"	"TPC_3"
"GGGACCTCAATCTGCA"	"DCT-like_1"
"GGGACCTCACCCTATC"	"PEC-like_1"
"GGGACCTTCCGCATAA"	"DCT-like_1"
"GGGAGATAGGCTAGAC"	"TPC_1"
"GGGAGATCATGTCTCC"	"Epith.:HighMT"
"GGGAGATGTCGTGGCT"	"Prolif.TPC"
"GGGAGATGTGTTGGGA"	"DCT-like_1"
"GGGAGATTCGTGGGAA"	"DCT-like_1"
"GGGAGATTCTTGTTTG"	"TPC_3"
"GGGATGACATGATCCA"	"TPC_3"
"GGGATGAGTCAACATC"	"Epith.:HighRibo"
"GGGATGAGTCCCGACA"	"Prolif.TPC"
"GGGATGATCACCTCGT"	"TPC_3"
"GGGATGATCTTACCGC"	"TPC_2"
"GGGCACTCAACACGCC"	"TPC_2"
"GGGCATCAGCTCTCGG"	"PEC-like_1"
"GGGCATCAGGTGCTAG"	"Prolif.TPC"
"GGGCATCAGTAGGCCA"	"TPC_1"
"GGGCATCCATTTCACT"	"DCT-like_1"
"GGGCATCTCCTTGCCA"	"TPC_1"
"GGGCATCTCCTTGGTC"	"TPC_1"
"GGGTCTGAGAAGAAGC"	"DCT-like_1"
"GGGTCTGAGATGTAAC"	"TPC_2"
"GGGTCTGCATATGCTG"	"DCT-like_1"
"GGGTCTGGTATGCTTG"	"TPC_2"
"GGGTCTGGTCATGCAT"	"DCT-like_2"
"GGGTCTGTCAGCTGGC"	"PEC-like_1"
"GGGTCTGTCCGAATGT"	"TPC_1"
"GGGTCTGTCCTCATTA"	"TPC_3"
"GGGTTGCAGTACGATA"	"Prolif.TPC"
"GGGTTGCAGTCCCACG"	"DCT-like_2"
"GGGTTGCTCCGCATAA"	"TPC_1"
"GGTATTGAGAAACCGC"	"Prolif.TPC"
"GGTATTGAGCGAAGGG"	"DCT-like_2"
"GGTATTGAGTGATCGG"	"TPC_1"
"GGTATTGAGTTCCACA"	"TPC_3"
"GGTATTGCACGGCCAT"	"TPC_1"
"GGTATTGTCACGGTTA"	"TPC_2"
"GGTATTGTCACTTACT"	"TPC_2"
"GGTATTGTCAGCTCTC"	"TPC_1"
"GGTGAAGAGTAGATGT"	"TPC_3"
"GGTGAAGCATCGATTG"	"TPC_1"
"GGTGAAGGTCATACTG"	"DCT-like_1"
"GGTGAAGTCGTACCGG"	"TPC_3"
"GGTGAAGTCTGCGACG"	"DCT-like_1"
"GGTGCGTAGGATATAC"	"TPC_1"
"GGTGCGTAGGTCATCT"	"TPC_3"
"GGTGCGTCAAGGTTTC"	"TPC_2"
"GGTGCGTGTCCGAATT"	"TPC_2"
"GGTGCGTTCCGAGCCA"	"Epith.:HighMT"
"GGTGCGTTCTTGACGA"	"TPC_3"
"GGTGTTACAAATACAG"	"DCT-like_1"
"GGTGTTACAGTTTACG"	"Prolif.TPC"
"GGTGTTATCGCAAACT"	"TPC_1"
"GTAACGTAGATGGCGT"	"TPC_2"
"GTAACGTAGGGATGGG"	"Prolif.TPC"
"GTAACGTAGGTTACCT"	"PEC-like_2"
"GTAACGTAGTGTGGCA"	"Epith.:HighRibo"
"GTAACGTGTATAAACG"	"DCT-like_1"
"GTAACGTTCTGGCGTG"	"TPC_1"
"GTAACTGAGAGTAATC"	"Epith.:HighMT"
"GTAACTGCAGGTCTCG"	"TPC_2"
"GTAACTGTCTGGTGTA"	"DCT-like_2"
"GTACGTAAGTGCGTGA"	"DCT-like_1"
"GTACGTACAATTCCTT"	"Prolif.TPC"
"GTACGTAGTACACCGC"	"TPC_1"
"GTACGTAGTCCATGAT"	"TPC_2"
"GTACGTAGTTACGCGC"	"TPC_2"
"GTACGTAGTTCAGTAC"	"TPC_1"
"GTACGTAGTTCTGAAC"	"DCT-like_2"
"GTACGTATCATTGCCC"	"PEC-like_1"
"GTACGTATCCACTGGG"	"TPC_3"
"GTACTCCAGAAACCTA"	"TPC_2"
"GTACTCCAGGATGCGT"	"TPC_2"
"GTACTCCAGGGCACTA"	"TPC_1"
"GTACTCCCAAGAGTCG"	"TPC_3"
"GTACTCCCACATGGGA"	"TPC_3"
"GTACTCCCAGCTGTGC"	"DCT-like_1"
"GTACTCCGTCCGAGTC"	"DCT-like_2"
"GTACTCCGTGCGGTAA"	"DCT-like_1"
"GTACTCCGTGTAAGTA"	"DCT-like_1"
"GTACTCCTCATTATCC"	"TPC_1"
"GTACTCCTCCTTTCGG"	"DCT-like_2"
"GTACTCCTCTGTCAAG"	"TPC_2"
"GTACTTTAGATAGCAT"	"DCT-like_1"
"GTACTTTGTACCTACA"	"Prolif.TPC"
"GTACTTTGTCCAAGTT"	"DCT-like_1"
"GTACTTTGTCGCGGTT"	"TPC_2"
"GTACTTTTCCTTTACA"	"DCT-like_2"
"GTAGGCCAGGTAAACT"	"DCT-like_2"
"GTAGGCCAGTACCGGA"	"Prolif.TPC"
"GTAGGCCAGTGGGTTG"	"TPC_2"
"GTAGGCCCACAGAGGT"	"DCT-like_1"
"GTAGGCCCATTTGCCC"	"DCT-like_1"
"GTAGGCCCATTTGCTT"	"PEC-like_2"
"GTAGGCCGTTACCAGT"	"Prolif.TPC"
"GTAGGCCTCAGCTGGC"	"TPC_2"
"GTAGGCCTCCAGGGCT"	"TPC_3"
"GTAGGCCTCGCAGGCT"	"DCT-like_1"
"GTAGGCCTCGCTTGTC"	"TPC_1"
"GTAGTCACACATGTGT"	"DCT-like_1"
"GTAGTCAGTAGGGTAC"	"DCT-like_1"
"GTAGTCATCATTTGGG"	"PEC-like_1"
"GTAGTCATCTGACCTC"	"DCT-like_1"
"GTATCTTAGAAGGCCT"	"DCT-like_2"
"GTATTCTCAAGCGTAG"	"Prolif.TPC"
"GTATTCTCAATTGCTG"	"TPC_1"
"GTATTCTCAGCTGCTG"	"TPC_1"
"GTATTCTCATTACGAC"	"PEC-like_1"
"GTATTCTGTTGATTCG"	"PEC-like_2"
"GTCAAGTAGGACACCA"	"TPC_2"
"GTCAAGTCAATGGATA"	"DCT-like_1"
"GTCAAGTCATCAGTAC"	"DCT-like_1"
"GTCAAGTGTGATGATA"	"TPC_3"
"GTCACAAAGGACGAAA"	"TPC_1"
"GTCACAAAGTTAGGTA"	"TPC_2"
"GTCACAACAACACGCC"	"TPC_1"
"GTCACAACACGGCTAC"	"DCT-like_1"
"GTCACAACACTTCGAA"	"TPC_2"
"GTCACAACATATGCTG"	"TPC_1"
"GTCACAATCTGATACG"	"TPC_2"
"GTCACGGAGAGTAATC"	"TPC_1"
"GTCACGGAGTGGTCCC"	"TPC_1"
"GTCACGGCAAGGACTG"	"DCT-like_2"
"GTCACGGGTCTTCTCG"	"TPC_1"
"GTCACGGGTTCGTGAT"	"TPC_2"
"GTCATTTCAAATTGCC"	"TPC_1"
"GTCATTTCAACACCCG"	"TPC_2"
"GTCATTTCATCGGGTC"	"DCT-like_1"
"GTCATTTGTCCGTGAC"	"TPC_1"
"GTCATTTGTTAAGTAG"	"Epith.:HighRibo"
"GTCATTTTCTCGCATC"	"Prolif.TPC"
"GTCCTCAAGCGACGTA"	"TPC_3"
"GTCCTCACAGCTGGCT"	"PEC-like_2"
"GTCCTCACAGTGGGAT"	"TPC_1"
"GTCCTCACATCAGTAC"	"TPC_2"
"GTCCTCAGTGTATGGG"	"TPC_3"
"GTCCTCAGTTGATTCG"	"TPC_3"
"GTCCTCATCGTCACGG"	"DCT-like_1"
"GTCGGGTAGAGTAAGG"	"TPC_3"
"GTCGGGTAGCAATATG"	"TPC_1"
"GTCGGGTCAAGGCTCC"	"DCT-like_2"
"GTCGGGTGTAAGTAGT"	"DCT-like_1"
"GTCGGGTGTCTAGCCG"	"TPC_2"
"GTCGGGTGTTAAAGAC"	"Prolif.TPC"
"GTCGTAAAGTTGAGTA"	"TPC_2"
"GTCGTAACAAATTGCC"	"TPC_2"
"GTCGTAACAGAGTGTG"	"TPC_1"
"GTCGTAAGTCTCCCTA"	"DCT-like_1"
"GTCGTAATCCACGAAT"	"TPC_2"
"GTCGTAATCTGAGGGA"	"TPC_2"
"GTCTCGTGTAGCTCCG"	"Epith.:HighRibo"
"GTCTCGTTCGGCGCAT"	"TPC_1"
"GTCTTCGAGACTAGGC"	"Epith.:HighRibo"
"GTCTTCGAGGCTCAGA"	"TPC_1"
"GTCTTCGCATGGTTGT"	"Prolif.TPC"
"GTCTTCGTCGTTTATC"	"DCT-like_1"
"GTGAAGGAGATGTTAG"	"TPC_2"
"GTGAAGGAGTCGATAA"	"TPC_1"
"GTGAAGGAGTGTGGCA"	"PEC-like_1"
"GTGAAGGCAACGCACC"	"DCT-like_1"
"GTGAAGGCATTGAGCT"	"TPC_1"
"GTGAAGGTCATCTGTT"	"TPC_2"
"GTGAAGGTCGCTTGTC"	"TPC_1"
"GTGAAGGTCTTCATGT"	"Prolif.TPC"
"GTGCAGCAGTACATGA"	"Prolif.TPC"
"GTGCATACAGACGTAG"	"DCT-like_2"
"GTGCATACATCCGGGT"	"TPC_3"
"GTGCATATCACAATGC"	"TPC_1"
"GTGCATATCCCGGATG"	"DCT-like_2"
"GTGCGGTAGGCCCGTT"	"DCT-like_1"
"GTGCGGTGTCGAACAG"	"PEC-like_1"
"GTGCGGTTCTGCTTGC"	"TPC_2"
"GTGCTTCAGCTCTCGG"	"TPC_1"
"GTGCTTCCACCCATGG"	"TPC_1"
"GTGCTTCGTCCGTGAC"	"DCT-like_2"
"GTGCTTCTCAGCGATT"	"PEC-like_2"
"GTGGGTCCATCCCACT"	"PEC-like_1"
"GTGGGTCTCAACGAAA"	"TPC_2"
"GTGGGTCTCAAGCCTA"	"TPC_1"
"GTGGGTCTCGCTGATA"	"TPC_1"
"GTGTGCGAGATAGCAT"	"DCT-like_1"
"GTGTGCGAGCGTCAAG"	"TPC_1"
"GTGTGCGTCTCAAGTG"	"PEC-like_1"
"GTGTGCGTCTCGTATT"	"DCT-like_2"
"GTGTTAGAGATATGCA"	"TPC_3"
"GTGTTAGGTAGCGTCC"	"DCT-like_2"
"GTGTTAGGTGACAAAT"	"TPC_1"
"GTGTTAGTCTGTCCGT"	"DCT-like_2"
"GTTAAGCAGAACAATC"	"DCT-like_1"
"GTTAAGCAGAAGGACA"	"Prolif.TPC"
"GTTAAGCAGAGGGATA"	"DCT-like_1"
"GTTAAGCAGATGCGAC"	"TPC_1"
"GTTAAGCTCAACGAAA"	"Prolif.TPC"
"GTTAAGCTCCGAACGC"	"DCT-like_2"
"GTTACAGAGCCGTCGT"	"TPC_1"
"GTTACAGCAATCAGAA"	"DCT-like_2"
"GTTACAGGTACAGTTC"	"TPC_2"
"GTTACAGTCAGAGACG"	"TPC_2"
"GTTCATTCACACTGCG"	"TPC_3"
"GTTCATTCATTCACTT"	"TPC_3"
"GTTCATTGTAGCGATG"	"TPC_1"
"GTTCATTGTTACCAGT"	"Prolif.TPC"
"GTTCATTGTTCAGACT"	"TPC_1"
"GTTCATTTCAGTTTGG"	"TPC_3"
"GTTCATTTCCGGCACA"	"TPC_2"
"GTTCGGGAGCACAGGT"	"DCT-like_1"
"GTTCGGGCAAGCGAGT"	"TPC_1"
"GTTCGGGCATCCAACA"	"TPC_2"
"GTTCGGGCATTCCTGC"	"TPC_1"
"GTTCGGGGTGCGCTTG"	"PEC-like_2"
"GTTCGGGGTTATGTGC"	"DCT-like_1"
"GTTCGGGGTTGTGGAG"	"PEC-like_1"
"GTTCGGGTCAGCGATT"	"TPC_2"
"GTTCGGGTCCTTGGTC"	"TPC_1"
"GTTCTCGAGCCAGGAT"	"TPC_1"
"GTTCTCGAGCTGATAA"	"DCT-like_2"
"GTTCTCGGTGCCTTGG"	"PEC-like_1"
"GTTTCTATCACTGGGC"	"Epith.:HighRibo"
"GTTTCTATCTGGGCCA"	"DCT-like_2"
"TAAACCGAGTGATCGG"	"Prolif.TPC"
"TAAACCGGTGTGGTTT"	"TPC_2"
"TAAACCGGTTGATTCG"	"Prolif.TPC"
"TAAACCGTCGACCAGC"	"TPC_3"
"TAAACCGTCGGCATCG"	"TPC_3"
"TAAGAGAAGCAAATCA"	"Prolif.TPC"
"TAAGAGAAGTCTCAAC"	"TPC_2"
"TAAGAGAAGTTGTAGA"	"DCT-like_2"
"TAAGAGACAGTTCATG"	"TPC_1"
"TAAGCGTAGGAGTCTG"	"PEC-like_1"
"TAAGCGTCAATGGAGC"	"Epith.:HighMT"
"TAAGCGTGTGTCCTCT"	"TPC_1"
"TAAGCGTTCTGATACG"	"TPC_1"
"TAAGCGTTCTGGTTCC"	"TPC_1"
"TAAGTGCCACCAGGCT"	"DCT-like_1"
"TAAGTGCCATGCCTTC"	"PEC-like_1"
"TAAGTGCGTAAGGGAA"	"TPC_1"
"TAAGTGCTCAAGCCTA"	"TPC_2"
"TAAGTGCTCGGATGGA"	"TPC_2"
"TACACGAAGACGACGT"	"Prolif.TPC"
"TACACGACACCGGAAA"	"DCT-like_2"
"TACACGACATGTCTCC"	"TPC_2"
"TACACGATCCAACCAA"	"TPC_1"
"TACACGATCGGCGCTA"	"Prolif.TPC"
"TACAGTGCAAGAGGCT"	"TPC_1"
"TACAGTGGTATATGGA"	"TPC_1"
"TACAGTGGTGGACGAT"	"TPC_2"
"TACCTATCAGGACCCT"	"DCT-like_1"
"TACCTATGTATCTGCA"	"TPC_3"
"TACCTTAAGTAATCCC"	"TPC_3"
"TACCTTACAGCTCGAC"	"TPC_1"
"TACGGATAGATCTGCT"	"TPC_3"
"TACGGATAGGACTGGT"	"Prolif.TPC"
"TACGGATCAGGGTTAG"	"TPC_1"
"TACGGATGTCTGCGGT"	"Epith.:HighRibo"
"TACGGGCAGAACAACT"	"TPC_1"
"TACGGGCAGCCGTCGT"	"Prolif.TPC"
"TACGGGCAGTCCATAC"	"TPC_1"
"TACGGGCCAATAGCAA"	"TPC_2"
"TACGGTACAAGCCCAC"	"TPC_2"
"TACGGTACATTTCAGG"	"TPC_3"
"TACGGTAGTCTCTCGT"	"TPC_3"
"TACTCATAGACGCAAC"	"DCT-like_1"
"TACTCATAGCAACGGT"	"TPC_2"
"TACTCATAGTGCGTGA"	"TPC_3"
"TACTCATCAGGCGATA"	"TPC_3"
"TACTCGCAGAGCTGGT"	"PEC-like_1"
"TACTCGCAGCAGGCTA"	"DCT-like_2"
"TACTCGCAGGTGCAAC"	"DCT-like_1"
"TACTCGCCACACATGT"	"PEC-like_1"
"TACTCGCGTCGTTGTA"	"TPC_1"
"TACTCGCGTGGTTTCA"	"DCT-like_2"
"TACTTACAGTCAATAG"	"TPC_2"
"TACTTACCAATGAAAC"	"DCT-like_2"
"TACTTACCATATGGTC"	"TPC_2"
"TACTTACGTAACGCGA"	"DCT-like_2"
"TACTTACTCATAGCAC"	"TPC_1"
"TACTTACTCCGAATGT"	"DCT-like_1"
"TACTTACTCGTGGACC"	"TPC_2"
"TACTTACTCTGGGCCA"	"TPC_2"
"TACTTGTAGACAGGCT"	"TPC_2"
"TACTTGTAGACCACGA"	"TPC_1"
"TACTTGTAGCTGATAA"	"TPC_1"
"TACTTGTGTAAGGGAA"	"Prolif.TPC"
"TACTTGTGTTTGGGCC"	"TPC_1"
"TACTTGTTCAGCTTAG"	"PEC-like_1"
"TACTTGTTCATCACCC"	"PEC-like_1"
"TACTTGTTCCGTTGCT"	"Prolif.TPC"
"TAGACCACAAAGAATC"	"Epith.:HighMT"
"TAGACCACACGTGAGA"	"TPC_1"
"TAGACCACACTACAGT"	"TPC_3"
"TAGACCACAGCGTAAG"	"Prolif.TPC"
"TAGACCAGTAGCTAAA"	"TPC_2"
"TAGACCATCGCTAGCG"	"TPC_1"
"TAGACCATCGTCACGG"	"TPC_2"
"TAGACCATCTAACCGA"	"TPC_3"
"TAGAGCTTCTACTTAC"	"DCT-like_1"
"TAGCCGGAGATGTCGG"	"DCT-like_1"
"TAGCCGGAGGAGTACC"	"TPC_1"
"TAGCCGGCATCACGTA"	"DCT-like_2"
"TAGCCGGGTGGTTTCA"	"TPC_1"
"TAGCCGGTCATGCAAC"	"TPC_3"
"TAGGCATAGTATTGGA"	"TPC_1"
"TAGGCATAGTCAAGCG"	"Prolif.TPC"
"TAGGCATGTCGTCTTC"	"TPC_3"
"TAGGCATGTGGTTTCA"	"TPC_1"
"TAGGCATTCTCGCTTG"	"DCT-like_2"
"TAGGCATTCTGACCTC"	"DCT-like_1"
"TAGTGGTAGAAACCGC"	"Prolif.TPC"
"TAGTGGTAGACGCACA"	"PEC-like_2"
"TAGTGGTAGGATGCGT"	"DCT-like_2"
"TAGTGGTCACCAGTTA"	"TPC_1"
"TAGTGGTCAGCGTAAG"	"Prolif.TPC"
"TAGTGGTCATCGATTG"	"TPC_1"
"TAGTTGGAGCAGACTG"	"DCT-like_2"
"TAGTTGGCAACACGCC"	"TPC_3"
"TAGTTGGTCAGATAAG"	"TPC_2"
"TATCAGGCAAGAGGCT"	"TPC_3"
"TATCAGGCAAGGACTG"	"TPC_2"
"TATCAGGTCACAAACC"	"Epith.:HighRibo"
"TATCAGGTCTAACCGA"	"TPC_2"
"TATCTCAAGACAAAGG"	"TPC_3"
"TATCTCAAGAGGGCTT"	"DCT-like_1"
"TATCTCAAGAGTGAGA"	"TPC_1"
"TATCTCAAGCCAACAG"	"TPC_1"
"TATCTCAAGCTACCGC"	"TPC_1"
"TATCTCATCACCACCT"	"TPC_2"
"TATCTCATCATGTCCC"	"TPC_2"
"TATCTCATCTTAGAGC"	"DCT-like_2"
"TATGCCCAGAAGGTGA"	"Prolif.TPC"
"TATGCCCAGATGAGAG"	"DCT-like_1"
"TATGCCCAGCTCCCAG"	"TPC_3"
"TATGCCCAGGCCGAAT"	"TPC_3"
"TATGCCCCACAGGTTT"	"DCT-like_1"
"TATGCCCGTCTGATCA"	"TPC_3"
"TATGCCCTCAACGGGA"	"TPC_3"
"TATGCCCTCACTCCTG"	"PEC-like_1"
"TATGCCCTCCAACCAA"	"DCT-like_1"
"TATGCCCTCGATCCCT"	"Prolif.TPC"
"TATTACCCACCACGTG"	"DCT-like_1"
"TATTACCGTCCAGTAT"	"TPC_2"
"TATTACCTCAGCGATT"	"TPC_3"
"TCAACGAAGAGCTTCT"	"DCT-like_2"
"TCAACGAAGTGCCAGA"	"TPC_2"
"TCAACGAGTGTGACGA"	"DCT-like_1"
"TCAATCTAGGACTGGT"	"TPC_3"
"TCAATCTAGGGTCTCC"	"TPC_1"
"TCAATCTCAGGATTGG"	"PEC-like_2"
"TCAATCTTCTTCATGT"	"DCT-like_2"
"TCACAAGCAAGACACG"	"TPC_1"
"TCACAAGGTCCAAGTT"	"TPC_1"
"TCACAAGGTCTTCGTC"	"TPC_1"
"TCACAAGGTTCATGGT"	"TPC_2"
"TCACAAGTCAGCTCGG"	"DCT-like_1"
"TCACAAGTCCAAGCCG"	"PEC-like_2"
"TCACGAAAGTACGCCC"	"DCT-like_2"
"TCACGAAAGTAGCCGA"	"DCT-like_1"
"TCACGAAAGTCCTCCT"	"DCT-like_1"
"TCACGAATCAACGGGA"	"TPC_1"
"TCACGAATCCGAACGC"	"TPC_2"
"TCACGAATCCTGCTTG"	"DCT-like_2"
"TCAGATGCAAGTACCT"	"TPC_2"
"TCAGATGGTACCAGTT"	"TPC_3"
"TCAGATGTCTCAAGTG"	"Epith.:HighRibo"
"TCAGCAACAAATTGCC"	"DCT-like_1"
"TCAGCAACATGCCACG"	"Epith.:HighMT"
"TCAGCAAGTAAGTGGC"	"TPC_3"
"TCAGCAAGTCCCTTGT"	"DCT-like_2"
"TCAGCAATCATAAAGG"	"TPC_3"
"TCAGCAATCGAATCCA"	"TPC_1"
"TCAGCAATCGTACCGG"	"DCT-like_2"
"TCAGCAATCTCGGACG"	"DCT-like_2"
"TCAGCAATCTTGAGAC"	"DCT-like_2"
"TCAGCTCCAATGGTCT"	"TPC_1"
"TCAGCTCCAGCTCGAC"	"TPC_2"
"TCAGCTCGTCTCTTAT"	"TPC_1"
"TCAGCTCTCCTCAACC"	"TPC_3"
"TCAGGATAGACTGTAA"	"TPC_1"
"TCAGGATGTACTCTCC"	"DCT-like_1"
"TCAGGATGTCGCTTTC"	"TPC_2"
"TCAGGATTCAACGAAA"	"DCT-like_2"
"TCAGGATTCTGGGCCA"	"DCT-like_2"
"TCAGGTACAACTGCTA"	"Prolif.TPC"
"TCAGGTACAGACAAAT"	"Epith.:HighRibo"
"TCAGGTACAGATGGCA"	"TPC_1"
"TCAGGTAGTCATCGGC"	"TPC_2"
"TCAGGTAGTGCAGGTA"	"Prolif.TPC"
"TCAGGTAGTGTTGGGA"	"Prolif.TPC"
"TCAGGTATCACGGTTA"	"DCT-like_1"
"TCAGGTATCTACTCAT"	"PEC-like_1"
"TCATTACAGTGAAGTT"	"DCT-like_2"
"TCATTACCAGGGCATA"	"Epith.:HighRibo"
"TCATTACGTTAAGTAG"	"DCT-like_1"
"TCATTACTCCGTCATC"	"TPC_1"
"TCATTTGAGGAGCGAG"	"TPC_2"
"TCATTTGCAGGTCGTC"	"TPC_1"
"TCATTTGCATCTCCCA"	"TPC_2"
"TCATTTGCATGACGGA"	"Epith.:HighRibo"
"TCATTTGGTAACGACG"	"Prolif.TPC"
"TCATTTGGTACCGGCT"	"TPC_2"
"TCATTTGTCTACCTGC"	"DCT-like_2"
"TCCACACAGTCCCACG"	"TPC_1"
"TCCACACCATCCGTGG"	"TPC_1"
"TCCACACGTAACGCGA"	"DCT-like_2"
"TCCACACGTATAATGG"	"TPC_1"
"TCCACACGTCTACCTC"	"DCT-like_2"
"TCCACACGTGAAAGAG"	"Prolif.TPC"
"TCCACACTCCTCAACC"	"TPC_1"
"TCCCGATCATCGGGTC"	"TPC_3"
"TCCCGATCATGCCCGA"	"Prolif.TPC"
"TCCCGATGTTTAGGAA"	"TPC_1"
"TCGAGGCAGAGTCGGT"	"TPC_2"
"TCGAGGCAGCCGTCGT"	"Prolif.TPC"
"TCGAGGCCACGCGAAA"	"DCT-like_1"
"TCGAGGCGTATCAGTC"	"DCT-like_2"
"TCGAGGCGTGGACGAT"	"DCT-like_2"
"TCGAGGCGTTAGTGGG"	"Epith.:HighMT"
"TCGAGGCTCGTGACAT"	"TPC_1"
"TCGAGGCTCTACTTAC"	"Prolif.TPC"
"TCGAGGCTCTGCTGCT"	"TPC_3"
"TCGCGAGAGGCGATAC"	"TPC_2"
"TCGCGAGCAAGCTGTT"	"DCT-like_2"
"TCGCGAGCAATAACGA"	"TPC_2"
"TCGCGAGCATCCGTGG"	"Prolif.TPC"
"TCGCGAGGTCCGAAGA"	"DCT-like_1"
"TCGCGAGGTTACGACT"	"TPC_3"
"TCGCGAGTCACTCCTG"	"TPC_1"
"TCGCGTTAGCGTCAAG"	"DCT-like_2"
"TCGCGTTCAGGTCGTC"	"DCT-like_1"
"TCGCGTTTCACAACGT"	"DCT-like_1"
"TCGCGTTTCAGGCCCA"	"TPC_2"
"TCGCGTTTCCTATGTT"	"DCT-like_1"
"TCGCGTTTCGTGGACC"	"DCT-like_1"
"TCGGGACAGTTAACGA"	"TPC_1"
"TCGGGACCAGTGAGTG"	"TPC_1"
"TCGGGACGTGCTCTTC"	"DCT-like_2"
"TCGGTAAAGTGGGATC"	"DCT-like_1"
"TCGGTAACAAGTCTGT"	"DCT-like_1"
"TCGGTAAGTACCGCTG"	"DCT-like_1"
"TCGGTAAGTAGCGTGA"	"DCT-like_2"
"TCGGTAATCTGGTATG"	"TPC_2"
"TCGTACCCATGGTAGG"	"TPC_3"
"TCGTACCGTCCAGTGC"	"DCT-like_1"
"TCGTAGAAGCTACCTA"	"TPC_1"
"TCGTAGACAGGGTACA"	"DCT-like_2"
"TCGTAGATCACCCTCA"	"TPC_1"
"TCGTAGATCATCTGTT"	"TPC_3"
"TCGTAGATCGTCCGTT"	"DCT-like_2"
"TCGTAGATCTCTGCTG"	"TPC_2"
"TCGTAGATCTGTTGAG"	"TPC_1"
"TCTATTGAGGTGATTA"	"TPC_3"
"TCTATTGCAATCGAAA"	"TPC_2"
"TCTCATAAGTTGCAGG"	"DCT-like_2"
"TCTCATACAAGTACCT"	"TPC_1"
"TCTCATACATACTCTT"	"TPC_1"
"TCTCATAGTTGCGTTA"	"TPC_1"
"TCTCATAGTTTCCACC"	"TPC_1"
"TCTCATATCAACACCA"	"TPC_3"
"TCTCATATCCAAATGC"	"TPC_1"
"TCTCTAAAGACCACGA"	"TPC_1"
"TCTCTAAGTCTCTCGT"	"Prolif.TPC"
"TCTCTAAGTCTTGTCC"	"TPC_3"
"TCTCTAAGTGGCGAAT"	"DCT-like_1"
"TCTCTAAGTTTGGGCC"	"TPC_1"
"TCTCTAATCGTGGACC"	"DCT-like_2"
"TCTCTAATCTCTTATG"	"Prolif.TPC"
"TCTGAGACAAACGCGA"	"DCT-like_1"
"TCTGAGAGTCTCAACA"	"Prolif.TPC"
"TCTGAGAGTGGACGAT"	"TPC_1"
"TCTGAGATCCAACCAA"	"PEC-like_1"
"TCTGAGATCGGAAACG"	"TPC_1"
"TCTGGAAAGAGTGACC"	"TPC_1"
"TCTGGAACATCCGTGG"	"PEC-like_1"
"TCTGGAAGTCCATGAT"	"TPC_1"
"TCTTCGGAGTGTCCAT"	"TPC_3"
"TCTTCGGTCAGAGCTT"	"DCT-like_2"
"TCTTCGGTCCTCAATT"	"DCT-like_1"
"TCTTCGGTCTACCAGA"	"TPC_2"
"TCTTTCCGTAATCGTC"	"TPC_1"
"TCTTTCCGTGGACGAT"	"DCT-like_1"
"TCTTTCCTCAGGTTCA"	"DCT-like_2"
"TCTTTCCTCCTTAATC"	"TPC_1"
"TCTTTCCTCTTGAGGT"	"TPC_2"
"TGAAAGAAGTCCATAC"	"TPC_2"
"TGAAAGACAATAGAGT"	"TPC_2"
"TGAAAGACACATCTTT"	"TPC_1"
"TGAAAGAGTAAGGGCT"	"Epith.:HighMT"
"TGAAAGAGTTTCCACC"	"TPC_1"
"TGAAAGATCAAACCGT"	"TPC_1"
"TGAAAGATCCAAACAC"	"TPC_1"
"TGAAAGATCTGGCGTG"	"TPC_1"
"TGACAACAGTGTCCAT"	"DCT-like_1"
"TGACAACCACGAGAGT"	"TPC_3"
"TGACAACCACTTCTGC"	"TPC_1"
"TGACAACGTCATGCCG"	"TPC_2"
"TGACAACTCAGCTCTC"	"Epith.:HighMT"
"TGACAACTCATCGCTC"	"DCT-like_2"
"TGACGGCAGTAACCCT"	"Epith.:HighMT"
"TGACGGCCAAGCGTAG"	"Epith.:HighMT"
"TGACGGCCAATCCAAC"	"TPC_2"
"TGACGGCCACGAAAGC"	"DCT-like_1"
"TGACGGCCATGAGCGA"	"TPC_2"
"TGACGGCGTCTGATCA"	"DCT-like_1"
"TGACGGCGTCTTGATG"	"PEC-like_1"
"TGACGGCGTTCAGACT"	"TPC_3"
"TGACGGCTCACTGGGC"	"TPC_3"
"TGACTAGAGCTCCTTC"	"PEC-like_1"
"TGACTAGAGTATGACA"	"DCT-like_1"
"TGACTAGAGTTGAGAT"	"DCT-like_1"
"TGACTAGGTCACCCAG"	"Prolif.TPC"
"TGACTAGGTCGTTGTA"	"PEC-like_1"
"TGACTAGTCAGGTAAA"	"TPC_1"
"TGACTAGTCCCAAGAT"	"DCT-like_2"
"TGACTAGTCGTCTGCT"	"Prolif.TPC"
"TGACTAGTCTTTCCTC"	"Epith.:HighRibo"
"TGACTTTAGTGGAGAA"	"DCT-like_2"
"TGACTTTCAGTATCTG"	"DCT-like_1"
"TGACTTTCATGCCACG"	"DCT-like_2"
"TGACTTTGTCGAGTTT"	"DCT-like_1"
"TGACTTTGTGTTCTTT"	"TPC_2"
"TGACTTTTCCAATGGT"	"TPC_2"
"TGAGAGGCAAACTGCT"	"TPC_1"
"TGAGAGGCACACATGT"	"TPC_1"
"TGAGAGGGTATGGTTC"	"DCT-like_1"
"TGAGAGGGTTCCACTC"	"TPC_3"
"TGAGAGGTCTGCTGCT"	"TPC_3"
"TGAGCATCAGTGGGAT"	"Prolif.TPC"
"TGAGCATGTGCTTCTC"	"TPC_3"
"TGAGCATTCAATAAGG"	"DCT-like_1"
"TGAGCATTCGAGAGCA"	"TPC_3"
"TGAGCATTCGGCGCTA"	"DCT-like_1"
"TGAGCCGAGAAGGTTT"	"TPC_2"
"TGAGCCGCAATGGAAT"	"TPC_1"
"TGAGCCGCATTCTCAT"	"Prolif.TPC"
"TGAGCCGGTACCGTAT"	"TPC_2"
"TGAGCCGGTTGTACAC"	"DCT-like_1"
"TGAGGGAAGCTACCTA"	"DCT-like_1"
"TGAGGGAAGGATATAC"	"DCT-like_1"
"TGAGGGACACAGGAGT"	"TPC_3"
"TGAGGGATCTTAACCT"	"TPC_3"
"TGATTTCCAAGCCATT"	"DCT-like_1"
"TGATTTCCAGGAATGC"	"TPC_2"
"TGATTTCGTAGAGTGC"	"PEC-like_1"
"TGATTTCTCTTCAACT"	"TPC_2"
"TGCACCTAGTAGCGGT"	"TPC_1"
"TGCACCTCAAGCCGCT"	"TPC_1"
"TGCACCTCAATAAGCA"	"DCT-like_1"
"TGCACCTCACCTATCC"	"TPC_1"
"TGCACCTCAGAGTGTG"	"DCT-like_1"
"TGCACCTGTCTCGTTC"	"Epith.:HighRibo"
"TGCACCTTCTCGAGTA"	"TPC_2"
"TGCACCTTCTGCTTGC"	"DCT-like_1"
"TGCCAAAAGCGCTCCA"	"DCT-like_1"
"TGCCAAAAGCGTCAAG"	"DCT-like_2"
"TGCCAAAAGGTACTCT"	"Prolif.TPC"
"TGCCAAACAATAGCAA"	"TPC_3"
"TGCCCATAGGTGTTAA"	"TPC_3"
"TGCCCTAAGCCGGTAA"	"DCT-like_2"
"TGCCCTACATGCCCGA"	"TPC_2"
"TGCCCTATCAACTCTT"	"DCT-like_1"
"TGCGCAGAGAATTGTG"	"TPC_2"
"TGCGCAGAGCTGCGAA"	"TPC_3"
"TGCGCAGCAGTACACT"	"TPC_3"
"TGCGCAGGTGACAAAT"	"DCT-like_1"
"TGCGCAGGTTCGTGAT"	"DCT-like_2"
"TGCGGGTTCAGGCGAA"	"DCT-like_1"
"TGCGGGTTCTTGAGAC"	"PEC-like_1"
"TGCGTGGAGCGTTGCC"	"TPC_3"
"TGCGTGGTCCCGGATG"	"TPC_2"
"TGCTACCAGAGTGACC"	"Prolif.TPC"
"TGCTACCAGCCACCTG"	"TPC_3"
"TGCTACCAGCGAGAAA"	"TPC_1"
"TGCTACCCAATCTGCA"	"DCT-like_1"
"TGCTACCCAATGGACG"	"PEC-like_2"
"TGCTACCCATGCCTTC"	"TPC_1"
"TGCTACCGTAGTACCT"	"Prolif.TPC"
"TGCTACCTCGATCCCT"	"TPC_3"
"TGCTACCTCGTGGTCG"	"TPC_3"
"TGCTGCTAGCCACGTC"	"Prolif.TPC"
"TGCTGCTAGGATGGTC"	"DCT-like_1"
"TGCTGCTCAACGATCT"	"TPC_1"
"TGCTGCTCAATGGAAT"	"TPC_1"
"TGCTGCTCACCGAAAG"	"TPC_1"
"TGCTGCTCACGAAATA"	"TPC_2"
"TGCTGCTGTACGCTGC"	"TPC_1"
"TGCTGCTGTCGGCTCA"	"TPC_3"
"TGCTGCTGTTCGTTGA"	"TPC_3"
"TGCTGCTTCAACGCTA"	"DCT-like_1"
"TGGACGCAGCTGCCCA"	"TPC_1"
"TGGACGCAGCTGTCTA"	"DCT-like_2"
"TGGACGCCACGACTCG"	"TPC_2"
"TGGACGCGTAAGGGAA"	"Prolif.TPC"
"TGGACGCGTATAGGGC"	"Prolif.TPC"
"TGGCCAGCAGACGCAA"	"DCT-like_1"
"TGGCCAGCATTGAGCT"	"PEC-like_2"
"TGGCCAGGTAGCTCCG"	"TPC_1"
"TGGCCAGGTCAATACC"	"TPC_3"
"TGGCCAGGTCCGAAGA"	"TPC_1"
"TGGCCAGGTCGAATCT"	"TPC_2"
"TGGCCAGGTGACTCAT"	"TPC_2"
"TGGCCAGTCACTTACT"	"DCT-like_1"
"TGGCCAGTCGGCTTGG"	"Prolif.TPC"
"TGGCCAGTCTCGCTTG"	"DCT-like_1"
"TGGCGCAAGCCACCTG"	"TPC_2"
"TGGCGCAAGCTTATCG"	"Prolif.TPC"
"TGGCGCAAGTGTACTC"	"DCT-like_1"
"TGGCGCACACAAGTAA"	"TPC_1"
"TGGCGCAGTAAGAGGA"	"TPC_2"
"TGGCGCATCGGGAGTA"	"Epith.:HighRibo"
"TGGCTGGAGTGCGATG"	"TPC_1"
"TGGCTGGCATGGATGG"	"TPC_1"
"TGGCTGGGTCAAAGAT"	"PEC-like_1"
"TGGCTGGGTTAGATGA"	"DCT-like_2"
"TGGCTGGTCACATAGC"	"Epith.:HighMT"
"TGGCTGGTCGCTTAGA"	"DCT-like_1"
"TGGCTGGTCTTGAGAC"	"PEC-like_2"
"TGGGAAGAGTGCTGCC"	"TPC_1"
"TGGGAAGCACCCATGG"	"TPC_3"
"TGGGAAGGTAGGGTAC"	"DCT-like_2"
"TGGGAAGGTGAGTATA"	"DCT-like_2"
"TGGGAAGTCGAGAGCA"	"TPC_1"
"TGGGAAGTCGCTTAGA"	"TPC_1"
"TGGGCGTAGCTAAGAT"	"DCT-like_1"
"TGGGCGTCAAACTGCT"	"DCT-like_2"
"TGGGCGTGTCGGATCC"	"TPC_1"
"TGGGCGTGTGGTCCGT"	"PEC-like_2"
"TGGGCGTTCCTAAGTG"	"PEC-like_1"
"TGGTTAGAGAGTCGGT"	"DCT-like_2"
"TGGTTAGAGGTGCAAC"	"Epith.:HighRibo"
"TGGTTAGCAGATTGCT"	"Prolif.TPC"
"TGGTTAGCATTGCGGC"	"DCT-like_2"
"TGGTTAGGTTATCACG"	"Prolif.TPC"
"TGGTTCCAGCTCCTCT"	"TPC_2"
"TGGTTCCCAGGGTATG"	"DCT-like_1"
"TGGTTCCGTCGGCACT"	"Epith.:HighRibo"
"TGGTTCCTCTCACATT"	"Prolif.TPC"
"TGTATTCAGGTAGCCA"	"TPC_1"
"TGTATTCTCCTGCCAT"	"PEC-like_2"
"TGTCCCACAAGAAGAG"	"TPC_2"
"TGTCCCACACAGTCGC"	"DCT-like_2"
"TGTCCCACACCCATGG"	"DCT-like_2"
"TGTCCCACACGCATCG"	"Epith.:HighMT"
"TGTCCCACAGCTGCTG"	"DCT-like_2"
"TGTCCCAGTTGATTGC"	"Prolif.TPC"
"TGTGGTACATAAAGGT"	"TPC_2"
"TGTGGTAGTCTCTCGT"	"Prolif.TPC"
"TGTGGTATCTCCTATA"	"DCT-like_2"
"TGTGGTATCTGGAGCC"	"DCT-like_1"
"TGTGTTTAGCTATGCT"	"DCT-like_1"
"TGTGTTTAGGACAGCT"	"DCT-like_2"
"TGTGTTTAGTTCGATC"	"DCT-like_2"
"TGTGTTTCACAAGTAA"	"TPC_2"
"TGTGTTTCACTTACGA"	"DCT-like_2"
"TGTGTTTCAGCGTCCA"	"Prolif.TPC"
"TGTGTTTGTAGGACAC"	"Prolif.TPC"
"TGTGTTTGTGAGGGAG"	"TPC_1"
"TGTGTTTTCCCATTAT"	"Epith.:HighRibo"
"TGTTCCGAGATGCCTT"	"Prolif.TPC"
"TGTTCCGAGGCCGAAT"	"DCT-like_1"
"TGTTCCGCAGCTGCTG"	"Prolif.TPC"
"TGTTCCGGTTCAACCA"	"Epith.:HighRibo"
"TGTTCCGGTTGATTCG"	"TPC_2"
"TGTTCCGTCGTTGCCT"	"Epith.:HighMT"
"TTAACTCAGGCAGTCA"	"Prolif.TPC"
"TTAGGACAGTGAATTG"	"TPC_1"
"TTAGGACGTCTAAACC"	"TPC_2"
"TTAGGACTCACCCGAG"	"PEC-like_1"
"TTAGGACTCCTCAACC"	"TPC_1"
"TTAGGCAAGACAAGCC"	"TPC_3"
"TTAGGCACAAGCTGTT"	"TPC_3"
"TTAGGCAGTCCAACTA"	"DCT-like_2"
"TTAGGCATCAAAGACA"	"TPC_1"
"TTAGGCATCATGTAGC"	"TPC_1"
"TTAGTTCAGAGACTTA"	"Prolif.TPC"
"TTAGTTCCAGTGAGTG"	"DCT-like_2"
"TTAGTTCGTCTGCAAT"	"DCT-like_2"
"TTAGTTCGTGTAAGTA"	"TPC_2"
"TTAGTTCTCCGTCAAA"	"TPC_3"
"TTAGTTCTCGGAAACG"	"TPC_1"
"TTATGCTAGGCATTGG"	"DCT-like_1"
"TTATGCTCACCATGTA"	"TPC_2"
"TTATGCTGTACAGTTC"	"DCT-like_1"
"TTATGCTGTCTCTTTA"	"TPC_3"
"TTATGCTGTTGATTCG"	"TPC_3"
"TTATGCTTCTGGCGTG"	"TPC_3"
"TTCCCAGCAAACCTAC"	"DCT-like_2"
"TTCCCAGGTACAGCAG"	"DCT-like_1"
"TTCCCAGGTGCAGACA"	"TPC_1"
"TTCCCAGTCAATACCG"	"TPC_2"
"TTCCCAGTCTGAGTGT"	"DCT-like_2"
"TTCGAAGAGCGCCTCA"	"Prolif.TPC"
"TTCGAAGAGTGTTGAA"	"DCT-like_2"
"TTCGAAGCAATAACGA"	"DCT-like_2"
"TTCGAAGCACGAAGCA"	"TPC_1"
"TTCGGTCAGAAGATTC"	"TPC_3"
"TTCGGTCCAGCTGTTA"	"DCT-like_2"
"TTCGGTCGTAAGGATT"	"TPC_1"
"TTCGGTCGTAGCCTAT"	"Epith.:HighMT"
"TTCGGTCTCGAGAACG"	"TPC_1"
"TTCTACAAGCGAAGGG"	"TPC_1"
"TTCTACAAGGGTCTCC"	"PEC-like_1"
"TTCTACACAAGTCTGT"	"DCT-like_2"
"TTCTACACACAGGCCT"	"TPC_3"
"TTCTACACAGCCAATT"	"DCT-like_1"
"TTCTACAGTGCTAGCC"	"DCT-like_1"
"TTCTACAGTTCAGTAC"	"Prolif.TPC"
"TTCTACATCCAATGGT"	"DCT-like_1"
"TTCTACATCGCAGGCT"	"DCT-like_2"
"TTCTACATCTTACCTA"	"TPC_2"
"TTCTCAAAGAATGTTG"	"DCT-like_2"
"TTCTCAAGTAGCCTCG"	"TPC_2"
"TTCTCAAGTTTGACAC"	"DCT-like_1"
"TTCTCAATCCACGTGG"	"Prolif.TPC"
"TTCTCAATCTAGCACA"	"TPC_2"
"TTCTCCTAGCTAGCCC"	"TPC_1"
"TTCTCCTCAATTCCTT"	"DCT-like_1"
"TTCTCCTGTTCATGGT"	"TPC_1"
"TTCTCCTGTTGTTTGG"	"DCT-like_2"
"TTCTCCTTCTCGGACG"	"TPC_3"
"TTCTCCTTCTTGAGAC"	"DCT-like_1"
"TTCTTAGAGGCCCGTT"	"TPC_2"
"TTCTTAGCAAGCTGGA"	"Epith.:HighRibo"
"TTCTTAGGTCTTCGTC"	"TPC_3"
"TTGAACGAGAGTTGGC"	"TPC_1"
"TTGAACGAGGATTCGG"	"DCT-like_1"
"TTGAACGTCCACTCCA"	"DCT-like_1"
"TTGACTTAGCTAAGAT"	"TPC_1"
"TTGACTTAGGAGTTGC"	"TPC_2"
"TTGCCGTAGCAAATCA"	"TPC_2"
"TTGCCGTCACAGACTT"	"Prolif.TPC"
"TTGCCGTCACTTGGAT"	"TPC_1"
"TTGCCGTGTAGCTAAA"	"TPC_2"
"TTGCCGTTCACATGCA"	"Epith.:HighRibo"
"TTGCCGTTCAGATAAG"	"TPC_1"
"TTGCCGTTCCTCAACC"	"TPC_2"
"TTGCGTCAGCGACGTA"	"TPC_3"
"TTGCGTCAGTGACATA"	"TPC_3"
"TTGCGTCCAAGTCATC"	"PEC-like_2"
"TTGCGTCCACGACGAA"	"TPC_2"
"TTGCGTCCAGGGTACA"	"Prolif.TPC"
"TTGCGTCCAGTCACTA"	"TPC_2"
"TTGCGTCGTCATTAGC"	"DCT-like_2"
"TTGCGTCGTGAAATCA"	"DCT-like_2"
"TTGGAACAGAAGATTC"	"TPC_2"
"TTGGAACAGACGCTTT"	"TPC_3"
"TTGGAACCAATCCGAT"	"PEC-like_1"
"TTGGAACGTAAGTTCC"	"DCT-like_2"
"TTGGAACGTACCGTTA"	"TPC_1"
"TTGGAACGTCTGCCAG"	"DCT-like_2"
"TTGGAACGTCTTCTCG"	"TPC_3"
"TTGGAACTCCCAAGAT"	"DCT-like_2"
"TTGGCAAAGGCAAAGA"	"TPC_3"
"TTGGCAACATCGGACC"	"DCT-like_2"
"TTGGCAAGTACATCCA"	"TPC_2"
"TTGGCAAGTACGCTGC"	"Prolif.TPC"
"TTGGCAAGTCAAAGAT"	"Epith.:HighMT"
"TTGTAGGAGCGGCTTC"	"TPC_1"
"TTGTAGGAGTCGTTTG"	"TPC_3"
"TTGTAGGCAATGCCAT"	"DCT-like_2"
"TTGTAGGCATACCATG"	"DCT-like_1"
"TTGTAGGGTCAGAATA"	"Epith.:HighRibo"
"TTGTAGGTCTGTACGA"	"TPC_3"
"TTGTAGGTCTTAGAGC"	"TPC_3"
"TTTACTGAGACAAAGG"	"TPC_1"
"TTTACTGAGAGGTTGC"	"DCT-like_1"
"TTTACTGAGCTATGCT"	"TPC_1"
"TTTACTGCAGCCTTGG"	"DCT-like_1"
"TTTACTGCAGTGAGTG"	"TPC_1"
"TTTACTGGTACCATCA"	"DCT-like_1"
"TTTACTGTCTTGCAAG"	"TPC_3"
"TTTATGCAGAATAGGG"	"TPC_2"
"TTTATGCGTAAACCTC"	"DCT-like_1"
"TTTCCTCGTGCCTGCA"	"TPC_2"
"TTTCCTCTCATCGGAT"	"DCT-like_1"
"TTTGCGCAGCTACCGC"	"TPC_1"
"TTTGCGCAGTACCGGA"	"Prolif.TPC"
"TTTGCGCAGTGTCTCA"	"DCT-like_2"
"TTTGCGCGTCTCTCTG"	"DCT-like_2"
"TTTGCGCTCACGATGT"	"DCT-like_2"
"TTTGGTTAGCAGGCTA"	"TPC_1"
"TTTGGTTAGCTGTCTA"	"DCT-like_2"
"TTTGGTTCATGGATGG"	"PEC-like_2"
"TTTGGTTCATTCTTAC"	"DCT-like_1"
"TTTGTCAGTAACGTTC"	"TPC_1"
