""	"Ident"
"AAACCCAAGAACAAGG"	"PT_1"
"AAACCCAAGCGTCAAG"	"PT_2"
"AAACCCAAGGAGCAAA"	"POD"
"AAACGAACATCCGCGA"	"IC-A1"
"AAACGAAGTCAACCAT"	"PT_1"
"AAACGAAGTGCAGATG"	"EC_2"
"AAACGAAGTGTTTACG"	"TAL_1"
"AAACGCTAGGTCATAA"	"TAL_1"
"AAACGCTAGTCTGCAT"	"PT_1"
"AAACGCTCAACGTTAC"	"TAL_1"
"AAACGCTGTTAGGGTG"	"PT_2"
"AAACGCTTCATGAGAA"	"EC_1"
"AAAGAACAGATAGTGT"	"EC_1"
"AAAGAACAGATTGAGT"	"DCT"
"AAAGAACAGCGCCTAC"	"TAL_3"
"AAAGAACAGCTAGAAT"	"PT_2"
"AAAGAACAGGTTGCCC"	"EC_1"
"AAAGAACCACCGCTAG"	"TAL_2"
"AAAGAACCACTCCCTA"	"EC_2"
"AAAGAACGTCATACCA"	"TAL_2"
"AAAGAACTCCCGAACG"	"PT_2"
"AAAGGATAGAGTTGAT"	"TAL_1"
"AAAGGATCACGCGTCA"	"TAL_1"
"AAAGGATCACTCTAGA"	"TAL_1"
"AAAGGATCACTGGATT"	"POD"
"AAAGGATCATGACAGG"	"EC_1"
"AAAGGATTCGGTCAGC"	"TAL_1"
"AAAGGGCAGGTGGCTA"	"PT_2"
"AAAGGGCAGTCGGGAT"	"TAL_2"
"AAAGGGCCATGACACT"	"PT_1"
"AAAGGGCTCGTCACCT"	"iPT"
"AAAGGGCTCTGGCTGG"	"DCT"
"AAAGGGCTCTGGTGGC"	"IC-A1"
"AAAGGTAAGACCCGCT"	"iPT"
"AAAGGTAAGCGTGTTT"	"TAL_1"
"AAAGGTAAGGTGCTAG"	"EC_1"
"AAAGGTAAGGTTAGTA"	"TAL_2"
"AAAGGTACAACCCGCA"	"iPT"
"AAAGGTACACTGGATT"	"iPT"
"AAAGGTACAGTTGTTG"	"CNT"
"AAAGGTACATGACTAC"	"CNT"
"AAAGGTAGTCGTTATG"	"DCT"
"AAAGGTATCCACCCTA"	"PT_2"
"AAAGGTATCTGAATGC"	"PT_1"
"AAAGGTATCTGGTTGA"	"CNT"
"AAAGTCCAGCACGGAT"	"PT_1"
"AAAGTCCAGTCTCTGA"	"EC_2"
"AAAGTCCGTCGTGTTA"	"PEC"
"AAAGTCCGTCTTTATC"	"PT_1"
"AAAGTCCTCACGTAGT"	"TAL_2"
"AAAGTCCTCCAAATGC"	"IC-A1"
"AAAGTGAAGATCCGAG"	"TAL_2"
"AAAGTGAAGTCTAGCT"	"POD"
"AAAGTGACAAGGATGC"	"iPT"
"AAAGTGACAGTGTGGA"	"TAL_1"
"AAAGTGAGTCATCTAG"	"PT_2"
"AAAGTGAGTGATTGGG"	"EC_1"
"AAAGTGAGTGCTCTCT"	"iPT"
"AAATGGAGTAAGATTG"	"EC_1"
"AAATGGAGTAGGTGCA"	"IC-A1"
"AAATGGAGTTGCACGC"	"TAL_1"
"AAATGGATCAAGCCTA"	"TAL_1"
"AACAAAGAGTAACGAT"	"PT_2"
"AACAAAGAGTCATAGA"	"PT_1"
"AACAAAGCAAAGCTAA"	"PT_1"
"AACAAAGCAATTCTTC"	"PT_1"
"AACAAAGCACTTCCTG"	"TAL_1"
"AACAAAGGTGATGGCA"	"EC_1"
"AACAAAGGTGCTCTTC"	"EC_1"
"AACAAAGTCAAGCCGC"	"POD"
"AACAAAGTCCGTATGA"	"TAL_1"
"AACAACCAGCGGTAGT"	"EC_1"
"AACAACCAGTAGTGCG"	"IC-B"
"AACAACCCAGAATGTA"	"PT_1"
"AACAACCTCAGCCTTC"	"EC_1"
"AACAACCTCATGAAAG"	"POD"
"AACAACCTCCAAGCTA"	"PT_2"
"AACAACCTCGGCATTA"	"PT_1"
"AACAAGAAGAGGGTCT"	"PT_1"
"AACAAGAGTATATGGA"	"TAL_1"
"AACAAGATCTCGGTAA"	"PT_2"
"AACACACAGCCATGCC"	"PT_2"
"AACACACCATCATCCC"	"TAL_2"
"AACACACGTCGGTGAA"	"POD"
"AACAGGGAGGTTCAGG"	"CNT"
"AACAGGGGTTGATCGT"	"IC-A1"
"AACCAACAGACCATTC"	"iPT"
"AACCAACCAGTGTGCC"	"CNT"
"AACCAACCATGGCGCT"	"EC_1"
"AACCAACGTACCGGAA"	"DCT"
"AACCACAAGCGTGCCT"	"PEC"
"AACCACAGTAGTTAGA"	"CNT"
"AACCACATCACCCTGT"	"PT_1"
"AACCATGTCCGCGATG"	"CNT"
"AACCCAAAGCGTCTGC"	"iPT"
"AACCCAAGTCTTACTT"	"PT_2"
"AACCCAAGTTTGGAAA"	"iPT"
"AACCCAATCAAGAGGC"	"EC_2"
"AACCTGAAGCGCCCAT"	"PT_1"
"AACCTGAAGTTGAAAC"	"TAL_1"
"AACCTGACACGCTTAA"	"PT_1"
"AACCTGACATTGACAC"	"TAL_2"
"AACCTTTGTACGTACT"	"PT_1"
"AACCTTTTCGTGAGAG"	"CNT"
"AACCTTTTCTACACTT"	"PEC"
"AACGAAACACTGGATT"	"TAL_1"
"AACGAAAGTAACGGTG"	"TAL_2"
"AACGAAAGTGTATACC"	"TAL_1"
"AACGAAAGTTCTGACA"	"PT_2"
"AACGAAATCCAAATGC"	"TAL_2"
"AACGAAATCGACACTA"	"TAL_1"
"AACGGGAAGGAAACGA"	"IC-A1"
"AACGGGACAGTGGTGA"	"DCT"
"AACGGGAGTGGCTGCT"	"EC_2"
"AACGTCACAAGCACCC"	"PT_2"
"AACGTCACACAGCTGC"	"iPT"
"AACGTCAGTCACTAGT"	"IC-A1"
"AACGTCAGTGGTTCTA"	"PT_2"
"AACGTCATCATCTGTT"	"PT_1"
"AACGTCATCTTCGTGC"	"TAL_1"
"AACTTCTCAACTCGTA"	"PT_1"
"AACTTCTGTCTTACAG"	"EC_1"
"AACTTCTGTGGTATGG"	"PT_1"
"AAGAACAAGCACGGAT"	"DCT"
"AAGAACAAGCATCCCG"	"CNT"
"AAGACAACAGAGGCTA"	"EC_1"
"AAGACAAGTCCAAATC"	"iPT"
"AAGACTCAGCATGAAT"	"TAL_1"
"AAGACTCTCCCATTTA"	"PT_2"
"AAGACTCTCGGTCATA"	"iPT"
"AAGATAGAGCGCCTAC"	"CNT"
"AAGATAGCAGTAGAAT"	"PT_1"
"AAGATAGGTGTGTGTT"	"iPT"
"AAGATAGGTTCTCTAT"	"IC-A1"
"AAGATAGTCATCCTGC"	"IC-B"
"AAGCATCAGCCGAACA"	"PT_1"
"AAGCCATAGCCTCATA"	"CNT"
"AAGCCATCAAGTGCAG"	"IC-A1"
"AAGCCATCACCATATG"	"PEC"
"AAGCCATCATGCACTA"	"DCT"
"AAGCCATGTCAGGAGT"	"PT_1"
"AAGCCATGTGCCCACA"	"EC_2"
"AAGCCATGTTACACAC"	"TAL_1"
"AAGCGAGAGGATATAC"	"IC-A1"
"AAGCGAGCAAGACGAC"	"TAL_1"
"AAGCGAGCACGTCGGT"	"DCT"
"AAGCGTTAGATCGCTT"	"MC"
"AAGCGTTAGCGCCTCA"	"PT_2"
"AAGCGTTAGGGCAAGG"	"IC-B"
"AAGCGTTGTCGCCACA"	"IC-A1"
"AAGCGTTGTCTGATAC"	"EC_2"
"AAGGAATAGAGGTCAC"	"TAL_1"
"AAGGAATGTGTGGACA"	"EC_1"
"AAGGAATGTTAGCGGA"	"TAL_2"
"AAGGAATTCACGGGCT"	"DCT"
"AAGGTAACATGGGCAA"	"PT_2"
"AAGGTAATCATCAGTG"	"PEC"
"AAGGTAATCCACTTTA"	"DCT"
"AAGGTAATCTCCTGTG"	"IC-A1"
"AAGTACCAGCCGAACA"	"EC_1"
"AAGTACCAGCGTGTTT"	"EC_2"
"AAGTACCCACATCCCT"	"EC_1"
"AAGTACCCACGAAGAC"	"iPT"
"AAGTACCCATAGACTC"	"EC_1"
"AAGTACCCATCGCTAA"	"PT_1"
"AAGTACCGTAGCACGA"	"TAL_1"
"AAGTCGTAGAAGCCTG"	"POD"
"AAGTCGTAGGATTTAG"	"PT_1"
"AAGTCGTCAAAGACTA"	"EC_2"
"AAGTGAAAGATCGACG"	"PT_2"
"AAGTGAAAGGTGGGTT"	"IC-A1"
"AAGTGAACAAATCAAG"	"PT_1"
"AAGTGAACAGTCGGAA"	"CNT"
"AAGTGAACATACTGAC"	"CNT"
"AAGTGAATCACCTCAC"	"TAL_1"
"AAGTGAATCGTAACAC"	"PT_1"
"AAGTGAATCTAGTCAG"	"PT_2"
"AAGTGAATCTGTAAGC"	"CNT"
"AAGTTCGAGGTGAGAA"	"iPT"
"AAGTTCGAGTGGACGT"	"POD"
"AAGTTCGTCTTTCGAT"	"iPT"
"AATAGAGCAACACAAA"	"EC_2"
"AATAGAGCACGTAACT"	"iPT"
"AATAGAGCATACCAGT"	"PT_2"
"AATAGAGGTAGATGTA"	"DCT"
"AATAGAGGTGAGCTCC"	"EC_1"
"AATCACGGTCTGTGGC"	"TAL_1"
"AATCACGTCAAGAGGC"	"MC"
"AATCGACAGAATTGCA"	"iPT"
"AATCGACCATGTGCTA"	"TAL_1"
"AATCGACGTAATGCTC"	"TAL_1"
"AATCGACGTACCGTGC"	"IC-B"
"AATCGACGTAGACACG"	"DCT"
"AATCGACGTAGCTCGC"	"POD"
"AATCGTGAGTCAACAA"	"TAL_1"
"AATCGTGCAGGACAGT"	"CNT"
"AATCGTGCAGTTGTTG"	"IC-B"
"AATCGTGGTTATAGAG"	"IC-A1"
"AATCGTGTCCATCGTC"	"CNT"
"AATGAAGAGGGACTGT"	"CNT"
"AATGAAGGTTAAGTCC"	"PT_1"
"AATGAAGTCTACGGGC"	"TAL_1"
"AATGACCCAGGAACCA"	"TAL_2"
"AATGACCGTTGGGACA"	"PT_1"
"AATGACCTCACCATGA"	"DCT"
"AATGACCTCCAGCAAT"	"EC_2"
"AATGACCTCCCAAGTA"	"TAL_1"
"AATGACCTCCGCTAGG"	"TAL_2"
"AATGCCAAGCAACTCT"	"CNT"
"AATGCCAAGGGAGAAT"	"TAL_1"
"AATGCCAGTAGGAGGG"	"CNT"
"AATGCCAGTGGATTTC"	"PEC"
"AATGCCAGTTAGTTCG"	"POD"
"AATGCCATCACAGTGT"	"PT_2"
"AATGGAAGTACATACC"	"DCT"
"AATGGCTGTTGGGTTT"	"EC_2"
"AATGGCTTCCGCACGA"	"CNT"
"AATGGCTTCTTGGTGA"	"TAL_3"
"AATTCCTAGGGAGGCA"	"CNT"
"AATTCCTAGGGCTAAC"	"TAL_1"
"AATTCCTTCATGCCCT"	"iPT"
"AATTCCTTCCGATAAC"	"PEC"
"AATTCCTTCTCCCAAC"	"CNT"
"AATTTCCAGCCAAGCA"	"IC-B"
"AATTTCCAGGCCCACT"	"iPT"
"AATTTCCCAACAAGAT"	"IC-B"
"AATTTCCCAAGTGATA"	"DCT"
"AATTTCCGTACAAAGT"	"PT_1"
"AATTTCCGTACCGGCT"	"DCT"
"AATTTCCGTCTCGACG"	"MC"
"ACAAAGAGTACAGAAT"	"EC_1"
"ACAAAGAGTACCGTGC"	"iPT"
"ACAAAGAGTAGTGATA"	"DCT"
"ACAAAGAGTGCCAAGA"	"TAL_1"
"ACAAAGATCCAATGCA"	"CNT"
"ACAACCACAAATGAAC"	"PT_2"
"ACAACCACAAGAAATC"	"TAL_3"
"ACAACCAGTAACCAGG"	"IC-A1"
"ACAACCAGTGCTGATT"	"DCT"
"ACAACCAGTGTAGTGG"	"TAL_2"
"ACAACCATCTCAAAGC"	"PT_1"
"ACAAGCTAGATGAATC"	"PT_2"
"ACAAGCTAGCTGCGAA"	"PT_1"
"ACAAGCTAGTTTCGAC"	"iPT"
"ACAAGCTCATGACGGA"	"EC_2"
"ACACAGTGTTAATCGC"	"PT_1"
"ACACCAACAACAACAA"	"iPT"
"ACACCAATCACACCGG"	"TAL_1"
"ACACCAATCACGATAC"	"TAL_1"
"ACACGCGAGGGTCAAC"	"PEC"
"ACACGCGCAGGTTACT"	"TAL_2"
"ACACGCGCATGTTCGA"	"MC"
"ACACTGAAGGGTAATT"	"iPT"
"ACACTGAAGGTGCCAA"	"TAL_2"
"ACACTGACAGATCACT"	"TAL_3"
"ACACTGAGTCAAGCCC"	"PT_1"
"ACACTGAGTTTCGTGA"	"PT_1"
"ACACTGATCATATGGC"	"CNT"
"ACAGAAAAGATAGTGT"	"IC-A1"
"ACAGAAAAGTAGAATC"	"IC-A1"
"ACAGAAAGTGAGTAGC"	"IC-A1"
"ACAGAAATCATTCTTG"	"DCT"
"ACAGCCGAGGTACATA"	"IC-A1"
"ACAGCCGAGTTCCGGC"	"PT_1"
"ACAGCCGCATCCTTCG"	"TAL_3"
"ACAGCCGTCGCTACAA"	"CNT"
"ACAGGGAAGAGGTTAT"	"EC_2"
"ACAGGGAAGCCAACCC"	"PT_1"
"ACAGGGAAGGATATAC"	"PT_2"
"ACAGGGAGTAGGGAGG"	"CNT"
"ACAGGGAGTCCACGCA"	"EC_1"
"ACAGGGAGTGACATCT"	"PT_2"
"ACATCCCCAACTCGAT"	"POD"
"ACATCCCCAGCATACT"	"iPT"
"ACATCCCGTCTCTCTG"	"EC_1"
"ACATCCCTCACGATCA"	"iPT"
"ACATCCCTCCAACTAG"	"PT_1"
"ACATCCCTCGCACGGT"	"TAL_1"
"ACATCGAAGAGCAGAA"	"PT_2"
"ACATCGAAGCCTGTCG"	"DCT"
"ACATCGACAACACTAC"	"DCT"
"ACATCGACAAGTGCAG"	"TAL_2"
"ACATCGAGTCTGCATA"	"CNT"
"ACATCGATCACCCTTG"	"CNT"
"ACATCGATCTCCATAT"	"DCT"
"ACATGCAAGACGCATG"	"EC_1"
"ACATGCAAGAGTGTGC"	"EC_2"
"ACATGCAGTGGATACG"	"EC_2"
"ACATTTCAGGCTAACG"	"DCT"
"ACATTTCTCGATACTG"	"CNT"
"ACATTTCTCTCATGGA"	"EC_2"
"ACCAAACCATAACCCA"	"PT_2"
"ACCAACAAGACATCCT"	"TAL_1"
"ACCAACAAGACTAAGT"	"EC_2"
"ACCAACAAGTTCATGC"	"PT_1"
"ACCAACACACCGGTCA"	"CNT"
"ACCACAAAGTCATGCT"	"TAL_1"
"ACCACAACACGGATCC"	"MC"
"ACCACAAGTGAGCTCC"	"CNT"
"ACCACAATCACTCCGT"	"PT_1"
"ACCACAATCCGATGCG"	"EC_1"
"ACCACAATCCGGCAGT"	"PT_1"
"ACCATTTAGCACGATG"	"TAL_3"
"ACCATTTAGCATGCAG"	"TAL_1"
"ACCATTTAGCCTGGAA"	"PT_1"
"ACCATTTCAACGTATC"	"PT_1"
"ACCATTTTCATAGCAC"	"PT_2"
"ACCCAAACAACCGACC"	"PT_2"
"ACCCAAACAATGCTCA"	"PT_2"
"ACCCAAATCAAGTAAG"	"PT_1"
"ACCCTCAAGCCTGGAA"	"PT_1"
"ACCCTCACATAGATGA"	"PT_1"
"ACCCTCAGTAAGATCA"	"PT_2"
"ACCCTCAGTCATCGCG"	"TAL_1"
"ACCCTCAGTGTTGCCG"	"EC_2"
"ACCCTCAGTTAATCGC"	"TAL_2"
"ACCCTCATCTCTTGCG"	"TAL_1"
"ACCCTTGCAACAGCTT"	"DCT"
"ACCCTTGCATGGCACC"	"PT_1"
"ACCCTTGGTACGGATG"	"TAL_1"
"ACCCTTGGTTCGGGTC"	"PT_2"
"ACCCTTGTCAGCAGAG"	"TAL_2"
"ACCGTTCAGCAGGCTA"	"TAL_3"
"ACCGTTCAGCTCATAC"	"PT_1"
"ACCGTTCAGTGATTCC"	"PT_1"
"ACCGTTCCATTCGGGC"	"PT_1"
"ACCGTTCGTGAATGTA"	"PT_2"
"ACCTACCAGACGACTG"	"iPT"
"ACCTACCAGCTGTTCA"	"PT_2"
"ACCTACCGTAAGATCA"	"TAL_1"
"ACCTGAAAGTTTGTCG"	"EC_1"
"ACCTGAACAACCCTCT"	"EC_1"
"ACCTGAACATGTTCGA"	"CNT"
"ACCTGAATCCCGTGTT"	"iPT"
"ACCTGTCAGACGGTTG"	"PT_1"
"ACCTGTCAGCTTTCTT"	"IC-A1"
"ACCTGTCCAGAGGCAT"	"TAL_3"
"ACCTGTCCAGCAGACA"	"TAL_2"
"ACCTGTCTCCATTGCC"	"TAL_3"
"ACCTGTCTCTGGTTGA"	"TAL_2"
"ACGATCAAGCCTCAGC"	"TAL_1"
"ACGATCAGTACGTGAG"	"TAL_3"
"ACGATCAGTCACCGAC"	"PT_1"
"ACGATCAGTGACTATC"	"PT_1"
"ACGATCATCCCTCTCC"	"EC_2"
"ACGATGTCAAAGGAGA"	"PT_2"
"ACGATGTCAAGTGACG"	"MC"
"ACGATGTCAGTAGTTC"	"TAL_1"
"ACGATGTGTCACTCGG"	"iPT"
"ACGATGTGTCTCCCTA"	"TAL_3"
"ACGATGTTCATGCAGT"	"EC_1"
"ACGATGTTCGTGGCGT"	"TAL_1"
"ACGCACGAGACTCAAA"	"PT_1"
"ACGCACGCAAAGGAGA"	"DCT"
"ACGCACGCAGGTAGTG"	"IC-B"
"ACGCACGCAGTAGAAT"	"PT_1"
"ACGCACGCATGTGCTA"	"EC_2"
"ACGCACGTCCGGGACT"	"CNT"
"ACGCACGTCGTTGTAG"	"PT_2"
"ACGGAAGCACACCGAC"	"PT_2"
"ACGGAAGCAGCGAACA"	"PT_1"
"ACGGAAGGTCGGCTAC"	"TAL_1"
"ACGGAAGGTTATGTGC"	"PT_2"
"ACGGAAGTCCATCTAT"	"TAL_2"
"ACGGGTCAGACCAACG"	"CNT"
"ACGGGTCAGAGAATCT"	"iPT"
"ACGGGTCCAAGGCTTT"	"IC-B"
"ACGGGTCCAGCTTTCC"	"iPT"
"ACGGGTCGTACAGGTG"	"PT_2"
"ACGGGTCGTTCTCACC"	"iPT"
"ACGGGTCTCCCAGCGA"	"DCT"
"ACGGGTCTCCTCACCA"	"PEC"
"ACGGGTCTCTGAGCAT"	"DCT"
"ACGGTCGAGCTATCTG"	"PT_1"
"ACGGTCGCAGCATTGT"	"IC-B"
"ACGGTCGGTTCAACGT"	"PT_1"
"ACGGTTAAGAATGTTG"	"CNT"
"ACGGTTAAGGCAGGTT"	"DCT"
"ACGGTTAAGTAAAGCT"	"TAL_1"
"ACGGTTAGTAACATAG"	"EC_1"
"ACGGTTAGTGCGTTTA"	"POD"
"ACGGTTATCAACCGAT"	"TAL_1"
"ACGGTTATCTGCTGAA"	"DCT"
"ACGTAACAGATGATTG"	"PT_1"
"ACGTAACAGCTCTATG"	"IC-A1"
"ACGTAACAGGATGCGT"	"IC-A1"
"ACGTAACCAGTAACGG"	"TAL_1"
"ACGTAACGTCTAGATC"	"TAL_3"
"ACGTACATCAAGTTGC"	"PT_2"
"ACGTACATCTTTCCAA"	"PT_1"
"ACGTAGTAGTAGTCTC"	"DCT"
"ACGTAGTAGTTATGGA"	"POD"
"ACGTAGTCACGCCAGT"	"CNT"
"ACGTAGTCACTCAAGT"	"PT_1"
"ACGTAGTCATACGCAT"	"TAL_3"
"ACGTAGTTCAACCTCC"	"PT_1"
"ACGTAGTTCTCCCTAG"	"POD"
"ACGTCCTAGTTGTAAG"	"CNT"
"ACGTCCTTCTGGGCCA"	"CNT"
"ACGTTCCCAGACACAG"	"PT_2"
"ACGTTCCCAGGTTTAC"	"IC-A1"
"ACGTTCCTCTAGCCTC"	"TAL_2"
"ACGTTCCTCTATCCAT"	"MC"
"ACTACGAAGACCATGG"	"TAL_2"
"ACTACGAAGCCTGACC"	"iPT"
"ACTACGAAGGAGGTTC"	"PT_1"
"ACTACGAAGTTATGGA"	"PT_1"
"ACTACGACAAGTCATC"	"PT_1"
"ACTACGAGTTATAGCC"	"PT_1"
"ACTACGAGTTGACTAC"	"DCT"
"ACTATCTCAAACACGG"	"PT_1"
"ACTATCTCACCTCTAC"	"EC_2"
"ACTATCTGTCCACTCT"	"TAL_2"
"ACTATCTTCCGAGATT"	"POD"
"ACTATCTTCCGGTAAT"	"DCT"
"ACTATCTTCTCCGCAT"	"POD"
"ACTATGGAGGAAAGGT"	"CNT"
"ACTATGGCAATCGCAT"	"CNT"
"ACTATTCAGTGAATAC"	"EC_1"
"ACTATTCCACACAGAG"	"TAL_1"
"ACTATTCCACAGCGCT"	"TAL_1"
"ACTATTCCACTACAGT"	"iPT"
"ACTATTCCACTACCGG"	"EC_1"
"ACTCCCACACTCCGGA"	"DCT"
"ACTCCCACACTCGATA"	"TAL_1"
"ACTCCCAGTAATACCC"	"EC_1"
"ACTCTCGAGGAACGCT"	"CNT"
"ACTCTCGCACCTCGTT"	"TAL_3"
"ACTCTCGGTAGCGTTT"	"PT_2"
"ACTCTCGGTGGGATTG"	"CNT"
"ACTCTCGGTTTACTGG"	"PT_1"
"ACTCTCGTCGGAATGG"	"EC_1"
"ACTGATGAGCATTGTC"	"EC_2"
"ACTGATGAGGATTTAG"	"TAL_1"
"ACTGATGCAACACGAG"	"DCT"
"ACTGATGCACGACCTG"	"EC_1"
"ACTGATGCATCGATGT"	"PT_1"
"ACTGATGGTGCTCGTG"	"CNT"
"ACTGATGTCGGCACTG"	"PT_1"
"ACTGCAAAGTTGGCGA"	"PT_1"
"ACTGCAACACTTCCTG"	"TAL_2"
"ACTGCAACATCTATCT"	"iPT"
"ACTGCAAGTATGACAA"	"PT_1"
"ACTGTCCCAAATAGCA"	"POD"
"ACTGTCCCAAGACCGA"	"PT_1"
"ACTGTCCGTACCAATC"	"PT_1"
"ACTGTCCGTACCAGAG"	"PT_1"
"ACTGTCCGTGGCATCC"	"IC-A1"
"ACTGTCCTCATTTGGG"	"PT_1"
"ACTGTGACATCCGATA"	"PT_1"
"ACTGTGAGTTGATCGT"	"POD"
"ACTTAGGAGCACACAG"	"PT_1"
"ACTTAGGAGCTTTGTG"	"CNT"
"ACTTAGGAGGACACTG"	"iPT"
"ACTTAGGAGGCACCAA"	"POD"
"ACTTAGGAGGCATGCA"	"CNT"
"ACTTAGGGTCACGACC"	"iPT"
"ACTTAGGTCTGTCTCG"	"EC_1"
"ACTTATCAGACGCAGT"	"CNT"
"ACTTATCAGGCGACAT"	"PEC"
"ACTTATCTCGCGTCGA"	"IC-A1"
"ACTTATCTCTACGCGG"	"EC_2"
"ACTTCCGCAACCACAT"	"PT_1"
"ACTTCCGTCCACGTCT"	"PT_2"
"ACTTCCGTCGCGTTTC"	"TAL_2"
"ACTTCGCAGGTTGACG"	"TAL_1"
"ACTTTCAAGACTACCT"	"TAL_1"
"ACTTTCAGTCCTCAGG"	"POD"
"ACTTTCAGTGTACAGG"	"iPT"
"ACTTTCATCTATCGGA"	"TAL_2"
"ACTTTGTAGCCGGATA"	"IC-B"
"ACTTTGTAGCGCCTAC"	"TAL_2"
"ACTTTGTAGGGCAAGG"	"iPT"
"ACTTTGTAGGTAGACC"	"PT_1"
"ACTTTGTAGTCATGGG"	"TAL_2"
"ACTTTGTCATCTGGGC"	"iPT"
"ACTTTGTGTGGGCTCT"	"PT_1"
"ACTTTGTTCATGAGAA"	"DCT"
"AGAAATGCAATTTCGG"	"IC-A1"
"AGAAATGCATCAGTGT"	"TAL_1"
"AGAAATGGTAACTGCT"	"TAL_1"
"AGAAATGGTAGGAAAG"	"IC-A1"
"AGAAATGGTGATACTC"	"DCT"
"AGAAATGGTGCTCTTC"	"PT_2"
"AGAAATGGTTATTCTC"	"POD"
"AGAAATGTCTAGATCG"	"TAL_2"
"AGAACAAAGACCGTTT"	"POD"
"AGAACAAAGTCATCCA"	"PT_1"
"AGAACAATCCAGTACA"	"TAL_1"
"AGAACCTAGATACAGT"	"EC_2"
"AGAACCTCAATATCCG"	"IC-A1"
"AGAACCTCAGCTGTTA"	"TAL_2"
"AGAACCTTCATGGGAG"	"CNT"
"AGAACCTTCTAGAGCT"	"PT_2"
"AGAAGCGCATTACGGT"	"TAL_1"
"AGAAGCGGTCGTATGT"	"MC"
"AGAAGCGGTGCACAAG"	"PT_1"
"AGAAGCGGTTGCAAGG"	"PT_2"
"AGAAGCGTCAAGTTGC"	"EC_2"
"AGAAGCGTCGATACAC"	"CNT"
"AGAAGTAAGCACGGAT"	"TAL_3"
"AGAAGTACAAGTATCC"	"TAL_2"
"AGAAGTACATCCGATA"	"IC-A1"
"AGAAGTAGTCACCCTT"	"iPT"
"AGAAGTAGTCTTCAAG"	"POD"
"AGAAGTAGTCTTCTAT"	"TAL_1"
"AGACAAAAGCTGAAGC"	"iPT"
"AGACAAAGTTGGGTAG"	"EC_2"
"AGACAAATCACCTCTG"	"PT_2"
"AGACAAATCCTGGGAC"	"POD"
"AGACAAATCGTAACTG"	"TAL_2"
"AGACAAATCTCTAGGA"	"EC_2"
"AGACAAATCTCTTGCG"	"EC_1"
"AGACACTAGTAGACAT"	"PT_1"
"AGACACTCAAGACCTT"	"PT_1"
"AGACACTGTATAGCTC"	"PT_2"
"AGACACTTCCACTGGG"	"PT_1"
"AGACACTTCCGGTAAT"	"POD"
"AGACACTTCCGTGACG"	"PT_2"
"AGACAGGCAGAACTCT"	"IC-A1"
"AGACAGGGTTGCTCAA"	"TAL_1"
"AGACAGGTCCTCACCA"	"PT_1"
"AGACAGGTCTCTGCCA"	"PT_1"
"AGACAGGTCTGGGTCG"	"PT_1"
"AGACCATCAGAGCGTA"	"EC_2"
"AGACCATGTACCGGAA"	"TAL_1"
"AGACCATGTCGCACGT"	"POD"
"AGACCATGTTGTTGAC"	"PT_2"
"AGACCATGTTTGAACC"	"DCT"
"AGACCCGAGCGGCTCT"	"PT_1"
"AGACCCGAGTCTTCGA"	"EC_2"
"AGACCCGCAATCGCCG"	"MC"
"AGACCCGCAGCCATTA"	"PT_1"
"AGACCCGCATGCAGGA"	"CNT"
"AGACCCGGTAGCTTGT"	"DCT"
"AGACTCACAATAGGGC"	"EC_2"
"AGACTCACAGTCAGTT"	"PT_2"
"AGACTCACATAACCCA"	"DCT"
"AGACTCAGTGACAGGT"	"IC-A1"
"AGACTCATCAGAATAG"	"TAL_2"
"AGACTCATCATTACCT"	"PT_1"
"AGACTCATCGACGACC"	"IC-B"
"AGACTCATCTCGACGG"	"TAL_1"
"AGAGAATCAGTAACAA"	"PT_1"
"AGAGAATCAGTTGAAA"	"PT_1"
"AGAGAATGTTACACTG"	"PT_1"
"AGAGAATTCGTGGGTC"	"DCT"
"AGAGAGCAGCTAGTTC"	"TAL_1"
"AGAGCAGAGTAGTCAA"	"DCT"
"AGAGCAGGTAGGTCAG"	"PT_1"
"AGAGCAGGTATCGCTA"	"TAL_2"
"AGAGCAGTCAGCTTCC"	"IC-B"
"AGAGCCCAGGGAGTTC"	"TAL_2"
"AGAGCCCCAATACCCA"	"PT_1"
"AGAGCCCTCCCAGGCA"	"PT_2"
"AGAGCCCTCGATTTCT"	"iPT"
"AGATAGAAGGTTGACG"	"PT_1"
"AGATAGAAGTTGCCCG"	"PT_2"
"AGATAGAAGTTGGCTT"	"CNT"
"AGATAGACATGTCAGT"	"PT_2"
"AGATAGAGTCCGGACT"	"TAL_1"
"AGATAGAGTGAGACCA"	"PT_1"
"AGATAGAGTGCCTAAT"	"PT_1"
"AGATAGAGTGGTACAG"	"EC_2"
"AGATAGATCCAGCACG"	"PT_1"
"AGATCCACACACCGCA"	"PT_1"
"AGATCCACACTCCGGA"	"CNT"
"AGATCGTCAGCGACCT"	"EC_1"
"AGATCGTCAGGAACCA"	"TAL_1"
"AGATCGTCATAGCACT"	"MC"
"AGATCGTGTATTGGCT"	"EC_1"
"AGATCGTGTGTCATCA"	"PT_1"
"AGATCGTTCCATTGGA"	"TAL_2"
"AGATCGTTCCGGCAAC"	"EC_1"
"AGATCGTTCGCCGTGA"	"TAL_1"
"AGATGAACACAGACGA"	"iPT"
"AGATGAAGTATCGTAC"	"EC_2"
"AGATGAAGTCATCGGC"	"TAL_3"
"AGATGAAGTGATATAG"	"MC"
"AGATGAAGTGTCCACG"	"POD"
"AGATGAATCTGATTCT"	"CNT"
"AGATGCTAGATCGGTG"	"TAL_2"
"AGATGCTAGTACAGAT"	"iPT"
"AGATGCTTCGAGTACT"	"TAL_1"
"AGATGCTTCTCGAACA"	"PT_1"
"AGCATCAAGGCCTAAG"	"TAL_1"
"AGCATCACATCACCAA"	"PT_1"
"AGCATCAGTCCAGGTC"	"IC-B"
"AGCCAATAGACTGGGT"	"EC_1"
"AGCCAATAGCCTCCAG"	"PT_2"
"AGCCAATTCCGAGGCT"	"CNT"
"AGCCAATTCTGCGGGT"	"CNT"
"AGCCACGAGTGAACAT"	"TAL_1"
"AGCCACGGTATCAGGG"	"TAL_2"
"AGCCACGGTTCCGCTT"	"PT_2"
"AGCCAGCAGGGTAGCT"	"iPT"
"AGCCAGCAGTGTTGTC"	"IC-A1"
"AGCCAGCTCCCTCTCC"	"TAL_1"
"AGCCAGCTCGTGGTAT"	"POD"
"AGCGATTAGACTTCGT"	"TAL_1"
"AGCGATTCACCAGCGT"	"PT_2"
"AGCGATTGTTGCATAC"	"EC_1"
"AGCGATTTCGCTGATA"	"PT_1"
"AGCGATTTCTGATGGT"	"DCT"
"AGCGATTTCTGGGTCG"	"MC"
"AGCGCCAAGCAAACAT"	"PT_1"
"AGCGCCAAGCAGCCTC"	"PT_1"
"AGCGCCAAGGAAGAAC"	"PT_2"
"AGCGCCAAGTGGCAGT"	"iPT"
"AGCGCCAAGTGGTCAG"	"PT_1"
"AGCGCCATCAACTGGT"	"DCT"
"AGCGCCATCCCAGCGA"	"TAL_1"
"AGCGCCATCGGAATGG"	"PT_1"
"AGCGCTGAGAATCCCT"	"DCT"
"AGCGCTGAGCAGGCTA"	"POD"
"AGCGCTGAGGAACTCG"	"IC-A1"
"AGCGCTGAGTGCACTT"	"PT_1"
"AGCGCTGCACAATCTG"	"PEC"
"AGCGCTGCACACAGCC"	"IC-A1"
"AGCGCTGGTAGACAGC"	"PT_2"
"AGCGCTGGTATCACGT"	"CNT"
"AGCGCTGGTATCGAGG"	"PEC"
"AGCGCTGTCCACTGAA"	"TAL_1"
"AGCGCTGTCTTCGCTG"	"TAL_2"
"AGCGCTGTCTTTGGAG"	"DCT"
"AGCGTATCATGTTCAG"	"TAL_2"
"AGCGTATGTAGCGTAG"	"PT_1"
"AGCGTATGTCATCTAG"	"TAL_2"
"AGCGTATTCAAGAGTA"	"iPT"
"AGCGTATTCGCGTGAC"	"TAL_2"
"AGCGTATTCTAGGAAA"	"DCT"
"AGCGTATTCTCCAATT"	"CNT"
"AGCGTCGAGCCAGTAG"	"TAL_1"
"AGCGTCGCAACATCGT"	"IC-B"
"AGCGTCGCAGAATTCC"	"PT_1"
"AGCGTCGCAGGACGAT"	"TAL_1"
"AGCTACAAGCGTTGTT"	"CNT"
"AGCTACAAGTAGGATT"	"MC"
"AGCTACACACTAGGTT"	"PT_1"
"AGCTACACACTAGTAC"	"TAL_1"
"AGCTACACAGATTAAG"	"iPT"
"AGCTACAGTGTAAACA"	"PT_1"
"AGCTACATCAGACCGC"	"IC-A1"
"AGCTCAAAGCCTTGAT"	"PT_1"
"AGCTCAAAGGTTCACT"	"PT_1"
"AGCTCAAGTACATACC"	"EC_2"
"AGCTCAAGTGTATACC"	"EC_1"
"AGCTCAAGTTTCTTAC"	"TAL_2"
"AGCTTCCAGGGAGTGG"	"IC-B"
"AGCTTCCAGGTAAGTT"	"EC_1"
"AGCTTCCCAAGATGGC"	"TAL_2"
"AGCTTCCCACTACCCT"	"DCT"
"AGCTTCCGTTCTTCAT"	"PT_1"
"AGCTTCCTCACACCCT"	"PT_1"
"AGCTTCCTCATTTGGG"	"MC"
"AGCTTCCTCCATCTCG"	"PT_1"
"AGGAAATAGCAAACAT"	"PT_1"
"AGGAAATAGTAGAATC"	"TAL_1"
"AGGAAATCAAGAATGT"	"TAL_3"
"AGGAAATGTGTTATCG"	"PT_2"
"AGGAATAAGTATGTAG"	"TAL_1"
"AGGAATACATCCTTGC"	"TAL_2"
"AGGAATACATTAGGCT"	"CNT"
"AGGAATAGTATTCCGA"	"iPT"
"AGGAATAGTTTAGACC"	"EC_1"
"AGGAATATCAGGAGAC"	"CNT"
"AGGACGAAGGAACGCT"	"DCT"
"AGGACGACAGGATTCT"	"TAL_1"
"AGGACTTCAAGTGACG"	"EC_1"
"AGGACTTCAGAGGTTG"	"TAL_1"
"AGGACTTCAGATTTCG"	"EC_2"
"AGGACTTCAGCCATTA"	"IC-A1"
"AGGACTTCAGGGAATC"	"PT_1"
"AGGACTTGTCAGATTC"	"PT_1"
"AGGACTTTCATTGAGC"	"TAL_3"
"AGGACTTTCCGTGGCA"	"PT_1"
"AGGAGGTAGAGCGACT"	"TAL_2"
"AGGAGGTAGGACTATA"	"PT_1"
"AGGAGGTAGTAAAGCT"	"PT_1"
"AGGAGGTCAGACAATA"	"EC_1"
"AGGAGGTCATCGATAC"	"TAL_2"
"AGGAGGTCATGACTTG"	"PT_1"
"AGGAGGTGTCATGACT"	"MC"
"AGGATAACACAAGTGG"	"CNT"
"AGGATAACAGCTACAT"	"TAL_1"
"AGGATAAGTACGAGTG"	"TAL_1"
"AGGATAAGTCAGACGA"	"PT_1"
"AGGATAAGTTGAGTCT"	"TAL_1"
"AGGATAATCATAAGGA"	"iPT"
"AGGATAATCGCTTACC"	"DCT"
"AGGATCTCAACAGCCC"	"TAL_2"
"AGGATCTCAGGATGAC"	"POD"
"AGGATCTGTGTATACC"	"DCT"
"AGGATCTGTTGGACCC"	"PT_2"
"AGGATCTTCCCTCTCC"	"iPT"
"AGGATCTTCTTTGCAT"	"EC_2"
"AGGCATTCAGCAGATG"	"DCT"
"AGGCCACAGTAAGGGA"	"TAL_2"
"AGGCCACCAAATACGA"	"IC-A1"
"AGGCCACCACTTGTCC"	"TAL_1"
"AGGCCACGTGTTCGTA"	"PT_1"
"AGGCTGCAGATAGGGA"	"iPT"
"AGGCTGCCACAGTCCG"	"PT_2"
"AGGCTGCCAGATCATC"	"TAL_1"
"AGGCTGCCAGCGACAA"	"PT_1"
"AGGCTGCTCATACAGC"	"EC_1"
"AGGCTGCTCGCTAATG"	"DCT"
"AGGGAGTCAACCCTCT"	"CNT"
"AGGGCCTCACGTAACT"	"IC-B"
"AGGGCCTCACTGCGAC"	"PT_1"
"AGGGCCTCAGACCAAG"	"POD"
"AGGGCCTGTGATCATC"	"PT_2"
"AGGGCCTTCAGGTAAA"	"CNT"
"AGGGCCTTCCAGTTCC"	"EC_1"
"AGGGCTCGTGGTTTGT"	"iPT"
"AGGGCTCGTGTTAAAG"	"DCT"
"AGGGCTCTCCAGGACC"	"IC-A1"
"AGGGCTCTCGAAGGAC"	"PT_2"
"AGGGTCCGTAGCTCGC"	"PT_1"
"AGGGTCCGTGATTCTG"	"PT_2"
"AGGGTCCTCGGTAACT"	"DCT"
"AGGGTGAAGCGTGTCC"	"TAL_2"
"AGGGTGACATCTGTTT"	"TAL_1"
"AGGGTGATCGGTGTTA"	"CNT"
"AGGGTTTAGCTGAAGC"	"PT_1"
"AGGGTTTCAGGGACTA"	"POD"
"AGGTAGGGTAACGATA"	"IC-B"
"AGGTAGGGTCAGACTT"	"PT_2"
"AGGTAGGGTGTATTGC"	"PT_2"
"AGGTAGGTCTCACCCA"	"PT_2"
"AGGTCATAGAATAGTC"	"iPT"
"AGGTCATCAAGTTTGC"	"EC_2"
"AGGTCATCACCAGTTA"	"PT_1"
"AGGTCATCATGGATCT"	"TAL_1"
"AGGTCATTCTTTCCAA"	"EC_1"
"AGGTCTAAGGAATCGC"	"iPT"
"AGGTCTACAGCGACAA"	"PT_1"
"AGGTCTACAGTCGCTG"	"EC_1"
"AGGTCTAGTAGTCCTA"	"POD"
"AGGTCTAGTCGCCTAG"	"TAL_2"
"AGGTCTATCAACCCGG"	"PT_1"
"AGGTGTTCACGGCCAT"	"PT_1"
"AGGTGTTGTATGTCAC"	"CNT"
"AGGTGTTTCATCTGTT"	"EC_1"
"AGGTTACCATCTCCCA"	"PT_1"
"AGGTTACGTACTGCGC"	"TAL_3"
"AGGTTACGTGGATTTC"	"TAL_1"
"AGGTTACGTGTATTGC"	"TAL_1"
"AGGTTACTCGCAGTTA"	"EC_1"
"AGGTTGTCAACCGGAA"	"TAL_1"
"AGGTTGTCAGACAAGC"	"PT_1"
"AGGTTGTTCAACACGT"	"TAL_3"
"AGTAACCCACAGAGCA"	"EC_1"
"AGTAACCCACGACCTG"	"POD"
"AGTAACCCATCCTATT"	"MC"
"AGTACCAAGCACTCTA"	"DCT"
"AGTACCACAAGTACCT"	"PT_2"
"AGTACCAGTTAGCGGA"	"EC_1"
"AGTACCATCCCGGTAG"	"DCT"
"AGTACTGAGGCTAACG"	"IC-A1"
"AGTACTGCATTGAGCT"	"PT_1"
"AGTACTGGTTCTCCAC"	"PT_1"
"AGTACTGTCCCAAGCG"	"IC-B"
"AGTACTGTCTACGGTA"	"TAL_2"
"AGTAGCTGTCAGTTTG"	"PT_2"
"AGTAGCTTCGATACTG"	"TAL_1"
"AGTAGTCCAGGACGAT"	"TAL_1"
"AGTAGTCCATCGATAC"	"EC_2"
"AGTAGTCCATGTGTCA"	"DCT"
"AGTAGTCGTCCAACGC"	"IC-A1"
"AGTAGTCTCAGCGTCG"	"CNT"
"AGTAGTCTCCACTGGG"	"IC-A1"
"AGTCAACGTTCCTACC"	"PT_1"
"AGTCAACTCCCAATAG"	"DCT"
"AGTCAACTCGAGAATA"	"EC_1"
"AGTCAACTCTTAGGAC"	"DCT"
"AGTCACAAGCTCCGAC"	"IC-B"
"AGTCACAAGGTACATA"	"PT_1"
"AGTCACAAGTGAACAT"	"iPT"
"AGTCACACATCAGCGC"	"PT_2"
"AGTCACAGTGGGATTG"	"TAL_2"
"AGTCACATCAACTCTT"	"EC_2"
"AGTCACATCACTTGTT"	"IC-A1"
"AGTCATGAGGTGCCAA"	"iPT"
"AGTCATGCACGGTCTG"	"EC_1"
"AGTCATGGTCGCTGCA"	"PT_1"
"AGTCATGGTCTACGAT"	"EC_1"
"AGTCATGGTTGGGTAG"	"TAL_1"
"AGTCATGTCTACACTT"	"IC-B"
"AGTCTCCAGGTAAGTT"	"CNT"
"AGTCTCCCAAGCTGCC"	"PT_2"
"AGTCTCCGTAGTTAGA"	"CNT"
"AGTCTCCGTATCAAGA"	"TAL_3"
"AGTCTCCGTGGGTCAA"	"IC-A1"
"AGTCTCCGTTCTAAGC"	"IC-A1"
"AGTCTCCTCCCTAGGG"	"PT_2"
"AGTCTCCTCGAATCCA"	"TAL_1"
"AGTGACTAGCACTCTA"	"TAL_2"
"AGTGACTAGCCTGAGA"	"TAL_1"
"AGTGACTAGGTTGCCC"	"EC_2"
"AGTGACTCAACGGTAG"	"CNT"
"AGTGACTCAATGACCT"	"PT_2"
"AGTGACTCACTTCTCG"	"TAL_1"
"AGTGACTCATCACCAA"	"TAL_1"
"AGTGACTCATTCACCC"	"PT_1"
"AGTGACTGTACTCAAC"	"CNT"
"AGTGACTGTTGTCTAG"	"POD"
"AGTGATCCAAGTCCCG"	"PT_1"
"AGTGATCGTATCAAGA"	"IC-A1"
"AGTGATCGTCTGTGAT"	"PT_1"
"AGTGATCGTGGTCTGC"	"TAL_1"
"AGTGATCGTGTTCATG"	"PEC"
"AGTGCCGCACCTGCGA"	"CNT"
"AGTGCCGCAGCGCGTT"	"PT_1"
"AGTGCCGGTAAGAACT"	"PT_2"
"AGTGCCGTCACACCCT"	"POD"
"AGTGCCGTCCTACTGC"	"PT_1"
"AGTGCCGTCGCCACTT"	"TAL_3"
"AGTGTTGAGCGCCTTG"	"PT_1"
"AGTGTTGAGGACAACC"	"iPT"
"AGTGTTGAGGTAGCAC"	"PT_2"
"AGTGTTGCAAGGATGC"	"EC_2"
"AGTGTTGCAGCGGTTC"	"DCT"
"AGTGTTGGTTACCGTA"	"DCT"
"AGTGTTGGTTGGCCGT"	"TAL_1"
"AGTGTTGGTTTCGACA"	"PT_1"
"AGTGTTGTCAGGGATG"	"iPT"
"AGTGTTGTCGAGTGGA"	"TAL_3"
"AGTGTTGTCGCATTAG"	"TAL_1"
"AGTTAGCAGTGGTTGG"	"POD"
"AGTTAGCCACCATATG"	"EC_1"
"AGTTAGCCACCCTAAA"	"IC-A1"
"AGTTAGCCAGAGGCAT"	"PT_2"
"AGTTAGCGTTACGGAG"	"PT_1"
"AGTTAGCTCAGTAGGG"	"TAL_2"
"AGTTCCCAGTCTCTGA"	"TAL_3"
"AGTTCCCCAAGTGGCA"	"PT_1"
"AGTTCCCGTATCTCTT"	"POD"
"AGTTCCCGTCACTTCC"	"EC_2"
"AGTTCCCTCATCGCAA"	"EC_2"
"AGTTCGACAATACCTG"	"PT_1"
"AGTTCGACAGCTTTGA"	"EC_1"
"AGTTCGAGTGCAACAG"	"PT_2"
"AGTTCGAGTGTATTCG"	"CNT"
"AGTTCGAGTTCGAGCC"	"DCT"
"AGTTCGAGTTTCGCTC"	"PT_1"
"AGTTCGATCACTGAAC"	"PT_1"
"ATACCGAAGACTCGAG"	"TAL_2"
"ATACCGACAGGCGAAT"	"PT_1"
"ATACCGACATCGTGGC"	"TAL_1"
"ATACCGAGTGATACAA"	"PT_2"
"ATACCGAGTTGTCCCT"	"TAL_1"
"ATACCGATCGTAGCCG"	"IC-B"
"ATACCGATCTGCTAGA"	"TAL_1"
"ATACCGATCTTACTGT"	"IC-A1"
"ATACCGATCTTTCCAA"	"MC"
"ATACCTTAGTAGTCAA"	"EC_1"
"ATACCTTCACATGGTT"	"CNT"
"ATACCTTGTACGTACT"	"EC_2"
"ATACCTTGTCATGGCC"	"IC-A1"
"ATACCTTGTGGAATGC"	"TAL_3"
"ATACCTTTCGAGTGGA"	"PT_2"
"ATACTTCAGATAGGGA"	"TAL_2"
"ATACTTCCAACCAACT"	"PT_1"
"ATACTTCCACCTTCCA"	"TAL_1"
"ATACTTCCATCGTCCT"	"MC"
"ATACTTCGTCTTCGAA"	"IC-A1"
"ATACTTCGTGCCGTAC"	"EC_1"
"ATACTTCTCAGGACGA"	"CNT"
"ATACTTCTCGACTCCT"	"PT_1"
"ATAGACCAGGGAGAAT"	"TAL_1"
"ATAGACCAGTATAGAC"	"TAL_3"
"ATAGACCCAACGGTAG"	"PT_1"
"ATAGACCCAAGACCGA"	"CNT"
"ATAGACCCAAGTGACG"	"POD"
"ATAGACCGTACGTGTT"	"PT_2"
"ATAGACCGTATACAGA"	"CNT"
"ATAGACCGTCGTACTA"	"PT_1"
"ATAGACCTCTAAGCGT"	"DCT"
"ATAGAGAAGATAGTCA"	"CNT"
"ATAGAGAAGCACTGGA"	"CNT"
"ATAGAGAAGTAACCTC"	"IC-A1"
"ATAGAGATCGACACTA"	"PT_1"
"ATAGAGATCTTGGAAC"	"POD"
"ATAGGCTCAAGACGGT"	"TAL_2"
"ATAGGCTCACGACTAT"	"TAL_3"
"ATAGGCTGTAACGATA"	"EC_2"
"ATAGGCTTCATTGCGA"	"IC-A1"
"ATATCCTAGCTCGCAC"	"PEC"
"ATATCCTAGGTCCCGT"	"PT_1"
"ATATCCTAGTCTCTGA"	"iPT"
"ATATCCTCAAGTGGCA"	"PT_1"
"ATATCCTCACGCTGAC"	"TAL_2"
"ATATCCTCAGCGAGTA"	"IC-A1"
"ATATCCTGTGGAACAC"	"TAL_1"
"ATATCCTTCGCCTTTG"	"PT_2"
"ATCACAGAGGACAACC"	"PT_1"
"ATCACAGAGTCTGCAT"	"PT_1"
"ATCACAGCAACACGTT"	"IC-B"
"ATCACAGGTCCAGCCA"	"PT_1"
"ATCACAGTCTGAGCAT"	"TAL_2"
"ATCACGAAGCAATTAG"	"iPT"
"ATCACGAAGTGTCATC"	"PT_1"
"ATCACGACAATGACCT"	"TAL_1"
"ATCACGAGTTTGACAC"	"EC_1"
"ATCACGATCCTGTACC"	"TAL_3"
"ATCACGATCTCTGGTC"	"EC_1"
"ATCACGATCTTGGTCC"	"PT_1"
"ATCACTTGTCCTACGG"	"TAL_1"
"ATCACTTGTGTCCCTT"	"PT_2"
"ATCACTTTCGTTGTGA"	"TAL_1"
"ATCAGGTAGATGAATC"	"DCT"
"ATCAGGTAGTGTTCAC"	"CNT"
"ATCAGGTGTACTAGCT"	"CNT"
"ATCAGGTGTCTGTGAT"	"PT_1"
"ATCAGGTTCGTTCGCT"	"PT_2"
"ATCAGGTTCTCTCGCA"	"IC-A1"
"ATCAGGTTCTGCGGCA"	"TAL_3"
"ATCATTCAGGAGCAAA"	"iPT"
"ATCATTCAGGGTTGCA"	"iPT"
"ATCATTCAGGTTCACT"	"EC_1"
"ATCATTCAGGTTCTAC"	"PEC"
"ATCATTCGTTCCTTGC"	"iPT"
"ATCATTCGTTCTCCAC"	"TAL_2"
"ATCATTCTCTATCGCC"	"iPT"
"ATCCACCAGACTTAAG"	"PT_1"
"ATCCACCAGATCCCGC"	"TAL_2"
"ATCCACCCACTGCTTC"	"PT_1"
"ATCCACCCAGAGTAAT"	"PT_1"
"ATCCACCTCATGCCAA"	"PT_1"
"ATCCACCTCTCTTGCG"	"POD"
"ATCCATTAGACGGTTG"	"PT_1"
"ATCCATTAGCAGGCTA"	"POD"
"ATCCATTAGCTGAGTG"	"IC-A1"
"ATCCATTAGGTAAAGG"	"DCT"
"ATCCATTAGGTGCCAA"	"PT_1"
"ATCCATTAGTTTGAGA"	"CNT"
"ATCCATTCATTGCTTT"	"PT_2"
"ATCCATTGTATTCTCT"	"TAL_1"
"ATCCATTTCAAATGAG"	"IC-B"
"ATCCCTGTCCCTTGGT"	"TAL_1"
"ATCCCTGTCCGATGTA"	"iPT"
"ATCCCTGTCGAAATCC"	"IC-A1"
"ATCCGTCAGGTTCACT"	"PT_1"
"ATCCGTCAGTACGAGC"	"TAL_3"
"ATCCGTCCAGAGATGC"	"EC_2"
"ATCCGTCCAGGCACTC"	"PT_2"
"ATCCGTCGTCTTCAAG"	"CNT"
"ATCCGTCGTTTCGCTC"	"PT_1"
"ATCCGTCTCTACGGTA"	"EC_2"
"ATCCTATAGTGGTTGG"	"EC_1"
"ATCCTATAGTGTACAA"	"PT_1"
"ATCCTATTCACCCTCA"	"TAL_1"
"ATCGATGAGATGTTCC"	"CNT"
"ATCGATGAGCCAAGCA"	"iPT"
"ATCGATGAGTTGGCGA"	"PT_1"
"ATCGATGGTAGCACGA"	"PT_1"
"ATCGATGGTTGCTTGA"	"IC-A1"
"ATCGATGTCGATTCCC"	"PT_1"
"ATCGCCTAGCCTTTCC"	"iPT"
"ATCGCCTTCCACGTCT"	"POD"
"ATCGCCTTCGAACGGA"	"PT_1"
"ATCGGATAGTCGAAAT"	"IC-A1"
"ATCGGATCATCGTGCG"	"EC_1"
"ATCGGATGTTCTCGTC"	"PT_1"
"ATCGGATTCCCATTTA"	"EC_1"
"ATCGGATTCCTCACTG"	"TAL_1"
"ATCGGATTCGGTCTAA"	"POD"
"ATCGGCGAGCCTTCTC"	"PEC"
"ATCGGCGAGGAGGGTG"	"PT_1"
"ATCGGCGAGTTGTAAG"	"EC_2"
"ATCGGCGCACGCGGTT"	"EC_1"
"ATCGGCGCACTATCCC"	"TAL_1"
"ATCGGCGTCACCCTCA"	"PT_1"
"ATCGGCGTCAGCGCGT"	"POD"
"ATCGGCGTCCATTGCC"	"CNT"
"ATCGGCGTCGTAGTCA"	"iPT"
"ATCGTAGAGACTGGGT"	"TAL_2"
"ATCGTAGTCCTACTGC"	"iPT"
"ATCGTAGTCTTAGTTC"	"CNT"
"ATCGTCCGTGTACATC"	"PT_1"
"ATCGTGACAGTGACCC"	"TAL_2"
"ATCGTGAGTTCGAAGG"	"PT_1"
"ATCGTGATCTGTCTCG"	"iPT"
"ATCTCTAAGACATAAC"	"iPT"
"ATCTCTAAGAGTTGCG"	"PT_2"
"ATCTCTACAGCTGGTC"	"TAL_3"
"ATCTCTATCCAGCCTT"	"PT_2"
"ATCTCTATCTGTGCGG"	"POD"
"ATCTTCAAGGAGTATT"	"TAL_1"
"ATCTTCACAACGACAG"	"CNT"
"ATCTTCAGTATGGTTC"	"TAL_3"
"ATCTTCATCAGCTTCC"	"iPT"
"ATCTTCATCCTGTACC"	"IC-B"
"ATGAAAGCATGCCATA"	"TAL_2"
"ATGAAAGGTGGACCTC"	"IC-A1"
"ATGAAAGTCAACTTTC"	"EC_2"
"ATGAAAGTCACGGGAA"	"EC_1"
"ATGAAAGTCCATTTCA"	"EC_2"
"ATGACCAAGTAGCATA"	"iPT"
"ATGACCAAGTTGTAGA"	"PT_1"
"ATGAGGGGTCCAGCCA"	"PT_1"
"ATGAGGGGTTCAAGGG"	"EC_1"
"ATGAGGGTCACCCTCA"	"MC"
"ATGAGGGTCGTACACA"	"PT_1"
"ATGAGTCAGACATAAC"	"TAL_3"
"ATGAGTCAGTGACACG"	"TAL_1"
"ATGAGTCCAGCGTGCT"	"TAL_1"
"ATGAGTCTCCTGATAG"	"TAL_1"
"ATGATCGAGCCTCAGC"	"PT_1"
"ATGATCGAGCTCGCAC"	"POD"
"ATGATCGCAAGCGCAA"	"PT_2"
"ATGATCGCAATAACGA"	"CNT"
"ATGATCGCAGTAGAAT"	"iPT"
"ATGATCGCAGTGCCTG"	"TAL_2"
"ATGATCGTCCCAGCGA"	"POD"
"ATGATCGTCCGTTGGG"	"TAL_1"
"ATGCATGAGCTTCTAG"	"CNT"
"ATGCATGAGGTAACTA"	"CNT"
"ATGCATGCAAATTAGG"	"PT_1"
"ATGCATGGTTTAAGGA"	"DCT"
"ATGCATGTCAAAGACA"	"EC_2"
"ATGCATGTCGCTAATG"	"PT_1"
"ATGCATGTCTCGCAGG"	"PT_2"
"ATGCCTCCAACGATCT"	"CNT"
"ATGCCTCCACGCGGTT"	"PT_2"
"ATGCCTCGTCCAAATC"	"TAL_1"
"ATGCGATAGAGCTGAC"	"TAL_1"
"ATGCGATAGCAAACAT"	"PT_2"
"ATGCGATAGTGTGTTC"	"TAL_1"
"ATGCGATCAGGCATTT"	"DCT"
"ATGCGATGTTGTCTAG"	"TAL_1"
"ATGCGATTCTCATGGA"	"PT_2"
"ATGCGATTCTTCCCGA"	"iPT"
"ATGGAGGAGATGGCGT"	"TAL_3"
"ATGGAGGCAGACAATA"	"IC-B"
"ATGGAGGGTACCGGCT"	"PT_1"
"ATGGATCAGTCTGGAG"	"TAL_2"
"ATGGATCGTCGAACGA"	"PT_1"
"ATGGATCGTCTAGATC"	"PT_1"
"ATGGATCGTGTCTTCC"	"PT_1"
"ATGGATCGTTACCCTC"	"TAL_1"
"ATGGATCTCTTGGAAC"	"PT_1"
"ATGGGAGAGAGCAGCT"	"TAL_1"
"ATGGGAGAGTATGACA"	"PT_1"
"ATGGGAGCAAGCCATT"	"iPT"
"ATGGGAGCACTGTTCC"	"CNT"
"ATGGGAGGTATGGTTC"	"TAL_1"
"ATGGGAGGTTAAGCAA"	"PT_1"
"ATGGGAGGTTCAAGTC"	"TAL_1"
"ATGGGAGTCAGATGCT"	"PT_1"
"ATGGGAGTCAGTCTTT"	"TAL_3"
"ATGGGAGTCTCTTCAA"	"CNT"
"ATGGGTTAGGCATCTT"	"PT_2"
"ATGGGTTCATTGAAGA"	"iPT"
"ATGGGTTGTTGCGAAG"	"IC-B"
"ATGGGTTTCTCAACGA"	"CNT"
"ATGGTTGAGAGGCGTT"	"TAL_1"
"ATGGTTGAGCCACCGT"	"EC_2"
"ATGGTTGCAGAGACTG"	"PT_1"
"ATGGTTGCAGAGTAAT"	"PT_1"
"ATGGTTGCAGTGTGCC"	"TAL_2"
"ATGGTTGGTTTACGAC"	"PT_2"
"ATGTCCCCAACAGCTT"	"EC_1"
"ATGTCCCCATAGAATG"	"DCT"
"ATGTCCCGTTCCAAAC"	"PT_1"
"ATGTCCCTCGACCACG"	"TAL_1"
"ATGTCTTCAGACAAAT"	"EC_2"
"ATGTCTTTCTAGAGCT"	"CNT"
"ATTACCTAGATCACTC"	"TAL_1"
"ATTACCTCAGTGTGCC"	"TAL_1"
"ATTACCTCATTAGGCT"	"PT_1"
"ATTACCTGTGCTGCAC"	"EC_1"
"ATTACCTGTTCGGGTC"	"CNT"
"ATTACCTTCCCTCGAT"	"PT_1"
"ATTACCTTCTAGTACG"	"PT_1"
"ATTACTCCATTGCCGG"	"iPT"
"ATTACTCGTTGTTTGG"	"EC_2"
"ATTACTCTCGCAATGT"	"PT_1"
"ATTATCCCAAGAGCTG"	"PT_2"
"ATTATCCGTATGACAA"	"EC_1"
"ATTATCCGTTGCTGAT"	"CNT"
"ATTATCCTCTGAACGT"	"TAL_2"
"ATTATCCTCTGCATAG"	"CNT"
"ATTCACTCAAACCGGA"	"TAL_2"
"ATTCACTCACTTACAG"	"PEC"
"ATTCACTTCCGCCTAT"	"DCT"
"ATTCACTTCTGAGATC"	"IC-A1"
"ATTCAGGAGCATCAAA"	"DCT"
"ATTCAGGAGGCCTGCT"	"MC"
"ATTCAGGAGGTCCCTG"	"IC-A1"
"ATTCAGGAGTAGGGTC"	"EC_2"
"ATTCAGGGTAAGCTCT"	"POD"
"ATTCAGGTCATTGTGG"	"DCT"
"ATTCAGGTCTGTCCCA"	"TAL_1"
"ATTCATCAGCAGCCCT"	"TAL_3"
"ATTCATCAGCTAGATA"	"IC-B"
"ATTCATCCAAATCAGA"	"TAL_2"
"ATTCATCCAATCGTCA"	"PT_2"
"ATTCATCCACTACCCT"	"iPT"
"ATTCATCCAGTAGGAC"	"PT_1"
"ATTCATCGTCCTCCTA"	"iPT"
"ATTCATCGTGTCTCCT"	"EC_2"
"ATTCCATAGTCCCTAA"	"iPT"
"ATTCCATCACGACGTC"	"IC-A1"
"ATTCCATGTGCCGTAC"	"PT_1"
"ATTCCATGTGCGAACA"	"TAL_2"
"ATTCCATGTGTATCCA"	"PT_2"
"ATTCCCGCAAAGGGCT"	"MC"
"ATTCCCGGTACTAACC"	"EC_2"
"ATTCCCGGTGCCTACG"	"DCT"
"ATTCCCGTCTGGAGAG"	"TAL_1"
"ATTCCTAAGGCGCTTC"	"PT_1"
"ATTCCTAGTCGCTTGG"	"TAL_1"
"ATTCCTAGTGGAACCA"	"TAL_2"
"ATTCCTATCAGTGTGT"	"DCT"
"ATTCCTATCCCTCGAT"	"TAL_1"
"ATTCCTATCCTGCCAT"	"iPT"
"ATTCGTTAGATAGCTA"	"EC_1"
"ATTCGTTAGTAAACGT"	"PT_1"
"ATTCGTTCATAGGAGC"	"PT_1"
"ATTCGTTCATCGTCCT"	"DCT"
"ATTCGTTGTACAAACA"	"DCT"
"ATTCGTTGTACAGAAT"	"TAL_1"
"ATTCGTTTCCTAGCGG"	"CNT"
"ATTCGTTTCGCGATCG"	"TAL_1"
"ATTCTACAGTATGCAA"	"PT_2"
"ATTCTACCAAGTGATA"	"PT_2"
"ATTCTACCACTCACTC"	"TAL_2"
"ATTCTACCAGAGTTCT"	"TAL_2"
"ATTCTACCATTGTAGC"	"PT_1"
"ATTCTACGTGCCTATA"	"iPT"
"ATTCTACGTTCCTTGC"	"PT_1"
"ATTCTACTCAAGAATG"	"TAL_1"
"ATTCTTGAGGCCTGCT"	"TAL_1"
"ATTCTTGAGTAGCATA"	"iPT"
"ATTCTTGCAATATCCG"	"PT_1"
"ATTCTTGCAGGACTAG"	"TAL_1"
"ATTCTTGGTGGGATTG"	"PT_1"
"ATTCTTGTCCCGAGGT"	"POD"
"ATTCTTGTCGTCCTTG"	"PT_2"
"ATTGGGTGTCGCTGCA"	"DCT"
"ATTGGGTTCTACTATC"	"CNT"
"ATTGTTCAGCTGGCTC"	"DCT"
"ATTGTTCTCCCAGCGA"	"PEC"
"ATTGTTCTCCGCGGAT"	"PT_2"
"ATTTACCAGGCCTTCG"	"PT_1"
"ATTTACCAGGTTGGTG"	"PT_1"
"ATTTACCCATCCTTCG"	"PT_1"
"ATTTACCGTACAGGTG"	"TAL_2"
"ATTTACCGTGACAGGT"	"PEC"
"ATTTACCTCACTTCTA"	"POD"
"ATTTACCTCTGCAGCG"	"EC_1"
"ATTTCACCAGGCACAA"	"TAL_1"
"ATTTCACCATGTACGT"	"iPT"
"ATTTCACGTAACCCGC"	"TAL_2"
"ATTTCACGTATGATCC"	"POD"
"ATTTCACGTCCGGTGT"	"PT_2"
"ATTTCACTCCGCACTT"	"CNT"
"ATTTCACTCTAGTACG"	"TAL_1"
"ATTTCTGAGAATACAC"	"IC-A1"
"ATTTCTGCACAGAGAC"	"TAL_1"
"ATTTCTGCAGATACCT"	"TAL_3"
"ATTTCTGCATTCCTCG"	"PT_1"
"ATTTCTGGTCGAATTC"	"CNT"
"ATTTCTGTCACCGGTG"	"TAL_1"
"CAAAGAACAATTCGTG"	"EC_1"
"CAAAGAAGTACCTTCC"	"TAL_3"
"CAACAACAGGCTAAAT"	"EC_1"
"CAACAACCAAGGCAAC"	"PT_1"
"CAACAACCAGACGATG"	"PT_2"
"CAACAACTCAACACCA"	"PT_1"
"CAACAACTCATCGACA"	"iPT"
"CAACAACTCCGACAGC"	"PT_2"
"CAACAACTCGTTATCT"	"PT_1"
"CAACAGTCACACCTAA"	"PT_2"
"CAACAGTCACTGAATC"	"PEC"
"CAACAGTCAGCTCTGG"	"PT_1"
"CAACAGTGTTGGTACT"	"DCT"
"CAACCAACACAGAGAC"	"PT_2"
"CAACCAACAGCTAACT"	"PT_1"
"CAACCTCCAACAAGTA"	"TAL_1"
"CAACCTCCACCTCTAC"	"TAL_3"
"CAACCTCGTTGGTAGG"	"PT_1"
"CAACCTCTCCGATAAC"	"EC_2"
"CAACGATAGAGTAACT"	"PT_2"
"CAACGATCAAGAAACT"	"TAL_1"
"CAACGATGTATATGGA"	"TAL_2"
"CAACGATGTGAATGAT"	"EC_2"
"CAACGATTCGCTCCTA"	"EC_1"
"CAACGGCAGACGAGCT"	"PT_1"
"CAACGGCAGATACTGA"	"DCT"
"CAACGGCCATCCGAGC"	"TAL_1"
"CAACGGCGTCTCTCTG"	"PT_1"
"CAAGACTGTCCTGTTC"	"PT_1"
"CAAGAGGCAGACGCTC"	"PT_2"
"CAAGAGGCAGAGTTCT"	"CNT"
"CAAGAGGTCAGCCTTC"	"DCT"
"CAAGAGGTCCTGTACC"	"PT_2"
"CAAGCTAAGCAGCGAT"	"TAL_1"
"CAAGCTAAGTGGATAT"	"DCT"
"CAAGCTACACAGCCTG"	"EC_1"
"CAAGCTACACTAACCA"	"PT_2"
"CAAGCTATCAACCTTT"	"iPT"
"CAAGCTATCTTCGACC"	"PT_1"
"CAAGGGACACGTGAGA"	"TAL_1"
"CAAGGGACAGTTGTTG"	"EC_1"
"CAAGGGAGTATAGGAT"	"CNT"
"CAAGGGATCGTTCTGC"	"CNT"
"CAATACGAGGCCATAG"	"EC_2"
"CAATACGCAGTGTGCC"	"PT_1"
"CAATACGCATGTGCCG"	"PT_1"
"CAATACGTCCGATTAG"	"TAL_1"
"CAATACGTCGCCGAAC"	"iPT"
"CAATACGTCGTCTCAC"	"PT_2"
"CAATCGAAGCAACAGC"	"TAL_3"
"CAATCGAGTGCCTTTC"	"PT_1"
"CAATCGATCAGATTGC"	"CNT"
"CAATGACAGACTGAGC"	"PT_1"
"CAATGACAGCAACAAT"	"PT_1"
"CAATGACAGTATAACG"	"PT_1"
"CAATGACAGTCTGCAT"	"POD"
"CAATGACTCACACGAT"	"CNT"
"CAATTTCCAAGGCGTA"	"TAL_1"
"CAATTTCCAGTTCCAA"	"PT_2"
"CAATTTCTCTCATTAC"	"MC"
"CAATTTCTCTTCACGC"	"PT_1"
"CACAACAAGATGCTGG"	"TAL_2"
"CACAACAGTCCGGTCA"	"IC-A1"
"CACAACAGTTGTGTTG"	"PT_1"
"CACAACAGTTTAGACC"	"IC-A1"
"CACAACATCCATAGGT"	"TAL_2"
"CACAACATCTTAAGGC"	"EC_2"
"CACACAAAGCGACCCT"	"DCT"
"CACACAACAGCACGAA"	"PT_1"
"CACACAAGTTGTGTTG"	"TAL_2"
"CACACAATCACCTCGT"	"PT_1"
"CACAGATAGGATGTTA"	"PT_2"
"CACAGATCAAAGCTAA"	"CNT"
"CACAGATCATAGGCGA"	"iPT"
"CACAGATGTATGAGGC"	"TAL_2"
"CACAGATGTCAAATCC"	"PT_2"
"CACAGATGTCTTCATT"	"PT_1"
"CACAGATGTCTTGCTC"	"DCT"
"CACAGATTCTCTCGCA"	"iPT"
"CACAGGCGTTCGCGTG"	"TAL_1"
"CACAGGCGTTGAGGAC"	"CNT"
"CACAGGCTCCGTGTCT"	"EC_2"
"CACATGACAATGTGGG"	"CNT"
"CACATGATCCCGTGAG"	"PT_2"
"CACCAAACAACAAGTA"	"IC-A1"
"CACCAAACAACTCCAA"	"CNT"
"CACCAAAGTGTCGATT"	"iPT"
"CACCAAATCAGACATC"	"iPT"
"CACCAAATCGCTCTAC"	"TAL_1"
"CACCGTTAGAGGTTAT"	"EC_2"
"CACCGTTCAACACGAG"	"PT_1"
"CACCGTTCAAGGTCTT"	"CNT"
"CACCGTTCATGGCCCA"	"DCT"
"CACCGTTTCCCTCAAC"	"CNT"
"CACGAATAGAGAATCT"	"EC_1"
"CACGAATAGCTCGTGC"	"MC"
"CACGAATAGGGAGTGG"	"EC_1"
"CACGAATAGGTAGACC"	"PT_1"
"CACGAATAGTGCTAGG"	"EC_2"
"CACGAATCAGCTATAC"	"EC_1"
"CACGAATCATCGCCTT"	"TAL_1"
"CACGAATGTCGTTGGC"	"CNT"
"CACGAATTCCATCACC"	"IC-A1"
"CACGAATTCGAGTCCG"	"PT_1"
"CACGAATTCTTCCTAA"	"iPT"
"CACGGGTCATCAGCGC"	"TAL_1"
"CACGGGTGTCTATGAC"	"EC_1"
"CACGGGTTCAACCTCC"	"TAL_1"
"CACGGGTTCGATCCAA"	"PT_2"
"CACGGGTTCTGGTGGC"	"EC_2"
"CACGTGGAGTGGATTA"	"TAL_1"
"CACGTGGTCAGACCCG"	"PT_1"
"CACGTGGTCTAACACG"	"PT_1"
"CACGTTCAGGGCAATC"	"CNT"
"CACGTTCAGTAAACGT"	"IC-A1"
"CACGTTCCACAACGTT"	"DCT"
"CACGTTCGTATGCTTG"	"POD"
"CACTAAGAGCCTCATA"	"TAL_2"
"CACTAAGCAACACACT"	"PT_2"
"CACTAAGCAAGACGGT"	"EC_2"
"CACTAAGCATCTCAAG"	"IC-A1"
"CACTAAGGTCCACATA"	"PT_1"
"CACTAAGGTTGACTAC"	"TAL_1"
"CACTAAGTCGCCGAGT"	"TAL_2"
"CACTGAACAAATGGCG"	"TAL_1"
"CACTGAAGTACCAATC"	"TAL_2"
"CACTGAAGTTCAGTAC"	"TAL_3"
"CACTGGGAGAATTGTG"	"TAL_1"
"CACTGGGAGGGCTAAC"	"DCT"
"CACTGGGAGTAGAGTT"	"DCT"
"CACTGGGAGTCTGGTT"	"DCT"
"CACTGGGAGTGTACAA"	"CNT"
"CACTGGGCAGACCAAG"	"EC_1"
"CACTGGGGTCCTCCTA"	"EC_2"
"CACTGGGGTGTTGATC"	"TAL_1"
"CACTGGGTCATTGCCC"	"CNT"
"CACTGGGTCATTTGCT"	"DCT"
"CACTGTCCAGCGAGTA"	"PEC"
"CACTGTCGTCAGTTTG"	"TAL_3"
"CACTGTCTCACCGGTG"	"PT_2"
"CACTTCGAGCAAGCCA"	"PEC"
"CACTTCGAGTACAACA"	"CNT"
"CACTTCGCAAGGTCAG"	"IC-A1"
"CACTTCGCAGTTCACA"	"TAL_1"
"CACTTCGGTCGGAACA"	"PT_2"
"CACTTCGGTTGTATGC"	"TAL_2"
"CACTTCGTCGATACTG"	"TAL_3"
"CAGAGCCAGACCATTC"	"TAL_3"
"CAGAGCCAGGCTTCCG"	"PT_1"
"CAGAGCCCAAGTGGCA"	"TAL_3"
"CAGAGCCCATAGGTAA"	"TAL_1"
"CAGAGCCGTCACTTCC"	"DCT"
"CAGAGCCTCCTGGCTT"	"TAL_1"
"CAGATACAGATGAAGG"	"TAL_1"
"CAGATACAGCAAGTGC"	"PT_1"
"CAGATACAGGTGATCG"	"DCT"
"CAGATACGTGCCTACG"	"PT_1"
"CAGATACTCAATCCGA"	"PT_1"
"CAGATCACATACAGAA"	"iPT"
"CAGATCACATCGGAAG"	"TAL_1"
"CAGATCATCCAGTACA"	"PEC"
"CAGATTGAGGACTATA"	"iPT"
"CAGATTGCACGCGCAT"	"EC_1"
"CAGATTGGTGAATATG"	"IC-A1"
"CAGATTGGTGCCTTTC"	"PT_1"
"CAGATTGTCATTACCT"	"EC_1"
"CAGATTGTCCCTTGGT"	"PT_1"
"CAGATTGTCTTCGGAA"	"TAL_2"
"CAGCAATCATGACACT"	"PT_1"
"CAGCAATGTACTCCGG"	"POD"
"CAGCAATGTCTCCTGT"	"IC-A1"
"CAGCAATGTGTCCTAA"	"PT_2"
"CAGCACGCACTACAGT"	"TAL_1"
"CAGCACGGTCATAAAG"	"PT_1"
"CAGCACGGTTAGAGAT"	"IC-B"
"CAGCACGTCCCTTGTG"	"IC-A1"
"CAGCAGCAGAAGTCCG"	"CNT"
"CAGCAGCAGAATAACC"	"iPT"
"CAGCAGCAGATGACCG"	"POD"
"CAGCAGCCATCGTCCT"	"EC_1"
"CAGCAGCGTTTGGGTT"	"PT_1"
"CAGCCAGAGAGTCACG"	"CNT"
"CAGCCAGAGATCACCT"	"POD"
"CAGCCAGAGTCCCAAT"	"PT_1"
"CAGCCAGAGTTTGTCG"	"TAL_1"
"CAGCCAGGTGGACTGA"	"PT_1"
"CAGCCAGTCGCCGATG"	"TAL_2"
"CAGCCAGTCGGTAGGA"	"DCT"
"CAGCCAGTCTGCACCT"	"CNT"
"CAGCGTGAGGACAAGA"	"TAL_1"
"CAGCGTGAGGGAGGCA"	"DCT"
"CAGCGTGCACGTTGGC"	"iPT"
"CAGCGTGCAGCACAAG"	"PT_1"
"CAGCGTGCATCGCCTT"	"PT_2"
"CAGCGTGTCCACTTTA"	"TAL_1"
"CAGCGTGTCTTGAACG"	"CNT"
"CAGGCCAAGGAGGCAG"	"TAL_1"
"CAGGCCACAGGGATAC"	"DCT"
"CAGGCCATCGTTATCT"	"DCT"
"CAGGGCTAGAAGGGAT"	"TAL_3"
"CAGGGCTCAACTCATG"	"PT_1"
"CAGGGCTCACGCTATA"	"IC-A1"
"CAGGGCTCACGTACAT"	"iPT"
"CAGGGCTCATTCTGTT"	"IC-A1"
"CAGGGCTGTACGATTC"	"PT_1"
"CAGGGCTTCTAGGCCG"	"IC-A1"
"CAGGGCTTCTGTCCCA"	"EC_1"
"CAGGGCTTCTTGAACG"	"CNT"
"CAGGTATAGGGAGGGT"	"PT_1"
"CAGGTATCAACTCATG"	"POD"
"CAGGTATCATCCTGTC"	"CNT"
"CAGGTATGTACGGGAT"	"IC-A1"
"CAGGTATTCTCCCATG"	"CNT"
"CAGTGCGCAGGCTATT"	"PT_1"
"CAGTGCGGTATGAGCG"	"DCT"
"CAGTTAGAGCAGGTCA"	"EC_2"
"CAGTTAGCAGCTAACT"	"IC-A1"
"CAGTTAGCATCTGTTT"	"CNT"
"CAGTTAGCATGTTCGA"	"IC-A1"
"CAGTTAGCATTGTAGC"	"TAL_1"
"CAGTTAGTCATTCCTA"	"TAL_1"
"CAGTTCCAGTTTGGCT"	"CNT"
"CAGTTCCCAGTCGTTA"	"CNT"
"CAGTTCCCATCGGAGA"	"IC-A1"
"CAGTTCCGTATTCTCT"	"PT_1"
"CAGTTCCGTTCCACGG"	"TAL_3"
"CAGTTCCTCATTTCCA"	"TAL_1"
"CAGTTCCTCTCTTCAA"	"CNT"
"CATAAGCTCAGTGGGA"	"DCT"
"CATAAGCTCTCTCTTC"	"CNT"
"CATACAGAGGTACAAT"	"PT_1"
"CATACAGCACCTGCAG"	"PT_1"
"CATACAGCAGTAACCT"	"POD"
"CATACAGCATTGTGCA"	"PT_2"
"CATACAGTCTCTTCAA"	"iPT"
"CATACCCAGCTGTTCA"	"PT_2"
"CATACCCCACGTACTA"	"IC-A1"
"CATACCCCATCTTCGC"	"PT_1"
"CATACCCGTGCACAAG"	"PT_1"
"CATACCCGTTAAAGTG"	"EC_1"
"CATACCCGTTCGAGCC"	"POD"
"CATACCCTCGTCGGGT"	"IC-A1"
"CATACTTAGGTAGTCG"	"TAL_1"
"CATACTTCATTCACAG"	"PT_1"
"CATACTTGTAACTAAG"	"TAL_1"
"CATACTTGTACTGACT"	"DCT"
"CATAGACAGCACGGAT"	"EC_2"
"CATAGACAGCCATTTG"	"EC_1"
"CATAGACCATCCCGTT"	"PEC"
"CATAGACCATCCGATA"	"PT_1"
"CATAGACGTCGGCACT"	"TAL_1"
"CATCAAGAGTAGGTTA"	"TAL_1"
"CATCAAGGTGTCCGTG"	"EC_1"
"CATCAAGTCATGGGAG"	"TAL_1"
"CATCCACAGCAAGCCA"	"IC-A1"
"CATCCACCACGGTGAA"	"TAL_3"
"CATCCACCACTTCCTG"	"CNT"
"CATCCACTCTTCCCAG"	"iPT"
"CATCCCAAGAAGCCAC"	"PT_1"
"CATCCCAAGCGACAGT"	"iPT"
"CATCCCAGTACAAGCG"	"IC-B"
"CATCCCAGTACGAAAT"	"TAL_2"
"CATCCCAGTGCGAGTA"	"POD"
"CATCCCAGTGGACCAA"	"IC-A1"
"CATCCCAGTGGACTGA"	"PT_2"
"CATCCCAGTTCTCAGA"	"TAL_1"
"CATCCCATCGAGAAGC"	"TAL_3"
"CATCCCATCTTCGATT"	"PT_1"
"CATCCGTAGGCGTTAG"	"TAL_1"
"CATCCGTAGTCGAAGC"	"IC-A1"
"CATCCGTCAACAAGTA"	"CNT"
"CATCCGTCAACCAGAG"	"PT_1"
"CATCCGTGTCAACACT"	"iPT"
"CATCGCTAGACTCATC"	"TAL_1"
"CATCGCTAGGTACTGG"	"CNT"
"CATCGCTAGTCGTCTA"	"DCT"
"CATCGGGAGACAGCGT"	"iPT"
"CATCGGGAGCAGTAAT"	"EC_2"
"CATCGGGAGGCGACAT"	"PEC"
"CATCGGGAGGTTCATC"	"IC-A1"
"CATCGGGCAAGTTTGC"	"TAL_1"
"CATCGGGCAGCGTAGA"	"CNT"
"CATCGGGGTCAGACGA"	"CNT"
"CATCGGGTCAAGCCCG"	"DCT"
"CATCGGGTCTCGACCT"	"DCT"
"CATCGTCAGTTGTAAG"	"POD"
"CATCGTCTCCCATGGG"	"EC_2"
"CATGAGTAGCTAAACA"	"DCT"
"CATGAGTCAATTTCTC"	"TAL_1"
"CATGAGTGTCTACGAT"	"PT_2"
"CATGAGTTCACTCCGT"	"TAL_3"
"CATGCAAAGACTGGGT"	"EC_1"
"CATGCAACAGATCCTA"	"CNT"
"CATGCAACATGTGCCG"	"IC-A1"
"CATGCAAGTCGTGATT"	"EC_1"
"CATGCAATCAAACGAA"	"PT_1"
"CATGCAATCACATTGG"	"EC_2"
"CATGCAATCATAAGGA"	"CNT"
"CATGCAATCATCACTT"	"TAL_1"
"CATGCAATCCAATCCC"	"iPT"
"CATGCCTGTGCATGAG"	"TAL_1"
"CATGCGGAGGGAGATA"	"MC"
"CATGCGGCAGGTCAGA"	"PT_1"
"CATGCTCAGAGATCGC"	"CNT"
"CATGCTCAGATTTGCC"	"TAL_3"
"CATGCTCAGGTCCAGA"	"PT_1"
"CATGCTCCACATATGC"	"TAL_1"
"CATGCTCGTCATAGTC"	"TAL_1"
"CATGCTCTCGAATCCA"	"PT_1"
"CATGCTCTCTTAAGGC"	"EC_2"
"CATGGATAGACCATTC"	"PT_1"
"CATGGATAGCTCAGAG"	"CNT"
"CATGGATCATGGACAG"	"PT_2"
"CATGGATGTACAAACA"	"PT_2"
"CATGGATTCTGAACGT"	"DCT"
"CATGGTACAGTTCACA"	"CNT"
"CATGGTAGTATCGCTA"	"PT_1"
"CATGGTAGTCCAGCGT"	"PT_1"
"CATGGTAGTCCCTGTT"	"iPT"
"CATGGTAGTTAATGAG"	"POD"
"CATGGTATCACGAGGA"	"CNT"
"CATGGTATCCGTTGGG"	"CNT"
"CATTCCGCAACATACC"	"PT_2"
"CATTCCGCAATGTGGG"	"MC"
"CATTCCGCAGGCCTGT"	"POD"
"CATTCCGTCGACACCG"	"TAL_1"
"CATTCCGTCGGACTTA"	"TAL_1"
"CATTCTAAGATGGTCG"	"PEC"
"CATTCTACAAACTCTG"	"POD"
"CATTCTACACAAATCC"	"EC_1"
"CATTCTATCGTCGCTT"	"PT_1"
"CATTGAGAGAGATCGC"	"DCT"
"CATTGAGAGAGTGACC"	"POD"
"CATTGAGCAAACGAGC"	"PT_2"
"CATTGAGGTTCGGCCA"	"CNT"
"CATTGTTAGAGAGGTA"	"IC-A1"
"CATTGTTAGTAAACAC"	"PT_1"
"CATTGTTCACCAGCGT"	"POD"
"CATTGTTCACTACTTT"	"iPT"
"CATTGTTCAGCTTCGG"	"TAL_1"
"CATTGTTGTACCTAGT"	"DCT"
"CATTGTTGTTGCGGCT"	"TAL_3"
"CATTGTTTCATGCAGT"	"PT_1"
"CATTGTTTCGTTGTTT"	"PT_1"
"CATTTCAAGTTGGACG"	"CNT"
"CATTTCACACAGAGCA"	"PT_1"
"CATTTCAGTCCATAGT"	"CNT"
"CCAAGCGAGTATGACA"	"EC_1"
"CCAAGCGCAGACGATG"	"CNT"
"CCAAGCGGTACCATAC"	"PT_1"
"CCAATGAAGAGATTCA"	"PT_1"
"CCAATGATCCACGTCT"	"PT_2"
"CCAATTTCACACTTAG"	"PT_2"
"CCAATTTCAGAGGTAC"	"TAL_3"
"CCAATTTGTCCAAATC"	"TAL_1"
"CCAATTTGTTGCCGCA"	"CNT"
"CCACAAACAGAGTGAC"	"TAL_2"
"CCACAAACAGTTTCGA"	"PT_1"
"CCACAAACATCGCTAA"	"DCT"
"CCACAAAGTATCAAGA"	"CNT"
"CCACAAAGTTTCGTTT"	"CNT"
"CCACACTAGGACTATA"	"iPT"
"CCACACTAGTGCCCGT"	"POD"
"CCACACTCATCTTTCA"	"TAL_2"
"CCACACTCATGTCTAG"	"IC-A1"
"CCACACTTCCTCACTG"	"PT_1"
"CCACACTTCGCTACGG"	"PT_2"
"CCACACTTCTGTCCCA"	"IC-A1"
"CCACCATAGCCTCAAT"	"CNT"
"CCACCATAGGAAAGGT"	"DCT"
"CCACCATCAACAGCCC"	"IC-A1"
"CCACCATCAATCTAGC"	"EC_1"
"CCACCATCACCCATAA"	"CNT"
"CCACCATCATACATCG"	"iPT"
"CCACCATGTGCATTAC"	"TAL_1"
"CCACCATTCATTCACT"	"TAL_1"
"CCACCATTCGCCATAA"	"DCT"
"CCACGAGCACGGCTAC"	"PT_1"
"CCACGAGCACTAACCA"	"PT_1"
"CCACGAGCAGATAAAC"	"TAL_3"
"CCACGAGCAGGACAGT"	"EC_2"
"CCACGAGCAGGGACTA"	"TAL_1"
"CCACGAGTCGTTGCCT"	"CNT"
"CCACGTTAGGTTGGAC"	"PT_1"
"CCACGTTAGTCGAGGT"	"IC-A1"
"CCACGTTCAGACAATA"	"EC_1"
"CCACGTTCAGTCGTTA"	"TAL_1"
"CCACGTTTCGTCACCT"	"iPT"
"CCACGTTTCTTCGCTG"	"CNT"
"CCACTTGGTAGGCTCC"	"PT_2"
"CCACTTGGTCCAACGC"	"PT_1"
"CCATAAGAGGAGGGTG"	"POD"
"CCATAAGGTAGATCCT"	"IC-A1"
"CCATAAGGTATGCTAC"	"POD"
"CCATAAGGTCCGACGT"	"TAL_2"
"CCATAAGGTCTTCCGT"	"TAL_2"
"CCATCACAGGAGACCT"	"CNT"
"CCATCACCACGCTGCA"	"TAL_1"
"CCCAACTAGATTTGCC"	"TAL_1"
"CCCAACTAGGCTAAAT"	"EC_2"
"CCCAACTAGTGTAGAT"	"TAL_1"
"CCCAACTCACGGGCTT"	"TAL_3"
"CCCAACTGTACAGAAT"	"POD"
"CCCAACTGTACAGTCT"	"TAL_2"
"CCCAACTGTAGCCAGA"	"CNT"
"CCCAACTGTGTACAGG"	"TAL_1"
"CCCAACTGTTCTTAGG"	"TAL_2"
"CCCAACTTCCCAGGCA"	"IC-A1"
"CCCAACTTCTGACCCT"	"TAL_3"
"CCCATTGAGAATGTTG"	"IC-A1"
"CCCATTGCACAGAGAC"	"DCT"
"CCCATTGCACTACCGG"	"TAL_3"
"CCCATTGCATCTCAAG"	"PT_1"
"CCCATTGGTACTGTTG"	"EC_1"
"CCCATTGGTCAAAGAT"	"iPT"
"CCCATTGTCAAGATAG"	"PT_1"
"CCCATTGTCCGGCAGT"	"PT_2"
"CCCATTGTCGATTCCC"	"EC_1"
"CCCGAAGAGAAGTCTA"	"TAL_1"
"CCCGAAGAGCGGTAGT"	"CNT"
"CCCGAAGGTATGTCCA"	"DCT"
"CCCGAAGGTTTGCCGG"	"PT_2"
"CCCGAAGTCCGTAGGC"	"MC"
"CCCGGAAGTCGGTAAG"	"PT_1"
"CCCGGAAGTCGTGCCA"	"CNT"
"CCCGGAAGTGACCTGC"	"EC_1"
"CCCGGAATCCCACAGG"	"PT_1"
"CCCTAACAGAACAAGG"	"iPT"
"CCCTAACCAAGTCATC"	"TAL_1"
"CCCTAACCAGCTGCCA"	"DCT"
"CCCTAACGTACAGTTC"	"EC_2"
"CCCTAACGTAGATTGA"	"MC"
"CCCTAACGTCTAATCG"	"iPT"
"CCCTAACGTGGCCACT"	"PT_2"
"CCCTAACTCGCTTGCT"	"POD"
"CCCTCAACATCGCTGG"	"DCT"
"CCCTCAAGTGCCTTCT"	"PT_2"
"CCCTCAATCCGTCACT"	"PT_1"
"CCCTCTCAGATCGACG"	"PEC"
"CCCTCTCAGCGTTCCG"	"CNT"
"CCCTCTCAGCTGAAAT"	"TAL_1"
"CCCTCTCAGTAGAATC"	"PT_1"
"CCCTCTCCACTGTCCT"	"iPT"
"CCCTCTCCAGAATTCC"	"EC_2"
"CCCTCTCGTCTCACGG"	"CNT"
"CCCTCTCGTGTCCTAA"	"TAL_1"
"CCCTCTCGTTAACCTG"	"IC-B"
"CCCTCTCGTTAGGAGC"	"EC_1"
"CCCTCTCGTTGTATGC"	"PT_1"
"CCCTCTCTCATTGTTC"	"TAL_1"
"CCCTCTCTCCAATCTT"	"IC-B"
"CCCTGATAGTATGAGT"	"TAL_1"
"CCCTGATCAGATACTC"	"POD"
"CCCTGATGTCACTCGG"	"PT_1"
"CCCTGATGTCGCCACA"	"EC_2"
"CCCTGATTCACACGAT"	"PT_1"
"CCCTTAGAGCGTGCCT"	"PT_2"
"CCCTTAGCACGGAAGT"	"TAL_1"
"CCCTTAGGTGGCTACC"	"TAL_1"
"CCCTTAGTCTGGTGCG"	"IC-A1"
"CCGAACGCAGGCTATT"	"DCT"
"CCGAACGCATAGCTGT"	"PT_1"
"CCGAACGGTGTGATGG"	"PT_1"
"CCGAACGGTTCCGCGA"	"TAL_1"
"CCGAACGTCTCCGCAT"	"EC_2"
"CCGATCTCACGACGAA"	"EC_2"
"CCGATCTCATGGCGCT"	"iPT"
"CCGATCTGTCGTCTCT"	"PT_1"
"CCGATCTGTGTTTACG"	"MC"
"CCGATCTTCTCTTAAC"	"PT_1"
"CCGATGGAGAGAATCT"	"PT_1"
"CCGATGGGTTGAATCC"	"MC"
"CCGATGGTCCATCAGA"	"PT_2"
"CCGATGGTCTAAGCGT"	"POD"
"CCGCAAGAGAGTCAGC"	"PT_1"
"CCGCAAGAGCTGACCC"	"iPT"
"CCGCAAGCACAAGGTG"	"IC-A1"
"CCGCAAGCAGAGACTG"	"CNT"
"CCGCAAGCAGTGCGCT"	"TAL_2"
"CCGCAAGGTTCTAACG"	"TAL_1"
"CCGCAAGTCTGGCCTT"	"TAL_1"
"CCGGACAAGCATGCAG"	"DCT"
"CCGGACAAGGGCAATC"	"IC-A1"
"CCGGACAAGGGCAGTT"	"TAL_1"
"CCGGACACAAGATCCT"	"IC-A1"
"CCGGACACATATAGCC"	"IC-B"
"CCGGACACATCATCCC"	"CNT"
"CCGGACACATGAAAGT"	"IC-A1"
"CCGGACAGTGATACAA"	"POD"
"CCGGACATCGACACTA"	"PT_2"
"CCGGGTAAGCATCCCG"	"EC_2"
"CCGGGTACACTAGTAC"	"IC-A1"
"CCGGGTACAGAGTCTT"	"EC_1"
"CCGGTAGAGTTGTCGT"	"DCT"
"CCGGTAGCAGCCCAGT"	"EC_2"
"CCGGTAGCATGGATCT"	"TAL_2"
"CCGGTAGGTACGATCT"	"PT_2"
"CCGGTAGGTTCCGTTC"	"iPT"
"CCGGTGAGTATACAGA"	"TAL_1"
"CCGGTGAGTCGGAACA"	"PT_1"
"CCGGTGAGTTGGGAAC"	"CNT"
"CCGTAGGCACACCGCA"	"EC_1"
"CCGTAGGGTAGCGCCT"	"EC_2"
"CCGTAGGGTGATGAAT"	"iPT"
"CCGTAGGGTTCAGCTA"	"EC_1"
"CCGTAGGGTTGAGGAC"	"PT_2"
"CCGTGAGAGATGCCGA"	"TAL_1"
"CCGTGAGGTCGTGATT"	"TAL_1"
"CCGTTCAAGACCATGG"	"EC_2"
"CCGTTCACACTTTAGG"	"EC_1"
"CCGTTCACATATGCGT"	"IC-A1"
"CCGTTCATCGAGAGAC"	"TAL_2"
"CCTAACCAGACTGAGC"	"TAL_3"
"CCTAACCAGCATCCTA"	"PT_1"
"CCTAACCAGCGACTGA"	"TAL_2"
"CCTAACCCAAGAGGCT"	"TAL_1"
"CCTAACCCAGTTCACA"	"TAL_1"
"CCTAACCGTATGCGGA"	"CNT"
"CCTAACCGTCATCGCG"	"TAL_3"
"CCTAACCGTTAGTTCG"	"TAL_1"
"CCTAACCGTTGAAGTA"	"PT_1"
"CCTAACCTCATAGGCT"	"EC_1"
"CCTAAGAAGCGTTACT"	"CNT"
"CCTAAGAGTTACGTAC"	"CNT"
"CCTAAGATCACCGGGT"	"TAL_1"
"CCTACGTAGATTGTGA"	"PT_1"
"CCTACGTCACGGTAGA"	"EC_2"
"CCTACGTCAGGCTCTG"	"TAL_2"
"CCTACGTGTGCAATGG"	"CNT"
"CCTACGTTCCACACCT"	"iPT"
"CCTACGTTCTGCCCTA"	"TAL_2"
"CCTATCGAGCTCTGTA"	"EC_1"
"CCTATCGAGGAGGTTC"	"PT_1"
"CCTATCGCAATAACGA"	"IC-A1"
"CCTATCGCAATCGCGC"	"PT_1"
"CCTATCGCATCTATCT"	"TAL_3"
"CCTATCGTCACTCCGT"	"IC-A1"
"CCTCAACCAGAACCGA"	"EC_1"
"CCTCAACCAGACGATG"	"EC_1"
"CCTCAACCAGGTCCGT"	"PT_1"
"CCTCAACGTACTAGCT"	"DCT"
"CCTCAACGTTATGACC"	"PT_1"
"CCTCACAAGGTTGCCC"	"PEC"
"CCTCACAGTGTACAGG"	"TAL_1"
"CCTCAGTAGGACCCAA"	"IC-A1"
"CCTCAGTCAGGGTCTC"	"EC_2"
"CCTCAGTGTCACTAGT"	"POD"
"CCTCAGTGTCCAAATC"	"TAL_1"
"CCTCAGTGTCGGTGTC"	"PT_1"
"CCTCAGTGTTGCAAGG"	"TAL_1"
"CCTCAGTGTTTACACG"	"EC_2"
"CCTCATGGTACTCGAT"	"PT_1"
"CCTCATGGTCCAAAGG"	"IC-A1"
"CCTCATGGTCTGTGAT"	"PT_1"
"CCTCCAAAGATGACAT"	"TAL_2"
"CCTCCAACATCGGCCA"	"TAL_2"
"CCTCCAAGTGCACAAG"	"TAL_1"
"CCTCCAAGTGGTCTGC"	"TAL_3"
"CCTCCAAGTTTCGACA"	"TAL_2"
"CCTCCAATCTGGGAGA"	"PT_1"
"CCTCCTCCAAGCGCTC"	"EC_1"
"CCTCCTCCACTTTATC"	"TAL_2"
"CCTCCTCCATGAATCC"	"PT_1"
"CCTCCTCTCAATCCAG"	"PT_1"
"CCTCCTCTCCATCACC"	"PT_1"
"CCTCCTCTCTTCTCAA"	"PT_2"
"CCTCTAGAGGTTGGTG"	"iPT"
"CCTCTAGAGTATGGAT"	"TAL_1"
"CCTCTAGCAATTGGTC"	"TAL_3"
"CCTCTAGCATTCCTAT"	"TAL_1"
"CCTCTAGGTCCAAGAG"	"PT_1"
"CCTCTAGGTCGAATTC"	"PT_2"
"CCTCTAGGTTCCGCGA"	"TAL_1"
"CCTCTAGTCAGGTAAA"	"PT_2"
"CCTCTAGTCATTATCC"	"DCT"
"CCTCTAGTCGCATTAG"	"EC_2"
"CCTCTCCCAAATTGCC"	"EC_1"
"CCTCTCCCATTCTCCG"	"iPT"
"CCTCTCCGTGCAATAA"	"TAL_2"
"CCTCTCCGTTATCTTC"	"EC_1"
"CCTCTCCGTTTCAGAC"	"TAL_3"
"CCTCTCCTCATGGAGG"	"CNT"
"CCTGCATCAAGTGCAG"	"PT_1"
"CCTGCATGTACCTAAC"	"PEC"
"CCTGTTGAGTAACGAT"	"PT_2"
"CCTGTTGCAGCGATTT"	"TAL_3"
"CCTGTTGGTATACGGG"	"PT_1"
"CCTGTTGGTATCGAAA"	"TAL_1"
"CCTGTTGGTGACTCGC"	"PT_1"
"CCTGTTGTCAACACGT"	"PT_1"
"CCTGTTGTCGAGAGCA"	"TAL_1"
"CCTTCAGCAACCACGC"	"DCT"
"CCTTCAGGTAACAGTA"	"CNT"
"CCTTCAGGTATCGGTT"	"EC_1"
"CCTTCAGTCGTAGTCA"	"CNT"
"CCTTGTGCAGACTGCC"	"CNT"
"CCTTGTGGTTCGGTAT"	"CNT"
"CCTTGTGGTTCTGAGT"	"PT_1"
"CCTTGTGTCACCCTTG"	"PT_1"
"CCTTGTGTCGGTGTAT"	"PT_1"
"CCTTGTGTCGTTAGAC"	"EC_1"
"CCTTGTGTCTACACTT"	"PT_1"
"CCTTTGGCACACTTAG"	"MC"
"CCTTTGGCACCTCGTT"	"IC-A1"
"CCTTTGGCATCCGGCA"	"PT_2"
"CGAAGGAAGCGTGAAC"	"PT_1"
"CGAAGGATCAAAGCCT"	"PT_1"
"CGAAGGATCTGAGGCC"	"PT_1"
"CGAAGTTAGCCGAATG"	"EC_2"
"CGAAGTTCAAATAAGC"	"PT_1"
"CGAAGTTGTACCAGAG"	"TAL_1"
"CGAAGTTGTTTCCATT"	"CNT"
"CGAAGTTTCACTTTGT"	"DCT"
"CGAAGTTTCGTAGGAG"	"PT_1"
"CGAAGTTTCGTGCATA"	"MC"
"CGAATTGAGAGCCCAA"	"PT_2"
"CGAATTGGTAACACCT"	"PT_1"
"CGAATTGGTTCCTACC"	"IC-A1"
"CGAATTGGTTTCGACA"	"PT_1"
"CGAATTGTCTATTTCG"	"TAL_1"
"CGACAGCCAAATGGTA"	"PT_1"
"CGACAGCCAGAGAGGG"	"TAL_2"
"CGACAGCCAGGAAGTC"	"TAL_1"
"CGACAGCGTCCCAAAT"	"TAL_3"
"CGACAGCGTCTGTGAT"	"TAL_3"
"CGACAGCTCATAGAGA"	"PEC"
"CGACAGCTCTCGTCGT"	"CNT"
"CGAGAAGCACCGTACG"	"TAL_3"
"CGAGAAGGTCCTCAGG"	"iPT"
"CGAGAAGGTTGCTCAA"	"POD"
"CGAGAAGTCGAGCCAC"	"PT_1"
"CGAGAAGTCGGCATCG"	"PT_1"
"CGAGAAGTCTCTCGCA"	"IC-A1"
"CGAGGAACAGACCAAG"	"EC_1"
"CGAGGAAGTTGGACTT"	"POD"
"CGAGGCTAGCCGCTTG"	"EC_2"
"CGAGGCTGTACTCGTA"	"EC_1"
"CGAGGCTGTAGCTGAG"	"TAL_2"
"CGAGGCTGTCTTCATT"	"POD"
"CGAGGCTTCGCGGACT"	"TAL_1"
"CGAGGCTTCGTCCATC"	"PT_1"
"CGAGGCTTCTTTCCAA"	"iPT"
"CGAGTGCAGCGCTGCT"	"PT_2"
"CGAGTGCCAACCGCCA"	"EC_1"
"CGAGTGCGTTAATGAG"	"TAL_2"
"CGAGTGCTCACTTGGA"	"iPT"
"CGAGTTAAGAAGGTAG"	"PT_2"
"CGAGTTAAGCAAATCA"	"TAL_1"
"CGAGTTAAGCAAGCCA"	"PT_1"
"CGAGTTAAGCGACTTT"	"IC-A1"
"CGAGTTACACCCAAGC"	"DCT"
"CGAGTTAGTGGCTACC"	"TAL_1"
"CGAGTTATCAGCTGAT"	"PT_1"
"CGAGTTATCTCGCTCA"	"TAL_1"
"CGATCGGAGATGGCGT"	"TAL_1"
"CGATCGGCACTTCAGA"	"MC"
"CGATCGGTCCGAAGGA"	"TAL_1"
"CGATCGGTCCGTGGCA"	"IC-A1"
"CGATGCGAGATACCAA"	"TAL_2"
"CGATGCGCACCTGCAG"	"DCT"
"CGATGCGGTACCTATG"	"PT_1"
"CGATGCGGTTGTGGCC"	"DCT"
"CGATGCGTCATGCCCT"	"TAL_3"
"CGATGGCCAACCTAAC"	"PT_2"
"CGATGGCCACCGTGGT"	"CNT"
"CGATGGCGTGTATTGC"	"IC-A1"
"CGATGGCTCAGACCCG"	"TAL_1"
"CGATGGCTCATTACCT"	"PT_1"
"CGCAGGTAGATTCGAA"	"PT_1"
"CGCAGGTAGTGAGGTC"	"IC-A1"
"CGCAGGTGTCAGTTTG"	"CNT"
"CGCAGGTTCGTTCCTG"	"CNT"
"CGCATAAAGTCTTGGT"	"MC"
"CGCATAAAGTTGCGCC"	"TAL_1"
"CGCATAACATCGGAGA"	"PT_1"
"CGCATAAGTCCAGGTC"	"EC_2"
"CGCATAATCGGACCAC"	"EC_1"
"CGCATGGAGGTCTTTG"	"POD"
"CGCATGGGTCACGCTG"	"PT_1"
"CGCCAGAGTAGCTAAA"	"DCT"
"CGCCAGATCCGATTAG"	"TAL_1"
"CGCCATTGTGCGCTCA"	"PT_1"
"CGCCATTTCCGTATGA"	"TAL_3"
"CGCGTGAGTACGAGCA"	"EC_1"
"CGCGTGATCAGTGTCA"	"DCT"
"CGCGTGATCATCACAG"	"PT_2"
"CGCGTGATCGACGATT"	"CNT"
"CGCGTGATCGCGGACT"	"EC_1"
"CGGAACCAGCAGCAGT"	"IC-B"
"CGGAACCAGTGGACGT"	"iPT"
"CGGAACCCAGCTGAGA"	"PT_2"
"CGGAACCGTCTACGTA"	"iPT"
"CGGAACCTCCTCACGT"	"EC_1"
"CGGAACCTCGTGGCGT"	"TAL_2"
"CGGAATTAGCTAAACA"	"TAL_1"
"CGGAATTGTACGCTTA"	"POD"
"CGGAATTGTATTGGCT"	"PT_2"
"CGGAATTGTCTTCTAT"	"IC-B"
"CGGAATTGTTCCCAAA"	"CNT"
"CGGAATTTCCTCCACA"	"DCT"
"CGGAATTTCCTTTAGT"	"DCT"
"CGGACACGTCTGTGGC"	"PT_1"
"CGGAGAAAGAGAGCAA"	"EC_2"
"CGGAGAAAGAGCAGTC"	"EC_2"
"CGGAGAAAGCGTGAAC"	"iPT"
"CGGAGAAAGGGCCCTT"	"PEC"
"CGGAGAAAGGTGCCTC"	"PT_1"
"CGGAGAAAGGTGCTAG"	"DCT"
"CGGAGAACAATATCCG"	"PT_1"
"CGGAGAAGTAATTGGA"	"PT_2"
"CGGAGAAGTCGACGCT"	"PT_1"
"CGGAGAATCCCGAGTG"	"DCT"
"CGGAGAATCTTCTCAA"	"TAL_1"
"CGGCAGTAGATTAGTG"	"PT_1"
"CGGCAGTAGCGTGCTC"	"iPT"
"CGGCAGTAGCTAGCCC"	"DCT"
"CGGCAGTAGGGATGTC"	"iPT"
"CGGCAGTCAACGGCCT"	"TAL_1"
"CGGCAGTCAATTAGGA"	"MC"
"CGGCAGTCACAGTCCG"	"EC_2"
"CGGCAGTCATACAGGG"	"TAL_2"
"CGGCAGTTCACTGTCC"	"PT_1"
"CGGCAGTTCTCGTGAA"	"TAL_2"
"CGGCAGTTCTCTTGCG"	"PT_2"
"CGGGACTAGAGCCCAA"	"TAL_2"
"CGGGACTAGTGCACCC"	"EC_2"
"CGGGACTGTGTACAGG"	"EC_2"
"CGGGACTGTTAAGCAA"	"DCT"
"CGGGACTTCTAATTCC"	"CNT"
"CGGGCATAGTACTGTC"	"PEC"
"CGGGCATAGTAGGGTC"	"PT_1"
"CGGGCATGTCTCGACG"	"TAL_2"
"CGGGCATTCCGCTAGG"	"PT_1"
"CGGGTCAAGATGCAGC"	"TAL_1"
"CGGGTCAAGGGTGAAA"	"IC-B"
"CGGGTCATCACCCTCA"	"PT_1"
"CGGGTCATCTTGGTGA"	"EC_1"
"CGGGTGTTCGCTACGG"	"CNT"
"CGGGTGTTCTGCAGCG"	"iPT"
"CGGTCAGAGTGTTGAA"	"IC-A1"
"CGGTCAGTCGCTCTAC"	"iPT"
"CGGTCAGTCTACCTTA"	"TAL_1"
"CGTAAGTGTCATCGGC"	"TAL_3"
"CGTAAGTGTTTCGTAG"	"IC-B"
"CGTAAGTTCACTACGA"	"PT_1"
"CGTAAGTTCAGCTGTA"	"CNT"
"CGTAAGTTCTAAGAAG"	"PT_1"
"CGTAATGAGCGGACAT"	"IC-A1"
"CGTAATGTCAGCAGAG"	"iPT"
"CGTAATGTCCAAGCCG"	"TAL_1"
"CGTAATGTCTTCTTCC"	"TAL_2"
"CGTAGTAAGCGGGTAT"	"POD"
"CGTAGTACAATACCCA"	"IC-A1"
"CGTAGTAGTTACACAC"	"TAL_1"
"CGTAGTAGTTTCGGCG"	"EC_2"
"CGTAGTATCCGAGCTG"	"EC_2"
"CGTAGTATCGAGTCCG"	"PT_2"
"CGTAGTATCGCGGACT"	"PT_1"
"CGTCAAACAAGTGGGT"	"POD"
"CGTCAAACACTCTAGA"	"PT_1"
"CGTCAAACATAGATCC"	"PT_1"
"CGTCAAAGTCACTGAT"	"EC_1"
"CGTCAAAGTTACACAC"	"EC_2"
"CGTCAAAGTTAGCGGA"	"PT_1"
"CGTCCATAGAGCAGTC"	"PT_2"
"CGTCCATAGCACTAGG"	"TAL_1"
"CGTCCATAGCTGGCTC"	"IC-A1"
"CGTCCATCACAGTACT"	"iPT"
"CGTCCATCAGAACATA"	"EC_1"
"CGTCCATCATCGATCA"	"DCT"
"CGTCCATGTACAGAGC"	"iPT"
"CGTCCATGTGCTCCGA"	"iPT"
"CGTCCATTCAAGAGGC"	"DCT"
"CGTCCATTCCATACAG"	"PT_2"
"CGTGAATCATGTGGTT"	"IC-A1"
"CGTGAATGTGTTGATC"	"iPT"
"CGTGAATTCTGCCCTA"	"CNT"
"CGTGATACATGGAACG"	"PT_1"
"CGTGATATCTCCGATC"	"CNT"
"CGTGCTTAGCCGCTTG"	"TAL_1"
"CGTGCTTAGGCGAAGG"	"CNT"
"CGTGCTTCACTGAATC"	"EC_2"
"CGTGCTTCAGAACTCT"	"DCT"
"CGTGCTTCATGGATCT"	"EC_1"
"CGTGCTTGTCGACTGC"	"EC_2"
"CGTGCTTGTGACACGA"	"TAL_2"
"CGTGCTTTCGTTCATT"	"TAL_1"
"CGTGCTTTCTAAGCCA"	"DCT"
"CGTGCTTTCTAGGAAA"	"PT_2"
"CGTGTCTAGGAAGAAC"	"TAL_1"
"CGTGTCTAGTCCGCCA"	"PT_1"
"CGTGTCTCACAAAGTA"	"TAL_1"
"CGTGTCTTCTTAGGAC"	"PEC"
"CGTTAGAAGCTCCCTT"	"iPT"
"CGTTAGACACCGCTAG"	"PT_2"
"CGTTAGAGTACCTTCC"	"PT_1"
"CGTTAGAGTCCGAAGA"	"IC-A1"
"CGTTAGATCCTCAGGG"	"TAL_3"
"CGTTAGATCGCATTGA"	"POD"
"CGTTCTGCAGATCACT"	"EC_1"
"CGTTCTGCATAACAGA"	"PT_1"
"CGTTCTGTCAGAGCAG"	"TAL_1"
"CGTTCTGTCAGTGCGC"	"PT_2"
"CGTTCTGTCCCGAACG"	"PT_2"
"CGTTGGGCATCAACCA"	"POD"
"CGTTGGGGTCTATGAC"	"EC_2"
"CGTTGGGTCCCGTGTT"	"IC-A1"
"CGTTGGGTCGGTAGGA"	"iPT"
"CTAACCCCAAAGCAAT"	"CNT"
"CTAACCCCAACTTCTT"	"POD"
"CTAACCCGTCATCCGG"	"TAL_1"
"CTAACCCTCTACTGAG"	"POD"
"CTAACTTAGTGGACGT"	"EC_2"
"CTAACTTCATAATCCG"	"iPT"
"CTAACTTGTTTCCCAC"	"IC-B"
"CTAAGTGCACAACGTT"	"IC-A1"
"CTAAGTGGTCATCACA"	"TAL_1"
"CTAAGTGGTCTAATCG"	"TAL_2"
"CTACAGAAGCATCAAA"	"CNT"
"CTACAGACAAATTGCC"	"EC_2"
"CTACAGACACAACCGC"	"EC_1"
"CTACAGACATAGATGA"	"DCT"
"CTACAGAGTGGAAATT"	"CNT"
"CTACAGATCGGTCTGG"	"DCT"
"CTACATTAGCTCTTCC"	"PT_1"
"CTACATTGTCACTTCC"	"IC-A1"
"CTACATTTCTTCTAAC"	"IC-B"
"CTACCCACAAAGGGTC"	"DCT"
"CTACCCACACACCAGC"	"PT_1"
"CTACCCATCTAACGCA"	"PT_2"
"CTACCCATCTGGGCAC"	"CNT"
"CTACCTGAGACATAAC"	"PT_1"
"CTACCTGAGGCTAGCA"	"DCT"
"CTACCTGAGTAGGTTA"	"DCT"
"CTACCTGCATCTGGGC"	"PT_1"
"CTACCTGCATGACTAC"	"IC-A1"
"CTACCTGCATGGCTAT"	"PT_1"
"CTACCTGGTACCTGTA"	"PT_1"
"CTACCTGGTACGATCT"	"MC"
"CTACCTGGTATACGGG"	"PT_2"
"CTACCTGGTATCAGCT"	"CNT"
"CTACCTGGTATGTGTC"	"EC_2"
"CTACCTGGTCATGGCC"	"TAL_2"
"CTACCTGGTGGACTAG"	"PT_2"
"CTACCTGGTTCTAAGC"	"TAL_1"
"CTACCTGTCAACTCTT"	"TAL_1"
"CTACGGGAGAACCCGA"	"DCT"
"CTACGGGCACGGCCAT"	"TAL_1"
"CTACGGGCAGACGCTC"	"CNT"
"CTACGGGCAGTCTTCC"	"TAL_1"
"CTACGGGGTCACTGAT"	"PT_1"
"CTACGGGTCCCAGGAC"	"CNT"
"CTACTATAGTGACACG"	"CNT"
"CTACTATCAATAGGGC"	"PT_1"
"CTACTATCAGAAACCG"	"iPT"
"CTAGACAAGACTCTTG"	"EC_2"
"CTAGACAAGAGGTGCT"	"PT_1"
"CTAGACAAGCGACTAG"	"PT_2"
"CTAGACAAGTAATTGG"	"IC-B"
"CTAGACATCCAGCCTT"	"TAL_2"
"CTAGACATCCGTGACG"	"PT_1"
"CTAGACATCGGACCAC"	"MC"
"CTAGGTAAGTCACAGG"	"TAL_3"
"CTAGGTACAAATGGAT"	"DCT"
"CTAGGTACACACCGAC"	"iPT"
"CTAGGTACACTTCATT"	"PT_1"
"CTAGGTACAGCATACT"	"iPT"
"CTAGGTACAGGACAGT"	"PT_1"
"CTAGGTACATCCGGTG"	"iPT"
"CTAGGTAGTTGTGCAT"	"DCT"
"CTAGGTATCGTAGAGG"	"TAL_1"
"CTATAGGAGATAGCTA"	"EC_1"
"CTATAGGAGTAAACGT"	"TAL_3"
"CTATAGGGTAAGGAGA"	"TAL_2"
"CTATAGGGTAGCTCGC"	"PEC"
"CTATAGGTCAGTGGGA"	"EC_2"
"CTATAGGTCTAAACGC"	"TAL_2"
"CTATCCGAGGTAACTA"	"IC-A1"
"CTATCCGCATGGTACT"	"POD"
"CTATCCGGTCCATACA"	"iPT"
"CTATCTAGTGGTCTCG"	"TAL_2"
"CTATCTATCGACATTG"	"IC-A1"
"CTCAACCCACCCAACG"	"CNT"
"CTCAACCTCAGCGTCG"	"IC-A1"
"CTCAACCTCAGCTCTC"	"DCT"
"CTCAACCTCTGTGCTC"	"PT_2"
"CTCAAGACATACGCAT"	"POD"
"CTCAAGAGTACACGTT"	"DCT"
"CTCAAGAGTGCCCAGT"	"iPT"
"CTCAAGAGTTCAATCG"	"iPT"
"CTCAATTAGTCGCTAT"	"TAL_2"
"CTCAATTCAATCCTTT"	"PT_1"
"CTCAATTGTCATATGC"	"EC_1"
"CTCACTGAGTCGGCAA"	"TAL_1"
"CTCACTGCAAGTTCCA"	"TAL_1"
"CTCACTGCAGCCGGTT"	"PT_2"
"CTCACTGGTGTAGCAG"	"DCT"
"CTCACTGTCACGACTA"	"TAL_1"
"CTCACTGTCCCGAAAT"	"EC_2"
"CTCACTGTCCTTACCG"	"PT_2"
"CTCAGAAAGGCCCGTT"	"DCT"
"CTCAGAACACCCTGTT"	"DCT"
"CTCAGAACAGCAAGAC"	"PT_1"
"CTCAGAATCAAGTAAG"	"DCT"
"CTCAGAATCACCTCAC"	"PT_1"
"CTCAGAATCGACGCTG"	"PT_1"
"CTCAGGGAGAGTTCGG"	"EC_2"
"CTCAGGGAGTCTCCTC"	"PT_1"
"CTCAGGGCAACTCCCT"	"PT_1"
"CTCAGGGCACGAGGAT"	"PT_1"
"CTCAGGGGTATCGCTA"	"IC-A1"
"CTCAGGGGTGACTGTT"	"PT_2"
"CTCAGGGTCACAACCA"	"TAL_2"
"CTCAGGGTCGAGCCTG"	"TAL_2"
"CTCAGGGTCGTCACCT"	"IC-A1"
"CTCAGTCAGCACACCC"	"PT_1"
"CTCAGTCCAAACGAGC"	"EC_1"
"CTCAGTCCAACACAGG"	"PT_1"
"CTCAGTCCACATTCTT"	"EC_1"
"CTCAGTCCATCGATGT"	"TAL_3"
"CTCAGTCGTCCTGGGT"	"iPT"
"CTCAGTCTCTAAGCCA"	"PT_2"
"CTCAGTCTCTCTTAAC"	"PEC"
"CTCATCGAGCAACCAG"	"CNT"
"CTCATCGAGTTACGGG"	"EC_1"
"CTCATCGCATCAGTCA"	"PT_1"
"CTCATCGGTGTTAAAG"	"PT_1"
"CTCATCGTCACTGGTA"	"IC-A1"
"CTCATCGTCAGGCGAA"	"EC_1"
"CTCATGCAGCCGCTTG"	"PT_1"
"CTCATGCCAGGTACGA"	"EC_1"
"CTCATGCGTAGCTTGT"	"iPT"
"CTCATGCGTATCTCTT"	"PT_1"
"CTCATGCGTCTATGAC"	"IC-A1"
"CTCATGCTCTCACCCA"	"PT_1"
"CTCATTAAGGTGAGAA"	"CNT"
"CTCATTAAGTATAGGT"	"EC_2"
"CTCATTACAAATTGGA"	"EC_2"
"CTCATTAGTATGAGGC"	"EC_2"
"CTCATTAGTGAGCTCC"	"PT_2"
"CTCATTATCAGACCTA"	"PEC"
"CTCATTATCAGCCTCT"	"CNT"
"CTCCAACGTTGGACCC"	"PT_2"
"CTCCACAGTCGCTTGG"	"IC-A1"
"CTCCATGAGCTGAAAT"	"MC"
"CTCCATGCAAATCGTC"	"PT_1"
"CTCCATGCACACGGAA"	"PT_1"
"CTCCATGCACTGCTTC"	"TAL_3"
"CTCCATGCATCAACCA"	"PT_2"
"CTCCATGGTACCCGCA"	"PT_2"
"CTCCCAACAACACAAA"	"PT_1"
"CTCCCAATCCGACATA"	"CNT"
"CTCCCTCAGCTCATAC"	"PT_1"
"CTCCCTCGTAATCAGA"	"TAL_1"
"CTCCCTCTCATGTCAG"	"PT_1"
"CTCCCTCTCGCTAGCG"	"PT_1"
"CTCCGATAGATGGCAC"	"PT_1"
"CTCCGATGTCGAGCTC"	"TAL_1"
"CTCCGATGTGAAGCGT"	"POD"
"CTCCGATGTGAGCGAT"	"TAL_3"
"CTCCGATTCGCAGTTA"	"EC_1"
"CTCCGATTCTTTCAGT"	"DCT"
"CTCCTCCCACCGGTCA"	"PT_1"
"CTCCTCCGTAGTCCTA"	"POD"
"CTCCTCCGTCGGTACC"	"PT_1"
"CTCCTCCGTCTTCTAT"	"POD"
"CTCCTCCTCCCATGGG"	"PT_1"
"CTCCTCCTCGTTCTGC"	"EC_2"
"CTCCTTTAGGACTATA"	"IC-A1"
"CTCCTTTCATGCGGTC"	"EC_1"
"CTCCTTTTCTGGTGCG"	"TAL_1"
"CTCGAGGAGCGTCGAA"	"EC_1"
"CTCGAGGGTCGGATTT"	"TAL_2"
"CTCGAGGTCCATCTGC"	"TAL_1"
"CTCGAGGTCCTCTAGC"	"DCT"
"CTCGAGGTCGCTATTT"	"EC_2"
"CTCTCAGGTCGTGATT"	"TAL_3"
"CTCTCAGGTGTCATCA"	"TAL_1"
"CTCTCAGGTGTGCTTA"	"TAL_1"
"CTCTCAGTCGATACTG"	"PT_1"
"CTCTCAGTCTGCGGGT"	"PT_1"
"CTCTCGAAGGAACTCG"	"PT_2"
"CTCTCGACATGTTCAG"	"TAL_1"
"CTCTCGATCTCGCTTG"	"EC_2"
"CTCTGGTAGTCATGAA"	"CNT"
"CTCTGGTTCCCTTCCC"	"IC-A1"
"CTGAATGCAAATCAAG"	"iPT"
"CTGAATGCATTATGCG"	"EC_2"
"CTGAATGCATTGTGCA"	"TAL_1"
"CTGAATGGTGATTGGG"	"PT_1"
"CTGAATGGTGTCCACG"	"TAL_1"
"CTGAATGGTTCCACGG"	"iPT"
"CTGAATGGTTGACGGA"	"TAL_2"
"CTGAGCGCAAGCACAG"	"EC_2"
"CTGAGCGCACGATTCA"	"IC-A1"
"CTGAGCGGTACAAAGT"	"TAL_3"
"CTGAGCGGTCACGCTG"	"EC_2"
"CTGAGCGGTGCTCTCT"	"iPT"
"CTGAGCGGTTCGGCCA"	"IC-A1"
"CTGAGCGTCAAACGTC"	"DCT"
"CTGAGGCCAATAACCC"	"IC-A1"
"CTGAGGCGTAACCCTA"	"EC_1"
"CTGAGGCGTTAATCGC"	"iPT"
"CTGATCCAGTCATTGC"	"PT_1"
"CTGATCCCACAAAGTA"	"PT_2"
"CTGATCCGTACTGGGA"	"CNT"
"CTGATCCTCCCTCTCC"	"TAL_2"
"CTGATCCTCGAAGAAT"	"TAL_2"
"CTGATCCTCTTCCACG"	"DCT"
"CTGCAGGGTTAACCTG"	"iPT"
"CTGCAGGTCTGCGAGC"	"TAL_1"
"CTGCATCAGGTTGCCC"	"PT_1"
"CTGCATCAGTGATAAC"	"PT_1"
"CTGCATCCAAGTGCAG"	"TAL_3"
"CTGCATCGTAAGATTG"	"TAL_3"
"CTGCATCGTTGGTAGG"	"PT_1"
"CTGCATCTCATCGCCT"	"iPT"
"CTGCATCTCTCCGAGG"	"TAL_1"
"CTGCCATAGATTGCGG"	"DCT"
"CTGCCATGTTCCGCAG"	"EC_2"
"CTGCCATGTTGTCAGT"	"CNT"
"CTGCCATTCAACCTTT"	"TAL_2"
"CTGCCTACATTGACAC"	"EC_2"
"CTGCCTAGTAGTCACT"	"PT_1"
"CTGCCTAGTGCTGATT"	"TAL_3"
"CTGCCTAGTTACGATC"	"PT_1"
"CTGCCTATCCCTGTTG"	"EC_2"
"CTGCCTATCCTTGGAA"	"TAL_1"
"CTGCCTATCGCTACAA"	"TAL_1"
"CTGCGAGCACACGCCA"	"CNT"
"CTGCGAGTCACCTGGG"	"CNT"
"CTGCTCAAGCAGCCCT"	"POD"
"CTGCTCAAGTGACCTT"	"IC-B"
"CTGCTCATCCAGCAAT"	"IC-A1"
"CTGCTCATCTAGACAC"	"POD"
"CTGGACGGTAACGCGA"	"TAL_1"
"CTGGACGGTATGGTAA"	"TAL_2"
"CTGGACGGTGACACGA"	"IC-B"
"CTGGACGTCTCATTGT"	"PT_2"
"CTGGACGTCTTCGACC"	"TAL_1"
"CTGGCAGCAATGCAAA"	"PT_1"
"CTGGTCTAGTGCACTT"	"PT_1"
"CTGGTCTGTTCACCGG"	"PT_1"
"CTGGTCTTCCGCGGAT"	"PT_1"
"CTGGTCTTCCTAGCTC"	"CNT"
"CTGGTCTTCTGTCCCA"	"DCT"
"CTGTACCAGGACGGAG"	"iPT"
"CTGTACCAGGCTAGCA"	"PT_1"
"CTGTACCCAACAAGTA"	"TAL_1"
"CTGTACCCACAGCATT"	"CNT"
"CTGTAGAAGATTAGCA"	"CNT"
"CTGTAGAAGCTGGTGA"	"TAL_2"
"CTGTAGACATAATGAG"	"EC_1"
"CTGTAGAGTGACCTGC"	"PT_1"
"CTGTAGAGTGAGCAGT"	"iPT"
"CTGTATTCACAAATGA"	"DCT"
"CTGTATTCACTACCGG"	"TAL_3"
"CTGTATTCAGCGTACC"	"PT_1"
"CTGTATTCATCGAAGG"	"TAL_2"
"CTGTATTGTAGTCTGT"	"PT_1"
"CTGTATTGTGCCTGCA"	"PT_2"
"CTGTATTTCATTCGTT"	"TAL_2"
"CTGTATTTCCTAAGTG"	"PT_1"
"CTGTATTTCCTAGAGT"	"DCT"
"CTGTCGTAGCGCCGTT"	"iPT"
"CTGTCGTGTGTTGAGG"	"TAL_1"
"CTGTGAACACGGTGAA"	"PT_1"
"CTGTGAAGTCGAGATG"	"iPT"
"CTGTGAATCTCTCGCA"	"TAL_2"
"CTGTGGGCACCAAAGG"	"CNT"
"CTGTGGGGTGATTAGA"	"CNT"
"CTTACCGAGATAGTGT"	"CNT"
"CTTACCGGTAAGATTG"	"IC-A1"
"CTTACCGGTACTCGCG"	"TAL_1"
"CTTACCGGTGCGTTTA"	"IC-B"
"CTTACCGGTGGCAACA"	"EC_1"
"CTTACCGTCAGGGATG"	"TAL_1"
"CTTAGGAAGCCATTCA"	"CNT"
"CTTAGGAAGGGCAACT"	"DCT"
"CTTAGGACACAAGTTC"	"CNT"
"CTTAGGACACTAGAGG"	"PT_2"
"CTTAGGACAGTGGGTA"	"POD"
"CTTAGGACAGTTGCGC"	"PEC"
"CTTAGGAGTCAGGCAA"	"TAL_1"
"CTTAGGAGTTGCAACT"	"PT_2"
"CTTAGGATCGCTTGAA"	"MC"
"CTTAGGATCTCGGTCT"	"TAL_1"
"CTTCAATAGATGAAGG"	"CNT"
"CTTCAATTCAGTGTCA"	"PT_1"
"CTTCAATTCGACGATT"	"EC_1"
"CTTCCGAAGATACCAA"	"TAL_1"
"CTTCCGACACACTGGC"	"PT_1"
"CTTCCGAGTCATAAAG"	"EC_1"
"CTTCCGATCTCCGAAA"	"TAL_1"
"CTTCCGATCTGGCCGA"	"TAL_2"
"CTTCCTTAGTCATGAA"	"CNT"
"CTTCCTTCAAAGGTTA"	"DCT"
"CTTCCTTGTATTAAGG"	"TAL_1"
"CTTCCTTGTTCAAACC"	"PT_1"
"CTTCCTTTCATAGAGA"	"PT_1"
"CTTCGGTAGGCTGGAT"	"DCT"
"CTTCGGTAGGGAGTTC"	"PT_1"
"CTTCGGTCAATGAAAC"	"iPT"
"CTTCGGTCATCATTTC"	"IC-B"
"CTTCGGTCATCTGTTT"	"PT_1"
"CTTCGGTGTCCGGTCA"	"PT_1"
"CTTCGGTGTGCAATGG"	"CNT"
"CTTCGGTGTTAAGTCC"	"PT_1"
"CTTCGGTTCCAAAGGG"	"POD"
"CTTCGGTTCCATGATG"	"CNT"
"CTTCTAAAGACTCTAC"	"TAL_1"
"CTTCTAAAGTAGCCAG"	"PT_2"
"CTTCTAACAAGTTCCA"	"TAL_1"
"CTTCTAACATCCTTGC"	"CNT"
"CTTCTAACATGGGATG"	"iPT"
"CTTCTAAGTAACATGA"	"EC_2"
"CTTCTAAGTGACTGTT"	"TAL_2"
"CTTCTAATCTGGAGAG"	"EC_1"
"CTTCTCTAGGTAAAGG"	"PT_1"
"CTTCTCTCACAGTACT"	"PT_1"
"CTTCTCTCACGTTCGG"	"CNT"
"CTTCTCTCATTGCTGA"	"iPT"
"CTTCTCTGTGCTCCGA"	"TAL_1"
"CTTCTCTGTTTCACTT"	"DCT"
"CTTCTCTTCATGCAGT"	"CNT"
"CTTCTCTTCCTTCTAA"	"PT_2"
"CTTGAGAAGTTGGAGC"	"TAL_1"
"CTTGAGACAGATCATC"	"DCT"
"CTTGAGACAGCGCGTT"	"TAL_1"
"CTTGAGACATTGACAC"	"TAL_2"
"CTTGAGAGTATGGTTC"	"CNT"
"CTTGAGATCATTGCTT"	"DCT"
"CTTGAGATCCGCTAGG"	"TAL_1"
"CTTGATTAGAGTTCGG"	"CNT"
"CTTGATTAGGGCTAAC"	"DCT"
"CTTGATTCATACTGAC"	"PT_1"
"CTTGATTGTTGCTGAT"	"POD"
"CTTGATTTCCGATCGG"	"TAL_1"
"CTTGATTTCTGCCTGT"	"IC-A1"
"CTTTCAAAGCGTGCCT"	"EC_2"
"CTTTCAAAGCTTCTAG"	"TAL_1"
"CTTTCAAAGGCTAGCA"	"PT_2"
"CTTTCAAAGTATAACG"	"CNT"
"CTTTCAACACCTGAAT"	"EC_2"
"CTTTCAATCACCATGA"	"CNT"
"CTTTCAATCAGAGCGA"	"DCT"
"CTTTCGGCAAGAGTTA"	"PT_2"
"CTTTCGGCAGATCCTA"	"PT_2"
"CTTTCGGCATGTCTAG"	"PT_1"
"CTTTCGGGTACTCGTA"	"PT_1"
"CTTTCGGTCTGTAAGC"	"TAL_1"
"GAAACCTAGGAAAGAC"	"IC-A1"
"GAAACCTCACCAATTG"	"PT_1"
"GAAATGAAGTAACGAT"	"IC-A1"
"GAAATGACATGTTCGA"	"TAL_1"
"GAAATGAGTACGAAAT"	"POD"
"GAAATGAGTCAAGCCC"	"CNT"
"GAAATGATCGGTCGAC"	"DCT"
"GAAATGATCTTTCCGG"	"TAL_1"
"GAACACTAGCGCCTCA"	"POD"
"GAACACTAGCTGTTCA"	"TAL_1"
"GAACACTCAGGCGAAT"	"TAL_1"
"GAACACTGTCTCACGG"	"TAL_2"
"GAACACTGTTGTGGCC"	"IC-A1"
"GAACACTTCTTCTAAC"	"PT_2"
"GAACGTTAGCCACTCG"	"PT_1"
"GAACGTTAGGACTATA"	"PT_1"
"GAACGTTAGTTACGTC"	"POD"
"GAACGTTCAAGTGGAC"	"TAL_1"
"GAACGTTTCAGCTTCC"	"PT_1"
"GAACGTTTCCACTAGA"	"EC_1"
"GAACGTTTCCATTTCA"	"TAL_3"
"GAACTGTAGACGGATC"	"IC-A1"
"GAACTGTAGTACAACA"	"EC_2"
"GAACTGTCACTCACTC"	"CNT"
"GAACTGTCATCTGGGC"	"TAL_1"
"GAACTGTTCCCAATAG"	"EC_1"
"GAACTGTTCCGCTTAC"	"PT_2"
"GAAGAATAGATAACAC"	"PT_1"
"GAAGAATAGCGAGGAG"	"PT_1"
"GAAGAATCAGACCAAG"	"PT_1"
"GAAGAATGTTGTGGAG"	"IC-B"
"GAAGAATTCCCGTGAG"	"CNT"
"GAAGCCCCAATTTCCT"	"CNT"
"GAAGCCCGTAGGCTCC"	"IC-A1"
"GAAGCCCGTAGTCCTA"	"TAL_1"
"GAAGCCCGTATGAAAC"	"PEC"
"GAAGCCCGTCTAGGCC"	"EC_1"
"GAAGCCCGTGGCTGAA"	"CNT"
"GAAGCCCGTTGCTAGT"	"PT_2"
"GAAGCGAAGACTGGGT"	"TAL_1"
"GAAGCGAAGGTCCCGT"	"DCT"
"GAAGCGAAGTGGTGGT"	"MC"
"GAAGCGAGTCGGAAAC"	"DCT"
"GAAGGACAGATAGTCA"	"iPT"
"GAAGGACGTAGAGGAA"	"TAL_1"
"GAAGGACTCCACATAG"	"PT_1"
"GAAGGGTAGCTGAAAT"	"PT_2"
"GAAGGGTCAAACTCGT"	"CNT"
"GAAGGGTGTTGAGTCT"	"CNT"
"GAAGTAATCTATACTC"	"EC_2"
"GAATAGACAGTATGAA"	"PT_2"
"GAATAGATCTAGTACG"	"PT_1"
"GAATCACCAAATGCGG"	"DCT"
"GAATCACGTCGTTCAA"	"POD"
"GAATCACGTTCCGCAG"	"PT_1"
"GAATCACTCAGAGTGG"	"iPT"
"GAATCGTAGAACTCCT"	"EC_1"
"GAATCGTAGGACAGTC"	"PT_2"
"GAATCGTCACCCGTAG"	"PT_1"
"GAATCGTCAGCAGTGA"	"EC_2"
"GAATCGTGTGATACTC"	"POD"
"GAATCGTGTGTTCAGT"	"TAL_2"
"GACACGCAGAAACTAC"	"iPT"
"GACACGCAGAGAATCT"	"iPT"
"GACACGCCAGCGAGTA"	"PT_1"
"GACACGCGTGGATCGA"	"iPT"
"GACAGCCAGGTTAAAC"	"TAL_1"
"GACAGCCCAGACAAGC"	"EC_1"
"GACAGCCGTTAAACAG"	"EC_1"
"GACAGCCGTTAGGCTT"	"TAL_1"
"GACAGCCGTTCCGCAG"	"TAL_1"
"GACAGCCTCAGCATTG"	"POD"
"GACATCAAGGATTCCT"	"CNT"
"GACATCAAGGCCTTCG"	"iPT"
"GACATCACATACGCAT"	"PT_1"
"GACATCATCGCTGACG"	"PT_1"
"GACCAATCAACCCTCT"	"IC-A1"
"GACCAATTCCGTACGG"	"CNT"
"GACCCAGTCTCTGACC"	"TAL_1"
"GACCCTTAGGAACGTC"	"PT_1"
"GACCCTTCATTACTCT"	"TAL_2"
"GACCCTTGTTGCTAGT"	"IC-B"
"GACCCTTGTTGTTGCA"	"POD"
"GACCCTTTCAAAGGAT"	"PT_1"
"GACCCTTTCAAGCCGC"	"DCT"
"GACCGTGAGCGAGGAG"	"PT_1"
"GACCGTGCAATTGTGC"	"TAL_1"
"GACCGTGCACTGGACC"	"TAL_3"
"GACCGTGCATGACTAC"	"DCT"
"GACCGTGTCACTGAAC"	"TAL_1"
"GACCTTCAGCTAAACA"	"PT_1"
"GACCTTCTCTGCTTTA"	"MC"
"GACGCTGAGCTTCTAG"	"DCT"
"GACGCTGCAGTCGTTA"	"CNT"
"GACGCTGGTTCTTGCC"	"iPT"
"GACGCTGTCATAGACC"	"PT_2"
"GACGCTGTCCTACCGT"	"DCT"
"GACGTTACAAAGGGTC"	"PT_1"
"GACGTTACAACAGATA"	"PT_1"
"GACGTTACACTGGAAG"	"IC-A1"
"GACGTTATCAGCTTCC"	"PT_1"
"GACGTTATCGGCATTA"	"iPT"
"GACTATGAGAGGACTC"	"DCT"
"GACTATGAGCGTGTTT"	"PT_2"
"GACTATGAGGCTTAAA"	"TAL_2"
"GACTATGCAGAAGCGT"	"PT_1"
"GACTATGCAGTACTAC"	"TAL_1"
"GACTATGGTCGTAATC"	"PT_1"
"GACTATGTCAATCTCT"	"IC-A1"
"GACTATGTCGCCTCTA"	"PT_1"
"GACTCAAAGGTCGACA"	"TAL_2"
"GACTCAAGTACTGACT"	"PT_1"
"GACTCAAGTAGTTACC"	"DCT"
"GACTCAAGTATATGGA"	"EC_1"
"GACTCAAGTGAAGCGT"	"EC_2"
"GACTCAATCCCAGTGG"	"IC-A1"
"GACTCTCAGCCTCAGC"	"IC-B"
"GACTCTCAGTTGGACG"	"PT_1"
"GACTCTCCACAGTCAT"	"PT_1"
"GACTCTCGTTTGAAAG"	"TAL_1"
"GACTGATAGTCGTTAC"	"PT_1"
"GACTGATCAATTTCGG"	"IC-A1"
"GACTGATTCTAGGCAT"	"TAL_2"
"GACTTCCCACAGAAGC"	"TAL_1"
"GACTTCCCAGCACGAA"	"CNT"
"GACTTCCGTAGGACTG"	"PT_1"
"GACTTCCGTGTTTACG"	"PT_2"
"GAGAAATAGGAGGGTG"	"CNT"
"GAGAAATCATACATCG"	"TAL_2"
"GAGAAATTCGACATCA"	"EC_1"
"GAGAAATTCGCATTAG"	"POD"
"GAGACCCCAAAGGCAC"	"EC_1"
"GAGACCCCACTGAATC"	"TAL_1"
"GAGACCCCAGTTACCA"	"CNT"
"GAGACCCGTATCTCTT"	"TAL_2"
"GAGACCCGTCTTGTCC"	"TAL_2"
"GAGACCCGTGATACCT"	"PT_1"
"GAGACCCGTGTATTGC"	"TAL_1"
"GAGACCCGTTTACCTT"	"PT_2"
"GAGACCCTCCATAGGT"	"PT_1"
"GAGACCCTCGTCCTCA"	"PT_2"
"GAGACTTAGCGTGAGT"	"TAL_1"
"GAGAGGTCACCGTGAC"	"IC-A1"
"GAGAGGTTCAGTCCGG"	"CNT"
"GAGAGGTTCTTGCGCT"	"CNT"
"GAGAGGTTCTTGGTGA"	"PT_2"
"GAGAGGTTCTTTACAC"	"EC_1"
"GAGATGGAGATTGAGT"	"TAL_1"
"GAGATGGAGCACCGAA"	"IC-A1"
"GAGATGGCAATTAGGA"	"EC_1"
"GAGATGGGTGGTTCTA"	"EC_1"
"GAGATGGGTTGAGTCT"	"TAL_1"
"GAGCCTGAGGTGCAGT"	"iPT"
"GAGCCTGGTGTCCGTG"	"PT_1"
"GAGCCTGTCCTACAAG"	"IC-A1"
"GAGCCTGTCGCAGTCG"	"TAL_1"
"GAGCCTGTCGGCTGGT"	"POD"
"GAGCTGCAGTGTTGTC"	"POD"
"GAGCTGCCATCCGGCA"	"TAL_1"
"GAGCTGCCATGTGCTA"	"PT_1"
"GAGCTGCGTGGACTGA"	"TAL_1"
"GAGCTGCTCACCTTGC"	"iPT"
"GAGGCAAGTAGGACCA"	"PT_1"
"GAGGCAAGTGGATTTC"	"POD"
"GAGGCAATCACGAACT"	"PT_1"
"GAGGCAATCGTGTGGC"	"CNT"
"GAGGCCTAGCCTCTCT"	"TAL_1"
"GAGGCCTAGCTCGAAG"	"DCT"
"GAGGCCTAGTGGTCAG"	"PT_1"
"GAGGCCTCAGTTAGGG"	"PT_1"
"GAGGGATAGCGGTAGT"	"IC-A1"
"GAGGGATAGGGAACAA"	"DCT"
"GAGGGATCACTAGGTT"	"TAL_3"
"GAGGGATGTGAGCCAA"	"EC_1"
"GAGGGATGTTTGGCTA"	"iPT"
"GAGGGATTCACCTTAT"	"EC_2"
"GAGGGTAAGCGCCCAT"	"PT_1"
"GAGGGTAAGGGCAGTT"	"EC_1"
"GAGGGTAAGTGGTCAG"	"PT_2"
"GAGGGTACAACACTAC"	"EC_1"
"GAGGGTACAGGCGTTC"	"MC"
"GAGGGTATCCACTTCG"	"iPT"
"GAGGGTATCCGCATAA"	"EC_1"
"GAGTCATAGCCTGGAA"	"TAL_1"
"GAGTCATGTAGCGTAG"	"iPT"
"GAGTCTAAGCTCGGCT"	"DCT"
"GAGTCTACACCTGAAT"	"PT_1"
"GAGTCTACAGGACAGT"	"TAL_1"
"GAGTCTACATACAGGG"	"CNT"
"GAGTCTAGTACAAAGT"	"PT_1"
"GAGTCTAGTTCATCGA"	"PT_1"
"GAGTCTATCGAACGGA"	"TAL_1"
"GAGTGAGAGGGCTAAC"	"TAL_1"
"GAGTGAGCATGGAAGC"	"MC"
"GAGTGAGGTAACGTTC"	"DCT"
"GAGTGAGGTGTGCTTA"	"TAL_1"
"GAGTGAGGTTCCGCAG"	"CNT"
"GAGTGTTAGTCTGGAG"	"TAL_2"
"GAGTGTTAGTTGAAAC"	"TAL_2"
"GAGTGTTCAAGGGTCA"	"PT_2"
"GAGTGTTCACATATCG"	"TAL_1"
"GAGTGTTTCACCTACC"	"EC_1"
"GAGTGTTTCTCATTTG"	"TAL_1"
"GAGTTACAGTCAGAGC"	"CNT"
"GAGTTACCACTACACA"	"TAL_1"
"GAGTTACTCCGTGTCT"	"DCT"
"GAGTTACTCTAGGCCG"	"EC_2"
"GAGTTGTGTCAGTCCG"	"PT_1"
"GAGTTGTTCTTCGACC"	"TAL_1"
"GAGTTTGAGCAACTCT"	"TAL_1"
"GAGTTTGGTACGAGCA"	"PT_1"
"GATAGAAAGGATGGCT"	"TAL_1"
"GATAGAAAGGTAGACC"	"EC_1"
"GATAGAACAGCGGATA"	"POD"
"GATAGAAGTAGCGATG"	"CNT"
"GATAGAAGTTACAGCT"	"PT_1"
"GATAGAAGTTTCGCTC"	"PEC"
"GATAGCTCAGCATACT"	"TAL_1"
"GATAGCTCATGTGTCA"	"PT_1"
"GATAGCTTCAATCGGT"	"DCT"
"GATCACACAGCGATTT"	"PT_2"
"GATCAGTAGTATGTAG"	"CNT"
"GATCAGTAGTCATGGG"	"TAL_1"
"GATCAGTAGTTAGTGA"	"TAL_1"
"GATCAGTAGTTTGGCT"	"EC_2"
"GATCAGTCAAATTGCC"	"TAL_1"
"GATCAGTGTAGCTAAA"	"TAL_1"
"GATCATGAGTGATAGT"	"EC_1"
"GATCATGCACTAAACC"	"POD"
"GATCATGGTTACCCAA"	"EC_1"
"GATCATGTCACCTACC"	"TAL_3"
"GATCATGTCTTCCACG"	"PT_1"
"GATCCCTGTACCTATG"	"DCT"
"GATCCCTGTTGAGTCT"	"PT_2"
"GATCGTACAATCGTCA"	"PT_1"
"GATCGTACACGATAGG"	"PT_1"
"GATCGTACAGCAAGAC"	"TAL_1"
"GATCGTACATGATGCT"	"EC_2"
"GATCGTACATTCACAG"	"EC_1"
"GATCGTATCGGCCTTT"	"IC-A1"
"GATCGTATCTGGGTCG"	"PT_1"
"GATGACTCAATAGTAG"	"EC_2"
"GATGACTCACCCAACG"	"EC_2"
"GATGACTCATCTCGTC"	"TAL_1"
"GATGACTGTAGACAGC"	"TAL_1"
"GATGACTTCTACCCAC"	"IC-A1"
"GATGAGGAGAAGTGTT"	"PT_1"
"GATGAGGAGACCAACG"	"CNT"
"GATGAGGAGACTTCGT"	"PT_1"
"GATGAGGGTGCCTAAT"	"TAL_2"
"GATGAGGGTTGCTTGA"	"TAL_1"
"GATGAGGTCCGTAGTA"	"IC-A1"
"GATGAGGTCTTCGGAA"	"CNT"
"GATGATCAGATCACCT"	"TAL_1"
"GATGATCAGATTCGAA"	"TAL_1"
"GATGATCAGCCAGAGT"	"PT_1"
"GATGATCCATCGAGCC"	"PT_2"
"GATGATCTCAGGCGAA"	"CNT"
"GATGATCTCCTTCGAC"	"TAL_1"
"GATGCTACAGTAACAA"	"iPT"
"GATGCTAGTAAGATCA"	"TAL_1"
"GATGGAGAGAACAGGA"	"PT_1"
"GATGGAGAGATAGGGA"	"POD"
"GATGGAGAGTCATGCT"	"EC_1"
"GATGGAGAGTTGGCTT"	"TAL_1"
"GATGGAGTCCCACAGG"	"DCT"
"GATGTTGCAGAGGTTG"	"CNT"
"GATGTTGGTAGGAAAG"	"TAL_1"
"GATGTTGGTAGGAGGG"	"TAL_1"
"GATGTTGTCCATGCAA"	"TAL_3"
"GATTCGAAGACAAGCC"	"TAL_1"
"GATTCGAAGATTAGCA"	"EC_1"
"GATTCGATCATACGAC"	"TAL_1"
"GATTCGATCATGCTAG"	"TAL_3"
"GATTCGATCTATGTGG"	"CNT"
"GATTCTTAGGTAGTCG"	"IC-B"
"GATTCTTAGTAAACGT"	"PT_1"
"GATTCTTCAGTAGAAT"	"CNT"
"GATTCTTGTCTACAGT"	"PT_2"
"GATTCTTTCAAACCCA"	"IC-A1"
"GATTCTTTCCTATTTG"	"TAL_1"
"GATTGGTAGAGGCGTT"	"TAL_2"
"GATTGGTAGCTACTGT"	"TAL_2"
"GATTGGTGTGCTCTTC"	"IC-A1"
"GATTGGTGTTTATGCG"	"PT_1"
"GATTGGTTCTCCGTGT"	"TAL_1"
"GATTTCTAGCATGTTC"	"TAL_1"
"GATTTCTAGGCTGAAC"	"DCT"
"GATTTCTCAACAGAGC"	"PT_1"
"GATTTCTCAGCTTCGG"	"PT_1"
"GCAACATCAAGCCCAC"	"DCT"
"GCAACATCATCTCGTC"	"EC_2"
"GCAACATGTGGACCTC"	"MC"
"GCAACCGGTTCAGGTT"	"PT_2"
"GCAACCGTCCACACCT"	"PT_2"
"GCAACCGTCCTTGACC"	"DCT"
"GCACATAAGACCATAA"	"POD"
"GCACATAAGGGTAATT"	"TAL_1"
"GCACATAAGGTAGGCT"	"PT_1"
"GCACATAGTCTAACGT"	"TAL_1"
"GCACATAGTTTACCTT"	"IC-A1"
"GCACGGTCACATTCGA"	"iPT"
"GCACGGTGTGAACTAA"	"EC_2"
"GCACGGTGTTAGGGTG"	"PT_1"
"GCACGGTTCAGTGGGA"	"PT_1"
"GCACGGTTCTGCTTAT"	"TAL_1"
"GCACGTGAGGATGCGT"	"PT_2"
"GCACGTGCAGCAAGAC"	"CNT"
"GCACGTGGTCACTTCC"	"TAL_1"
"GCACGTGGTCTAGTGT"	"EC_1"
"GCACGTGTCGAAGCCC"	"PT_1"
"GCACTAAAGCATTTCG"	"EC_2"
"GCACTAAAGTGAATAC"	"CNT"
"GCACTAATCCGTGTAA"	"EC_1"
"GCAGCCACATGTCAGT"	"PT_1"
"GCAGCCAGTGTTGACT"	"PT_2"
"GCAGCCATCTGAGTCA"	"PT_1"
"GCAGCTGAGTCCCGAC"	"TAL_3"
"GCAGCTGCAATCTGCA"	"DCT"
"GCAGCTGTCGATTTCT"	"PT_1"
"GCAGGCTAGCCTCAGC"	"EC_1"
"GCAGGCTAGCGATCGA"	"CNT"
"GCAGGCTCAGTCTACA"	"CNT"
"GCAGGCTGTAGGATAT"	"TAL_1"
"GCAGGCTGTTCACCGG"	"DCT"
"GCAGTTACACCATTCC"	"PT_1"
"GCAGTTAGTAGGCAGT"	"PT_2"
"GCAGTTAGTGAGCTCC"	"PT_2"
"GCAGTTAGTTGCTTGA"	"PT_2"
"GCAGTTATCCATATGG"	"CNT"
"GCATCGGTCAAGCCTA"	"CNT"
"GCATCGGTCGACCACG"	"DCT"
"GCATCTCAGAAACTGT"	"DCT"
"GCATCTCCAACTGCCG"	"DCT"
"GCATCTCCAAGCCTGC"	"TAL_2"
"GCATCTCGTCTGTGAT"	"TAL_2"
"GCATCTCGTGCTCGTG"	"IC-B"
"GCATCTCTCCGGTAAT"	"PT_1"
"GCATGATCAAATGAAC"	"EC_2"
"GCATGATCAGCCTATA"	"TAL_1"
"GCATGATGTGCTGCAC"	"IC-A1"
"GCATGATTCCGTCACT"	"DCT"
"GCATGATTCGCTGTTC"	"iPT"
"GCATGATTCGTACCTC"	"DCT"
"GCATTAGAGACCATAA"	"EC_1"
"GCATTAGAGGCGTCCT"	"TAL_1"
"GCATTAGAGTTTGCTG"	"TAL_1"
"GCATTAGCATCGGCCA"	"TAL_1"
"GCATTAGCATGGAATA"	"PT_1"
"GCATTAGTCAAGCTGT"	"DCT"
"GCATTAGTCGAAACAA"	"CNT"
"GCATTAGTCTCCGATC"	"TAL_2"
"GCCAACGAGCATGTTC"	"TAL_1"
"GCCAACGAGGGAGTGG"	"TAL_1"
"GCCAACGCAAATCAAG"	"POD"
"GCCAGCAAGAAAGCGA"	"TAL_2"
"GCCAGCACACAACGCC"	"PT_2"
"GCCAGCACACAAGCCC"	"TAL_2"
"GCCAGCACACACTTAG"	"PT_2"
"GCCAGCACACGTACAT"	"PT_1"
"GCCAGCACAGCCGTCA"	"CNT"
"GCCAGCAGTGGCGCTT"	"PT_1"
"GCCAGCATCTGACCCT"	"CNT"
"GCCAGCATCTGGGATT"	"TAL_1"
"GCCAGGTAGCATCAAA"	"PT_2"
"GCCAGGTGTAGGTACG"	"DCT"
"GCCAGGTGTGAATTGA"	"TAL_1"
"GCCAGGTGTTCGAACT"	"IC-A1"
"GCCAGTGAGACGAAGA"	"PT_1"
"GCCAGTGCAAGGTCTT"	"TAL_1"
"GCCAGTGGTCTTCATT"	"PT_1"
"GCCATGGAGGAACGAA"	"IC-B"
"GCCATGGAGGAGACCT"	"DCT"
"GCCATGGCAAACTCTG"	"POD"
"GCCATGGCACCGTGCA"	"TAL_1"
"GCCATGGCACGATAGG"	"DCT"
"GCCATGGGTAGCGCCT"	"EC_1"
"GCCATGGTCTGCGAGC"	"PT_1"
"GCCATTCTCGGACAAG"	"CNT"
"GCCATTCTCTTAGCCC"	"PT_2"
"GCCCAGAAGGCATGCA"	"TAL_1"
"GCCCAGACAAGAGGTC"	"EC_2"
"GCCCAGACAATGACCT"	"CNT"
"GCCCAGACAGGCATGA"	"IC-B"
"GCCCGAAAGACGACGT"	"DCT"
"GCCCGAAAGTTATGGA"	"CNT"
"GCCCGAACAGTCAGCC"	"EC_2"
"GCCCGAAGTACCGCGT"	"CNT"
"GCCCGAAGTATCGTTG"	"TAL_2"
"GCCCGAAGTCACTTCC"	"DCT"
"GCCCGAAGTGACAGGT"	"PT_1"
"GCCCGAATCGATGCAT"	"PT_1"
"GCCGATGCAAGACAAT"	"PT_2"
"GCCGATGCAGGCTCTG"	"PT_1"
"GCCGATGGTTTACCTT"	"PT_2"
"GCCGTGAGTGGTCCCA"	"EC_1"
"GCCTGTTAGATTAGCA"	"CNT"
"GCCTGTTCAGCGTAGA"	"PT_1"
"GCCTGTTGTCCGTACG"	"TAL_1"
"GCCTGTTGTGCAGGAT"	"POD"
"GCCTGTTTCGACTCCT"	"PT_1"
"GCGAGAAGTAGGACTG"	"TAL_2"
"GCGAGAATCCCAGGCA"	"PT_1"
"GCGATCGAGCTACAAA"	"PT_1"
"GCGATCGGTGGAAGTC"	"IC-A1"
"GCGGAAAAGGCCGCTT"	"IC-A1"
"GCGGAAAAGGGAGTTC"	"TAL_1"
"GCGGAAAAGTAACGTA"	"PT_1"
"GCGGAAATCTACCCAC"	"PT_2"
"GCGGATCAGGATACGC"	"TAL_3"
"GCGGATCCAATGTTGC"	"POD"
"GCGGATCCAGGGATAC"	"DCT"
"GCGTGCAAGACAACTA"	"DCT"
"GCGTGCAAGGGTAATT"	"iPT"
"GCGTGCACACAAACGG"	"EC_2"
"GCGTGCAGTGCCCACA"	"DCT"
"GCGTTTCAGGTTAAAC"	"PT_1"
"GCGTTTCCACGTACAT"	"TAL_1"
"GCGTTTCGTTCGGTTA"	"TAL_1"
"GCGTTTCTCGAGTTGT"	"PT_1"
"GCGTTTCTCGTTACCC"	"PT_2"
"GCTACAACAACTTGCA"	"PT_1"
"GCTACAAGTACTCAAC"	"TAL_1"
"GCTACAAGTATGCTAC"	"PT_1"
"GCTACAAGTCAGGCAA"	"iPT"
"GCTACAATCATCCTGC"	"PT_2"
"GCTACAATCTAGTGAC"	"PEC"
"GCTACCTAGACCATTC"	"MC"
"GCTACCTCAAATCGTC"	"PT_2"
"GCTACCTCACCCTTGT"	"CNT"
"GCTACCTCATCCCGTT"	"PT_2"
"GCTACCTGTCACTTAG"	"DCT"
"GCTACCTGTCTTGCGG"	"CNT"
"GCTACCTGTTGGCTAT"	"IC-A1"
"GCTACCTTCTGGCCGA"	"iPT"
"GCTCAAACATGAGATA"	"EC_2"
"GCTCAAAGTCGACTTA"	"PT_1"
"GCTCAAAGTGGTCCGT"	"PT_1"
"GCTCAAATCCGTAATG"	"TAL_3"
"GCTCAAATCGGCTGGT"	"TAL_2"
"GCTCAAATCGTCAACA"	"iPT"
"GCTGAATAGGAACGTC"	"DCT"
"GCTGAATCAATAGTAG"	"TAL_2"
"GCTGAATCATACACCA"	"TAL_2"
"GCTGAATCATCTGTTT"	"TAL_1"
"GCTGAATGTGACGCCT"	"POD"
"GCTGAATTCCTAGAGT"	"TAL_1"
"GCTGAATTCTTCTTCC"	"PT_1"
"GCTGCAGAGCGAGTAC"	"PEC"
"GCTGCAGAGTAAAGCT"	"PT_1"
"GCTGCAGAGTCGCCCA"	"PEC"
"GCTGCAGCAGAGTCAG"	"IC-A1"
"GCTGCAGGTCCAGGTC"	"TAL_1"
"GCTGCAGTCATGCAGT"	"TAL_2"
"GCTGCAGTCCGGCTTT"	"TAL_3"
"GCTGCAGTCTCAGAAC"	"EC_2"
"GCTGGGTCACAACGTT"	"POD"
"GCTGGGTCACCAACAT"	"iPT"
"GCTGGGTCAGATACTC"	"iPT"
"GCTGGGTTCTTAGCTT"	"iPT"
"GCTTCACAGGGCAAGG"	"PT_2"
"GCTTCACCACTTGAAC"	"EC_2"
"GCTTCACTCGTCCTCA"	"CNT"
"GCTTGGGCACGGTCTG"	"DCT"
"GCTTGGGCAGGAATCG"	"TAL_1"
"GCTTGGGCATTCGATG"	"TAL_2"
"GCTTGGGGTATCACGT"	"PT_1"
"GCTTGGGGTCGTTCAA"	"EC_1"
"GCTTGGGTCGGATAAA"	"PEC"
"GCTTTCGAGTCGTTAC"	"PT_2"
"GCTTTCGGTCACTCTC"	"EC_1"
"GCTTTCGGTTCTTCAT"	"PT_1"
"GCTTTCGTCGCTCTCA"	"PT_1"
"GGAACCCCAATAGGGC"	"iPT"
"GGAACCCCACTGAGGA"	"POD"
"GGAACCCTCAGCCCAG"	"PT_2"
"GGAACCCTCCGAAATC"	"PT_2"
"GGAAGTGAGGCCTAAG"	"PT_2"
"GGAAGTGCAAATCGTC"	"PT_2"
"GGAAGTGCAAGATTGA"	"CNT"
"GGAAGTGGTCCTGTTC"	"CNT"
"GGAAGTGGTGTTCCAA"	"TAL_2"
"GGAAGTGGTTATTCCT"	"DCT"
"GGAAGTGTCGTCAGAT"	"TAL_1"
"GGAATCTAGGATGCGT"	"DCT"
"GGAATCTGTGTCCTAA"	"PT_1"
"GGAATCTGTGTTGCCG"	"DCT"
"GGAATCTTCAAATAGG"	"DCT"
"GGAATGGAGCCGCTTG"	"PT_1"
"GGAATGGTCAATCTTC"	"iPT"
"GGAATGGTCGCTGTTC"	"EC_2"
"GGACGTCAGATGTAGT"	"iPT"
"GGACGTCAGCAAATGT"	"PT_1"
"GGACGTCAGTCATACC"	"PT_1"
"GGACGTCGTAGTATAG"	"PT_2"
"GGACGTCGTGAATAAC"	"TAL_1"
"GGACGTCTCAGGGTAG"	"IC-A1"
"GGAGAACCAGGGAGAG"	"DCT"
"GGAGAACGTAGATTAG"	"iPT"
"GGAGAACGTGTTCCTC"	"TAL_1"
"GGAGAACTCCATTGGA"	"EC_2"
"GGAGAACTCCTAACAG"	"EC_2"
"GGAGAACTCGCGTAGC"	"PT_2"
"GGAGATGCAATTAGGA"	"PT_2"
"GGAGATGCACCTGCGA"	"EC_1"
"GGAGATGTCACGTCCT"	"TAL_3"
"GGAGATGTCCGTAATG"	"PT_1"
"GGAGCAAAGAGGATCC"	"POD"
"GGAGCAAGTCGGATTT"	"TAL_2"
"GGAGCAAGTGTAAATG"	"CNT"
"GGAGCAATCGGTCAGC"	"EC_1"
"GGAGGATAGGCGATAC"	"PT_2"
"GGAGGATAGTCTAACC"	"PT_1"
"GGAGGATCAATGGCCC"	"DCT"
"GGAGGATCATGAATAG"	"TAL_2"
"GGAGGATCATGCCGGT"	"TAL_2"
"GGAGGATGTAGACGGT"	"DCT"
"GGAGGATGTCTCAAGT"	"DCT"
"GGAGGATGTGTTACTG"	"CNT"
"GGAGGATTCTTCGACC"	"PT_2"
"GGAGGTAAGGATACCG"	"TAL_2"
"GGAGGTACAGTGGTGA"	"CNT"
"GGAGGTAGTACGTTCA"	"PT_1"
"GGATCTAAGCGAGGAG"	"PT_1"
"GGATCTACATTCCTAT"	"PT_1"
"GGATCTAGTGTTCCTC"	"POD"
"GGATCTAGTTCGGGTC"	"EC_2"
"GGATCTATCCTATTGT"	"PT_1"
"GGATCTATCGAGATAA"	"PT_1"
"GGATGTTCACCAGTTA"	"PT_1"
"GGATGTTCAGTCTCTC"	"EC_1"
"GGATGTTTCACCCTCA"	"CNT"
"GGATGTTTCCAATCCC"	"PT_1"
"GGCACGTAGATAGGGA"	"TAL_3"
"GGCACGTAGCGGTATG"	"CNT"
"GGCACGTCATCCTTGC"	"TAL_3"
"GGCACGTCATCGTCCT"	"PT_1"
"GGCACGTGTAAGAACT"	"EC_1"
"GGCACGTGTATCGTGT"	"TAL_1"
"GGCACGTTCAGCTGTA"	"CNT"
"GGCACGTTCATCTATC"	"EC_1"
"GGCAGTCAGTAAGCAT"	"DCT"
"GGCAGTCCAGTTGTTG"	"iPT"
"GGCAGTCCATCACGGC"	"TAL_1"
"GGCAGTCGTTCCTTGC"	"PT_1"
"GGCAGTCTCGAAACAA"	"POD"
"GGCGTCACACGACTAT"	"CNT"
"GGCGTCAGTGACTGTT"	"PT_1"
"GGCGTCATCCCATAAG"	"TAL_1"
"GGCTGTGAGCGCACAA"	"PT_2"
"GGCTGTGGTAGCGCCT"	"EC_2"
"GGCTGTGTCCGCATAA"	"TAL_1"
"GGCTGTGTCCTAACAG"	"TAL_1"
"GGCTGTGTCTGGAGAG"	"IC-A1"
"GGCTTGGAGTCCCGGT"	"EC_1"
"GGCTTGGCAAGAGTGC"	"PT_2"
"GGCTTGGCACCTCAGG"	"PT_1"
"GGCTTGGGTTGAGTCT"	"DCT"
"GGCTTGGTCTATCGCC"	"DCT"
"GGCTTGGTCTCGAACA"	"PT_1"
"GGCTTGGTCTGGGCGT"	"PEC"
"GGCTTTCAGTGTTCAC"	"PT_1"
"GGCTTTCTCCTAGCGG"	"TAL_2"
"GGGAAGTAGTAGTCCT"	"CNT"
"GGGAAGTGTAGTGGCA"	"CNT"
"GGGAAGTGTGGAACAC"	"CNT"
"GGGAAGTGTTGCGGAA"	"PT_1"
"GGGAAGTGTTTGTGGT"	"CNT"
"GGGAAGTTCCATTCAT"	"PT_1"
"GGGACAAAGGAGCAAA"	"EC_2"
"GGGACAAGTGGCTTGC"	"TAL_1"
"GGGACAATCCTCTTTC"	"DCT"
"GGGACAATCTGAGTCA"	"DCT"
"GGGACCTCACTAGAGG"	"TAL_3"
"GGGACCTCATGTCTAG"	"PT_2"
"GGGACCTGTCAGATTC"	"EC_1"
"GGGACTCCAAGGCTTT"	"CNT"
"GGGACTCGTCTGCAAT"	"DCT"
"GGGACTCTCCTCAGGG"	"PT_1"
"GGGACTCTCGCCCAGA"	"DCT"
"GGGAGATGTAGCGATG"	"CNT"
"GGGAGATGTTTAGACC"	"CNT"
"GGGAGATTCCACATAG"	"PT_2"
"GGGAGATTCTCAACGA"	"iPT"
"GGGAGTAAGATGATTG"	"EC_1"
"GGGAGTAAGGTACTGG"	"PT_1"
"GGGAGTAAGTACAGAT"	"PT_1"
"GGGAGTAGTTACGCCG"	"PEC"
"GGGAGTATCATCACTT"	"DCT"
"GGGAGTATCTAAGCGT"	"PT_1"
"GGGATCCGTACCAATC"	"POD"
"GGGATCCGTCAAAGAT"	"TAL_1"
"GGGATCCTCAAGCTTG"	"DCT"
"GGGATCCTCATTTGGG"	"TAL_1"
"GGGATGAAGAGCCCAA"	"TAL_3"
"GGGATGAAGGCTCTCG"	"PT_1"
"GGGATGACACTGATTG"	"DCT"
"GGGATGACAGAGTCTT"	"CNT"
"GGGATGAGTACCTGTA"	"DCT"
"GGGCCATAGACGGTTG"	"PT_2"
"GGGCCATAGCAATTAG"	"TAL_1"
"GGGCCATGTGAGTAGC"	"iPT"
"GGGCCATGTTAACAGA"	"TAL_2"
"GGGCCATTCCAAAGGG"	"PT_1"
"GGGCCATTCCCTCAAC"	"EC_1"
"GGGCCATTCGAGTCTA"	"POD"
"GGGCCATTCTTCCGTG"	"PT_1"
"GGGCGTTGTCCGAAGA"	"TAL_2"
"GGGCGTTTCCTCACTG"	"TAL_2"
"GGGCTACAGGCTATCT"	"TAL_2"
"GGGCTACAGGTTAAAC"	"POD"
"GGGCTACCAGACGATG"	"TAL_1"
"GGGCTACCATATAGCC"	"PT_2"
"GGGCTACCATTGAAGA"	"TAL_3"
"GGGCTACTCCTCCACA"	"PEC"
"GGGCTACTCGCAATTG"	"TAL_2"
"GGGCTCACATGTAACC"	"TAL_1"
"GGGCTCATCCATCTCG"	"TAL_1"
"GGGTAGACAGATCCTA"	"TAL_1"
"GGGTAGAGTCGATTAC"	"PT_1"
"GGGTATTAGCGTATGG"	"MC"
"GGGTATTAGTATGGAT"	"TAL_2"
"GGGTATTCAGAGCGTA"	"TAL_1"
"GGGTATTCAGATACTC"	"PT_1"
"GGGTATTCATGTCAGT"	"TAL_1"
"GGGTATTCATGTCGTA"	"PT_1"
"GGGTATTTCATCCTGC"	"PT_2"
"GGGTATTTCGTCACCT"	"TAL_1"
"GGGTCACAGGACAACC"	"TAL_2"
"GGGTCACCAAGCCTGC"	"DCT"
"GGGTCACCACAAAGTA"	"PT_1"
"GGGTCACCATCCGAGC"	"EC_1"
"GGGTCACGTGATTCTG"	"EC_1"
"GGGTCACTCATTCATC"	"PT_1"
"GGGTCACTCCCTATTA"	"TAL_1"
"GGGTCACTCTTACCGC"	"TAL_1"
"GGGTCTGAGAATCGCG"	"PT_1"
"GGGTCTGCAGAACATA"	"iPT"
"GGGTCTGGTGTTAAAG"	"iPT"
"GGGTCTGGTTGCCGCA"	"PT_2"
"GGGTCTGTCATTCGTT"	"CNT"
"GGGTGAACAATTGGTC"	"TAL_1"
"GGGTGAAGTGACAGGT"	"TAL_1"
"GGGTGAATCTTCACAT"	"CNT"
"GGGTGTCAGCACCAGA"	"TAL_1"
"GGGTGTCGTTAGAAGT"	"CNT"
"GGGTGTCTCCAGCAAT"	"EC_1"
"GGGTTATAGAAGCCAC"	"DCT"
"GGGTTATCATGAATCC"	"TAL_2"
"GGGTTATGTAAGTCAA"	"DCT"
"GGGTTATTCCAAGCTA"	"IC-B"
"GGGTTATTCCATTGTT"	"TAL_1"
"GGGTTATTCGGCTGTG"	"TAL_2"
"GGGTTTACAAGCTGCC"	"PT_1"
"GGGTTTACAGACCAAG"	"EC_2"
"GGGTTTACAGAGGACT"	"MC"
"GGGTTTACAGGCTACC"	"TAL_1"
"GGGTTTAGTATCCTCC"	"TAL_3"
"GGGTTTAGTCTACACA"	"EC_2"
"GGGTTTATCATGGGAG"	"TAL_1"
"GGGTTTATCCACTAGA"	"iPT"
"GGTAACTCACATAACC"	"MC"
"GGTAACTTCAGAGCAG"	"PT_1"
"GGTAACTTCCTGATAG"	"IC-A1"
"GGTAATCAGAGGACTC"	"POD"
"GGTAATCAGAGGATCC"	"TAL_1"
"GGTAATCAGCAACTTC"	"EC_1"
"GGTAATCAGTCGGCAA"	"DCT"
"GGTAATCCACACAGAG"	"DCT"
"GGTAATCGTCACAGAG"	"PT_1"
"GGTAATCTCCTTACCG"	"PT_2"
"GGTAGAGAGAATCTAG"	"TAL_1"
"GGTAGAGAGAGCATAT"	"TAL_1"
"GGTAGAGAGGGATCAC"	"DCT"
"GGTAGAGCAATTTCTC"	"PT_1"
"GGTAGAGGTCCCTAAA"	"TAL_3"
"GGTAGAGGTGATTCAC"	"PT_2"
"GGTAGAGTCCTAGCTC"	"EC_1"
"GGTCACGAGGCCATAG"	"TAL_1"
"GGTCACGCAAATCCCA"	"DCT"
"GGTCACGCACATGGTT"	"CNT"
"GGTCACGGTGACCGAA"	"IC-A1"
"GGTCACGTCGGTCATA"	"IC-A1"
"GGTCTGGAGAGCGACT"	"CNT"
"GGTCTGGAGCAGTACG"	"TAL_3"
"GGTCTGGAGGCTAAAT"	"TAL_1"
"GGTCTGGAGGTAGTCG"	"POD"
"GGTGAAGCAGCTACTA"	"TAL_1"
"GGTGAAGGTCAACGCC"	"POD"
"GGTGATTAGTTATGGA"	"PT_1"
"GGTGATTGTAGACAAT"	"PT_1"
"GGTGATTGTAGATCGG"	"PT_1"
"GGTGATTGTCACCCTT"	"PT_1"
"GGTGATTTCTATTGTC"	"TAL_1"
"GGTGGCTAGGTACAAT"	"CNT"
"GGTGGCTCAGCACAAG"	"CNT"
"GGTGGCTGTAATTGGA"	"PT_2"
"GGTGGCTTCTGTGCGG"	"IC-A1"
"GGTGTCGAGCCACAAG"	"iPT"
"GGTGTCGCAGACGCTC"	"TAL_1"
"GGTGTCGCAGTGCGCT"	"PT_1"
"GGTGTCGGTTGCATAC"	"CNT"
"GGTGTTACAATACCTG"	"PT_1"
"GGTGTTACATGGCCCA"	"iPT"
"GGTGTTAGTGTTTCTT"	"PT_1"
"GGTGTTATCGACGTCG"	"PT_2"
"GGTTAACAGAAGTCCG"	"EC_2"
"GGTTAACAGGCTGGAT"	"EC_1"
"GGTTAACAGTTTCGGT"	"DCT"
"GGTTAACCAATGTCTG"	"TAL_3"
"GGTTAACGTACCGGAA"	"TAL_1"
"GGTTAACGTATCGAGG"	"CNT"
"GGTTAACGTTGCTCGG"	"DCT"
"GGTTAACTCCATCACC"	"CNT"
"GGTTAACTCTAGAGCT"	"POD"
"GGTTAACTCTCGTTTA"	"IC-A1"
"GGTTAACTCTTGTGCC"	"PT_1"
"GGTTAACTCTTTGCTA"	"POD"
"GGTTCTCCATGGAATA"	"iPT"
"GGTTCTCCATTGAAGA"	"IC-A1"
"GGTTCTCGTAACAGTA"	"CNT"
"GGTTCTCGTCCGTTTC"	"EC_1"
"GGTTCTCGTCGTCAGC"	"TAL_1"
"GGTTCTCTCATATGGC"	"POD"
"GGTTGTAAGAGATTCA"	"EC_1"
"GGTTGTACAGCATGCC"	"IC-A1"
"GGTTGTAGTGTACAGG"	"CNT"
"GGTTGTATCATGACAC"	"CNT"
"GGTTGTATCCACAGCG"	"IC-A1"
"GGTTGTATCGCCAACG"	"TAL_1"
"GGTTGTATCTAGACAC"	"IC-A1"
"GTAACACAGATAGCAT"	"EC_1"
"GTAACACAGCGTACAG"	"DCT"
"GTAACACCAATGAGCG"	"EC_1"
"GTAACACCACCCAATA"	"TAL_1"
"GTAACACCATGAATAG"	"PT_1"
"GTAACACGTCGAGATG"	"PT_1"
"GTAACACTCCCGGTAG"	"TAL_1"
"GTAACCAAGTAGGCCA"	"DCT"
"GTAACCAGTACCACGC"	"iPT"
"GTAACCAGTCGATGCC"	"PT_2"
"GTAACCAGTCTAGTGT"	"PT_1"
"GTAACCAGTGGTCAAG"	"POD"
"GTAACCATCCGAACGC"	"IC-B"
"GTAACCATCTCGGTAA"	"EC_1"
"GTAAGTCCATGACCCG"	"EC_1"
"GTAAGTCCATGTACGT"	"CNT"
"GTAATCGAGTAATACG"	"PT_2"
"GTAATCGAGTCGCCAC"	"POD"
"GTAATCGGTGTCGATT"	"POD"
"GTAATCGTCTGTGTGA"	"POD"
"GTAATGCAGCCATTGT"	"PT_2"
"GTAATGCCACTATGTG"	"PT_1"
"GTAATGCCAGCAGTTT"	"EC_1"
"GTAATGCCAGTTGTTG"	"DCT"
"GTAATGCGTCTACAGT"	"PT_1"
"GTACAACCAGCATACT"	"PT_1"
"GTACAACCATAAGCAA"	"CNT"
"GTACAACGTGTGATGG"	"TAL_3"
"GTACAGTAGCACTGGA"	"CNT"
"GTACAGTCATCTGGGC"	"PEC"
"GTACAGTGTCCTGGGT"	"TAL_3"
"GTACAGTGTCTATGAC"	"PT_2"
"GTACAGTTCCAGTTCC"	"PT_2"
"GTAGAAAAGAGTTGCG"	"CNT"
"GTAGAAATCGTCCTCA"	"POD"
"GTAGAGGAGGCCTAAG"	"PT_1"
"GTAGAGGTCCGGTAAT"	"EC_2"
"GTAGAGGTCGAGATGG"	"CNT"
"GTAGATCAGACACACG"	"PT_1"
"GTAGATCAGTGGTTCT"	"IC-A1"
"GTAGATCCATCTCGTC"	"PT_2"
"GTAGATCGTTAACCTG"	"IC-B"
"GTAGATCTCGGAGCAA"	"PT_1"
"GTAGCTAAGGCTAGCA"	"PT_1"
"GTAGGAGCACGGTAGA"	"PT_1"
"GTAGGAGGTCTCCTGT"	"PT_2"
"GTAGGAGGTGAGAGGG"	"IC-B"
"GTAGGAGTCCCGTTGT"	"TAL_1"
"GTAGGAGTCTGCGTCT"	"PT_2"
"GTAGGAGTCTTCACAT"	"TAL_3"
"GTAGGTTCAAGTGGCA"	"CNT"
"GTAGGTTCACCCTATC"	"EC_2"
"GTAGGTTCAGGACATG"	"IC-B"
"GTAGGTTTCCCAAGCG"	"TAL_1"
"GTAGGTTTCGATCCCT"	"TAL_1"
"GTAGGTTTCTTAATCC"	"IC-A1"
"GTAGTACAGAGTCACG"	"EC_2"
"GTAGTACAGCGTCTGC"	"EC_1"
"GTAGTACAGGTGCGAT"	"PT_2"
"GTAGTACCAAGGTTGG"	"EC_2"
"GTAGTACCACTGAATC"	"DCT"
"GTAGTACGTCAAATCC"	"DCT"
"GTAGTACGTCACCGAC"	"TAL_1"
"GTAGTACGTTTCGCTC"	"POD"
"GTATTGGAGGAAGTCC"	"TAL_2"
"GTATTGGCAGCAGTGA"	"MC"
"GTATTGGCAGTCACGC"	"EC_1"
"GTATTGGTCGCTAGCG"	"PEC"
"GTATTGGTCTCCACTG"	"MC"
"GTATTTCCAAGTAGTA"	"iPT"
"GTATTTCCAGGGCTTC"	"TAL_2"
"GTATTTCGTTGGACCC"	"DCT"
"GTATTTCTCAGTCCGG"	"EC_2"
"GTCAAACAGAGCCTGA"	"PT_2"
"GTCAAACAGCAATAGT"	"CNT"
"GTCAAACCACAGCCTG"	"PT_1"
"GTCAAACCACTGAGGA"	"TAL_1"
"GTCAAACGTGTCTTCC"	"MC"
"GTCAAACTCTATCACT"	"TAL_1"
"GTCAAGTAGGACGCAT"	"TAL_2"
"GTCAAGTAGTCATTGC"	"CNT"
"GTCAAGTAGTTGCCCG"	"iPT"
"GTCAAGTCACGATAGG"	"iPT"
"GTCAAGTCACGTAGTT"	"EC_2"
"GTCAAGTGTACCAGAG"	"TAL_1"
"GTCAAGTGTAGGGTAC"	"DCT"
"GTCAAGTGTTCAAAGA"	"MC"
"GTCAAGTTCCTACCAC"	"TAL_2"
"GTCACGGGTCATCGCG"	"CNT"
"GTCACGGTCACTCCGT"	"POD"
"GTCACTCAGACTACGG"	"CNT"
"GTCAGCGAGGTGCCAA"	"EC_1"
"GTCAGCGGTGAGTAAT"	"CNT"
"GTCAGCGGTTAATGAG"	"iPT"
"GTCAGCGTCCGACATA"	"TAL_3"
"GTCAGCGTCTTCGTGC"	"PEC"
"GTCATCCCAAGGCTTT"	"POD"
"GTCATCCCAGCTCATA"	"MC"
"GTCATCCGTATCCCAA"	"EC_2"
"GTCATCCGTATCGTGT"	"TAL_1"
"GTCATCCGTCTGTAGT"	"TAL_1"
"GTCATCCGTTAGAAAC"	"CNT"
"GTCATCCGTTGCTGAT"	"IC-A1"
"GTCATGACACCGCTAG"	"TAL_1"
"GTCATGAGTCGCATGC"	"EC_1"
"GTCATGAGTGTTCCTC"	"EC_1"
"GTCATGAGTTGTGGAG"	"PT_2"
"GTCATTTAGTTGAATG"	"EC_2"
"GTCATTTGTTACGCCG"	"TAL_2"
"GTCATTTTCAGCACCG"	"PT_1"
"GTCCACTAGTTGTAGA"	"POD"
"GTCCACTCAAGAGATT"	"iPT"
"GTCCACTCAAGGGCAT"	"EC_1"
"GTCCACTGTGGGCTTC"	"CNT"
"GTCCCATAGCCATTGT"	"TAL_1"
"GTCCCATGTCCTCATC"	"PT_2"
"GTCCCATTCATTCGGA"	"CNT"
"GTCCCATTCCGAGGCT"	"EC_2"
"GTCCTCACACAAAGTA"	"PT_1"
"GTCCTCACAGGCGAAT"	"TAL_1"
"GTCCTCAGTTAAGTCC"	"PT_1"
"GTCCTCATCCTCATAT"	"DCT"
"GTCCTCATCTTGTTAC"	"TAL_1"
"GTCGAATAGGATTTCC"	"TAL_1"
"GTCGAATAGTTGCCTA"	"MC"
"GTCGAATCACAGTGTT"	"TAL_2"
"GTCGAATCACCAGCCA"	"EC_2"
"GTCGAATTCAGCTTCC"	"EC_2"
"GTCGAATTCGAGCCAC"	"TAL_1"
"GTCGAATTCGGCTATA"	"TAL_2"
"GTCGCGAAGGGTTTCT"	"TAL_3"
"GTCGCGAAGTTGAAGT"	"IC-A1"
"GTCGCGATCATGCCAA"	"PEC"
"GTCGTAAGTAGTGATA"	"PT_1"
"GTCGTAAGTCTTGAAC"	"PT_2"
"GTCGTAAGTGCAGGAT"	"DCT"
"GTCGTAAGTGGCGCTT"	"TAL_2"
"GTCGTAATCCTTGAAG"	"IC-A1"
"GTCGTTCAGCAACAAT"	"PT_1"
"GTCGTTCCACTGTCGG"	"iPT"
"GTCGTTCCACTTTATC"	"TAL_1"
"GTCGTTCTCCCATTTA"	"DCT"
"GTCGTTCTCGCCAGAC"	"TAL_1"
"GTCGTTCTCGGAATGG"	"POD"
"GTCTAGAAGAACTTCC"	"EC_1"
"GTCTAGAAGACCCGCT"	"CNT"
"GTCTAGACAAGACGGT"	"CNT"
"GTCTAGACAGTTACCA"	"PT_1"
"GTCTAGAGTCCGAAAG"	"DCT"
"GTCTAGATCTGAGGCC"	"TAL_1"
"GTCTCACGTACCAGAG"	"TAL_2"
"GTCTCACTCCCGTGAG"	"PT_1"
"GTCTCACTCTTTGCTA"	"PT_1"
"GTCTGTCAGTGGTTAA"	"TAL_3"
"GTCTGTCCAACGCATT"	"DCT"
"GTCTGTCGTCGGTGAA"	"PT_1"
"GTCTTTAAGCATGCAG"	"TAL_1"
"GTCTTTAAGCGGTAGT"	"TAL_1"
"GTCTTTACAACCGCTG"	"IC-B"
"GTCTTTACAGGCCTGT"	"PT_1"
"GTCTTTACAGGCTATT"	"PT_1"
"GTCTTTACATACCAGT"	"TAL_2"
"GTCTTTAGTACAGTCT"	"TAL_1"
"GTCTTTAGTAGCGTCC"	"PT_1"
"GTCTTTAGTTCCGCAG"	"PT_1"
"GTCTTTATCATGAGGG"	"PEC"
"GTCTTTATCCTGCTAC"	"EC_2"
"GTGACGCAGTTCCTGA"	"IC-A1"
"GTGACGCCAACTTGCA"	"PT_1"
"GTGACGCCAAGATGTA"	"PT_1"
"GTGACGCCACCCTTGT"	"PT_2"
"GTGACGCTCAGTCAGT"	"PT_1"
"GTGACGCTCGAACGCC"	"TAL_1"
"GTGACGCTCGCTCATC"	"iPT"
"GTGAGCCAGCCGAATG"	"EC_2"
"GTGAGCCAGGTAAAGG"	"EC_1"
"GTGAGCCCAATGCAGG"	"DCT"
"GTGAGCCCAGAGGCAT"	"TAL_1"
"GTGAGCCGTTCCCACT"	"EC_2"
"GTGAGCCTCGGCAGTC"	"PT_1"
"GTGAGCCTCTGTGCGG"	"EC_2"
"GTGAGGAAGTCTAGCT"	"TAL_2"
"GTGAGGAGTACCACGC"	"TAL_2"
"GTGAGGAGTCTGCCTT"	"TAL_1"
"GTGAGGATCTCCCATG"	"CNT"
"GTGAGTTAGCAGGCAT"	"PT_1"
"GTGAGTTCACCCTCTA"	"TAL_1"
"GTGAGTTCAGCGCGTT"	"PT_1"
"GTGATGTAGAACTGAT"	"TAL_1"
"GTGATGTGTCGCAGTC"	"TAL_1"
"GTGCACGGTAGGTGCA"	"TAL_3"
"GTGCACGTCCGTTTCG"	"EC_1"
"GTGCACGTCTAGAACC"	"PT_1"
"GTGCAGCAGCGGGTTA"	"EC_1"
"GTGCAGCCACCTCTGT"	"DCT"
"GTGCAGCGTCAAAGTA"	"PT_1"
"GTGCAGCTCCGCAGTG"	"IC-B"
"GTGCAGCTCTCGCTCA"	"IC-A1"
"GTGCGTGAGTGCCGAA"	"PT_1"
"GTGCGTGCAAATCAGA"	"POD"
"GTGCGTGCAAGTTGGG"	"TAL_2"
"GTGCGTGTCTTTCAGT"	"PT_1"
"GTGCTGGAGGATAATC"	"TAL_3"
"GTGCTGGCAACAGTGG"	"TAL_1"
"GTGCTGGCAAGAAACT"	"MC"
"GTGCTGGGTAGAATAC"	"IC-A1"
"GTGCTTCCATTGCAAC"	"PT_1"
"GTGCTTCGTTAGGCCC"	"DCT"
"GTGCTTCTCATCGGGC"	"iPT"
"GTGGAAGCAACCAACT"	"PEC"
"GTGGAAGCATAAGCAA"	"TAL_1"
"GTGGAAGGTGGATCAG"	"TAL_1"
"GTGGAAGTCTCACGAA"	"TAL_1"
"GTGGAGAAGTGGTTCT"	"EC_1"
"GTGGAGAGTTAAGAAC"	"TAL_1"
"GTGGAGATCACCGGGT"	"EC_1"
"GTGGAGATCAGTCCGG"	"POD"
"GTGGCGTAGTCGGCAA"	"IC-A1"
"GTGGCGTCAAGGACAC"	"PT_1"
"GTGGCGTCAGACACCC"	"EC_2"
"GTGGGAAAGACTTCGT"	"POD"
"GTGGGAACAACGATCT"	"TAL_1"
"GTGGGAACAAGAGAGA"	"TAL_3"
"GTGGGAAGTCTAGATC"	"PT_2"
"GTGGGAAGTTCCATTT"	"EC_2"
"GTGGTTAAGAACAAGG"	"TAL_2"
"GTGGTTAAGAGGTTTA"	"CNT"
"GTGGTTAAGTCGGGAT"	"TAL_1"
"GTGGTTACACCCAACG"	"PT_1"
"GTGTAACAGAGCAGTC"	"TAL_1"
"GTGTAACAGCTTGTTG"	"TAL_1"
"GTGTAACCACCGTACG"	"POD"
"GTGTAACCATCAACCA"	"PT_1"
"GTGTAACCATTGGCAT"	"iPT"
"GTGTCCTAGGTCGTGA"	"CNT"
"GTGTCCTCATACAGGG"	"MC"
"GTGTCCTTCCGCATAA"	"TAL_1"
"GTGTGATGTAATGCGG"	"PT_1"
"GTGTGATGTTTGAACC"	"EC_2"
"GTGTGATTCGAGAGCA"	"EC_2"
"GTGTGGCAGTGTCATC"	"EC_1"
"GTGTGGCCACTATCGA"	"EC_1"
"GTGTGGCGTTCCAGGC"	"TAL_1"
"GTGTGGCTCCAGCTCT"	"CNT"
"GTGTGGCTCGTCTCAC"	"CNT"
"GTGTTAGCAAACTGCT"	"PT_2"
"GTGTTAGCAAGTGACG"	"TAL_1"
"GTGTTAGGTAGAGACC"	"DCT"
"GTGTTAGTCGGTGTAT"	"EC_1"
"GTGTTCCAGTGACACG"	"PT_1"
"GTGTTCCCACCTCAGG"	"PT_1"
"GTGTTCCCAGTAGAGC"	"CNT"
"GTGTTCCGTAACTAAG"	"iPT"
"GTGTTCCGTATTGCCA"	"TAL_1"
"GTGTTCCGTCTACATG"	"PT_1"
"GTTACAGCAAGAGTGC"	"DCT"
"GTTACAGCAGAAACCG"	"PT_2"
"GTTACAGGTAATCAGA"	"CNT"
"GTTACAGGTCTACAGT"	"EC_1"
"GTTACAGTCGGTGCAC"	"CNT"
"GTTACCCGTCCAGAAG"	"PT_1"
"GTTACCCGTTATCTTC"	"CNT"
"GTTACCCTCAAGTTGC"	"IC-A1"
"GTTACCCTCGCTAAAC"	"EC_2"
"GTTACCCTCTCCGATC"	"DCT"
"GTTACCCTCTTGGTGA"	"PT_1"
"GTTACGACACCGTGAC"	"POD"
"GTTACGACACTTGACA"	"EC_2"
"GTTACGACATGTAACC"	"EC_1"
"GTTACGAGTGAGTTTC"	"PT_1"
"GTTACGAGTGATTCTG"	"POD"
"GTTACGATCCAACCAA"	"PT_1"
"GTTAGACCAAGACCGA"	"PT_2"
"GTTAGACCAATCAAGA"	"PT_1"
"GTTAGACCACCTGAAT"	"PT_2"
"GTTAGACGTACCAATC"	"TAL_3"
"GTTAGACGTCTGATAC"	"TAL_2"
"GTTAGACGTGAGCAGT"	"CNT"
"GTTAGACGTTGGGTTT"	"iPT"
"GTTAGACTCATGTCAG"	"CNT"
"GTTAGACTCGAGTTGT"	"PT_1"
"GTTAGACTCTTACGTT"	"EC_1"
"GTTAGTGGTTCTCTAT"	"PT_2"
"GTTAGTGTCACAAGAA"	"TAL_3"
"GTTAGTGTCTAAGGAA"	"TAL_1"
"GTTATGGAGATTACCC"	"PT_1"
"GTTATGGAGTGAGCCA"	"PT_1"
"GTTATGGCAATGTCTG"	"iPT"
"GTTATGGGTCGATTTG"	"PT_2"
"GTTCATTAGATGCTTC"	"PT_1"
"GTTCATTAGCATTTGC"	"iPT"
"GTTCATTCAGGGATAC"	"TAL_1"
"GTTCATTGTACCTAAC"	"DCT"
"GTTCATTGTGGCTACC"	"IC-B"
"GTTCATTTCATTGCTT"	"TAL_2"
"GTTCATTTCCTTATAC"	"PEC"
"GTTCATTTCTGGGCCA"	"CNT"
"GTTCCGTAGCTCTATG"	"PT_1"
"GTTCCGTCAGCGTATT"	"DCT"
"GTTCCGTGTATGGGAC"	"CNT"
"GTTCCGTGTTAAGCAA"	"CNT"
"GTTCCGTGTTAGGGAC"	"TAL_2"
"GTTCCGTTCGGTCTGG"	"EC_1"
"GTTCCGTTCGTCTCAC"	"PT_1"
"GTTCGCTCAAAGGATT"	"EC_1"
"GTTCGCTCAAGTAGTA"	"EC_2"
"GTTCGCTCAATTCGTG"	"PT_1"
"GTTCGCTCAGGTTTAC"	"TAL_3"
"GTTCGCTGTCTGTCCT"	"TAL_1"
"GTTCGCTTCTACTGCC"	"POD"
"GTTCTATAGTGTTGTC"	"iPT"
"GTTCTATCAAGGTCGA"	"TAL_1"
"GTTCTATCACATAGCT"	"EC_2"
"GTTCTATCACCTATCC"	"TAL_1"
"GTTCTATGTTCCCAAA"	"iPT"
"GTTCTATGTTGCAAGG"	"TAL_1"
"GTTCTATGTTGTACGT"	"TAL_1"
"GTTCTATTCTTACCAT"	"PT_2"
"GTTGAACAGAGAGTGA"	"TAL_3"
"GTTGAACCAGTTTCGA"	"DCT"
"GTTGAACGTCATAGTC"	"EC_1"
"GTTGAACGTCCCACGA"	"IC-A1"
"GTTGAACGTCGATTTG"	"CNT"
"GTTGCGGCAATTGCTG"	"TAL_1"
"GTTGCGGCAGGTTCCG"	"TAL_3"
"GTTGCGGGTCAGGAGT"	"PT_1"
"GTTGCGGTCACAACCA"	"PT_2"
"GTTGCGGTCCGAGTGC"	"EC_2"
"GTTGCGGTCTCCTACG"	"TAL_1"
"GTTGCTCAGACGGTCA"	"TAL_1"
"GTTGCTCAGAGTCAGC"	"EC_2"
"GTTGCTCCAACCACGC"	"EC_1"
"GTTGCTCCACAATGCT"	"TAL_2"
"GTTGCTCCAGCCGTTG"	"TAL_2"
"GTTGCTCCAGGACAGT"	"PT_1"
"GTTGCTCCATAGGTTC"	"TAL_1"
"GTTGCTCCATGACTGT"	"CNT"
"GTTGCTCGTCTACAAC"	"POD"
"GTTGCTCGTCTTCTAT"	"PEC"
"GTTGCTCTCAGCTGTA"	"EC_1"
"GTTGCTCTCATGGATC"	"PT_2"
"GTTGCTCTCTGTAACG"	"PT_1"
"GTTGTAGAGCTGAGCA"	"EC_1"
"GTTGTAGCATCATCTT"	"DCT"
"GTTGTAGCATTGCTTT"	"CNT"
"GTTGTAGGTACCTAAC"	"TAL_1"
"GTTGTAGGTATACCCA"	"PT_1"
"GTTGTAGGTCAACCAT"	"DCT"
"GTTGTAGTCGGCTCTT"	"TAL_1"
"GTTGTCCAGAAACTAC"	"TAL_2"
"GTTGTCCAGCTACGTT"	"TAL_2"
"GTTGTCCGTGTCTCCT"	"TAL_1"
"GTTGTCCTCTACTGAG"	"TAL_1"
"GTTGTGACAGAGTGAC"	"IC-B"
"GTTGTGATCCGCGAGT"	"PT_1"
"GTTTACTAGATTGGGC"	"TAL_1"
"GTTTACTAGCCATTGT"	"TAL_2"
"GTTTACTCACCATAAC"	"TAL_3"
"GTTTACTTCGCTAAAC"	"PT_2"
"GTTTGGAAGGCATTTC"	"PT_1"
"GTTTGGACAGTTGAAA"	"PT_1"
"GTTTGGAGTCAAAGCG"	"TAL_2"
"GTTTGGATCGCCTTTG"	"EC_2"
"TAACACGCAATAAGGT"	"iPT"
"TAACACGGTACTGTTG"	"DCT"
"TAACACGGTAGCGTCC"	"MC"
"TAACACGGTCGGAACA"	"EC_1"
"TAACACGTCAGACCCG"	"PT_2"
"TAACACGTCCAATCTT"	"PT_2"
"TAACCAGCACAGTCAT"	"iPT"
"TAACCAGCACATGAAA"	"TAL_2"
"TAACCAGGTACACGCC"	"TAL_2"
"TAACCAGTCAGTCATG"	"TAL_2"
"TAACGACAGTAAATGC"	"DCT"
"TAACGACCACATGAAA"	"EC_1"
"TAACGACTCGGAAACG"	"iPT"
"TAACTTCAGGTTTGAA"	"PT_1"
"TAACTTCCAAGAGCTG"	"IC-A1"
"TAACTTCCACGACGAA"	"TAL_1"
"TAACTTCCAGCTGTAT"	"PT_1"
"TAACTTCTCCATTGTT"	"CNT"
"TAACTTCTCTGTCGCT"	"IC-A1"
"TAAGCACAGGTGGTTG"	"TAL_1"
"TAAGCACCAATGCTCA"	"PT_1"
"TAAGCACTCTCTCCGA"	"PT_1"
"TAAGCCACAAACTCGT"	"PT_1"
"TAAGCCACAGTCAGAG"	"PT_2"
"TAAGCCACATTCTCTA"	"EC_1"
"TAAGCCAGTTGTATGC"	"EC_1"
"TAAGCCATCTCATGGA"	"iPT"
"TAAGCGTAGTTGCTCA"	"CNT"
"TAAGCGTCAAGTGATA"	"PT_1"
"TAAGCGTCACCAGCTG"	"PT_1"
"TAAGCGTGTAACGGTG"	"EC_2"
"TAAGCGTTCCGCACGA"	"PT_1"
"TAAGTCGAGTCTAGCT"	"iPT"
"TAAGTCGCATAGGAGC"	"EC_1"
"TAAGTCGGTCGACTGC"	"TAL_1"
"TAAGTCGGTCTTACTT"	"PT_1"
"TAAGTCGGTTGATCGT"	"EC_2"
"TAAGTCGTCTCTCTAA"	"TAL_1"
"TAATCTCCAAGCGCAA"	"CNT"
"TAATCTCCACTCGATA"	"EC_1"
"TAATCTCGTGTTGCCG"	"PT_1"
"TAATTCCCAACCGTAT"	"PT_2"
"TAATTCCCACACCGCA"	"IC-A1"
"TAATTCCCACTGCTTC"	"PT_2"
"TACAACGAGAGCCGAT"	"EC_2"
"TACAACGAGAGTTGAT"	"CNT"
"TACAACGCAAATAAGC"	"CNT"
"TACAACGCAGGTAGTG"	"TAL_1"
"TACAACGGTCACCTTC"	"TAL_1"
"TACAACGGTCTTACAG"	"EC_1"
"TACAACGTCATTCCTA"	"PT_1"
"TACACCCAGCGACAGT"	"PT_1"
"TACACCCCAAGGACAC"	"PT_1"
"TACACCCCAATTGCGT"	"PT_1"
"TACACCCGTATGCGGA"	"TAL_1"
"TACACCCGTCGCTGCA"	"TAL_3"
"TACACCCTCGGAGTAG"	"DCT"
"TACAGGTAGAATCGAT"	"IC-A1"
"TACAGGTAGCTGGCTC"	"iPT"
"TACAGGTCACTACCGG"	"DCT"
"TACAGGTTCTGGCCAG"	"PT_1"
"TACATTCCAGCCCAGT"	"CNT"
"TACATTCCATAATCGC"	"TAL_1"
"TACATTCCATCCTTCG"	"PT_1"
"TACATTCTCGAGTTGT"	"TAL_1"
"TACATTCTCTCGGCTT"	"PT_1"
"TACCCACAGACCTTTG"	"EC_1"
"TACCCACGTGAGTTTC"	"DCT"
"TACCCGTAGATGGTCG"	"CNT"
"TACCCGTAGTGTTGTC"	"TAL_1"
"TACCCGTCACTTCATT"	"EC_2"
"TACCCGTCATCTTTCA"	"EC_1"
"TACCCGTTCAGAACCT"	"TAL_2"
"TACCCGTTCTCTGACC"	"TAL_3"
"TACCCGTTCTTACACT"	"DCT"
"TACCGAAAGTGATAAC"	"PT_1"
"TACCGAAGTATGGGAC"	"PT_2"
"TACCGAATCTTCGGAA"	"DCT"
"TACCGAATCTTGGTCC"	"TAL_2"
"TACCGGGAGCGCACAA"	"IC-A1"
"TACCGGGAGGAAAGAC"	"DCT"
"TACCGGGAGTTGCGCC"	"POD"
"TACCGGGCACGCTTAA"	"PT_1"
"TACCGGGCACTCCTGT"	"TAL_1"
"TACCGGGCAGCTGAAG"	"TAL_1"
"TACCGGGCATCCTTCG"	"PT_1"
"TACCGGGTCAAGAGTA"	"PT_1"
"TACCTCGAGACTCTAC"	"PT_1"
"TACCTCGAGCAGTCTT"	"CNT"
"TACCTCGGTGGACTAG"	"iPT"
"TACCTCGGTTAGGGAC"	"PT_1"
"TACCTGCAGGCTGGAT"	"PT_1"
"TACCTGCAGGTCCCGT"	"PT_2"
"TACCTGCGTTGAGTCT"	"PT_1"
"TACCTGCTCAGCCTCT"	"PT_2"
"TACCTGCTCCCATAAG"	"DCT"
"TACCTGCTCGACGATT"	"TAL_2"
"TACGCTCAGGCTTAAA"	"DCT"
"TACGCTCCAATCTCGA"	"iPT"
"TACGCTCGTGGGACAT"	"CNT"
"TACGCTCTCTGTGCAA"	"iPT"
"TACGGGCAGAAACCAT"	"MC"
"TACGGGCAGTAAGAGG"	"iPT"
"TACGGGCAGTGCACAG"	"TAL_2"
"TACGGGCCAATCGTCA"	"PT_1"
"TACGGGCCATGTGACT"	"PT_1"
"TACGGGCGTCAGTCTA"	"iPT"
"TACGGGCTCGCTAAAC"	"EC_1"
"TACGGTAAGAGACAAG"	"PT_1"
"TACGGTACACAATGAA"	"POD"
"TACGGTACACCGGAAA"	"DCT"
"TACGGTAGTAGGTGCA"	"IC-B"
"TACGGTAGTATGCTTG"	"EC_1"
"TACGGTAGTCATAACC"	"IC-A1"
"TACGGTAGTGATAGTA"	"POD"
"TACGTCCCACGCTGTG"	"EC_1"
"TACGTCCGTCTAGTGT"	"DCT"
"TACGTCCTCCTTCACG"	"TAL_1"
"TACTGCCAGCAACTTC"	"TAL_1"
"TACTGCCAGCAGGTCA"	"TAL_3"
"TACTGCCAGCTTTCCC"	"TAL_1"
"TACTGCCGTCCTCATC"	"EC_1"
"TACTGCCGTGATTCAC"	"PT_1"
"TACTTACAGCTATCTG"	"POD"
"TACTTACCAAATGGCG"	"CNT"
"TACTTACTCACCGGGT"	"TAL_1"
"TACTTACTCAGTGGGA"	"EC_1"
"TACTTCATCTCACGAA"	"iPT"
"TACTTGTAGGACGCAT"	"TAL_2"
"TACTTGTCACCCATAA"	"PT_1"
"TACTTGTGTACCGTGC"	"PT_1"
"TACTTGTTCATCCCGT"	"IC-A1"
"TACTTGTTCTTACACT"	"CNT"
"TAGACCAAGTGATTCC"	"MC"
"TAGACCAAGTGGATTA"	"TAL_1"
"TAGACCACAATGGCCC"	"TAL_2"
"TAGACCACACTTCAAG"	"PT_1"
"TAGACCACAGGCACTC"	"TAL_1"
"TAGACCAGTGGCCCAT"	"PT_2"
"TAGACCAGTGTACGCC"	"TAL_2"
"TAGACCATCACAGTGT"	"TAL_1"
"TAGACCATCCCTGGTT"	"PEC"
"TAGACTGAGAGGGTCT"	"IC-A1"
"TAGACTGCAAGACTGG"	"EC_2"
"TAGACTGCACAAATAG"	"PT_2"
"TAGACTGCAGAGTGTG"	"iPT"
"TAGACTGTCGGTGAAG"	"TAL_2"
"TAGAGTCCAGGTCAGA"	"TAL_2"
"TAGAGTCTCATTTGTC"	"iPT"
"TAGAGTCTCCAGTGTA"	"EC_1"
"TAGAGTCTCTGAGGTT"	"DCT"
"TAGATCGAGTCGAATA"	"PT_1"
"TAGATCGCACGTTGGC"	"DCT"
"TAGATCGTCACTTTGT"	"TAL_3"
"TAGATCGTCATGCAGT"	"TAL_1"
"TAGATCGTCCTTCACG"	"PT_1"
"TAGATCGTCGAACTCA"	"IC-A1"
"TAGATCGTCGCTCATC"	"PT_1"
"TAGCACAAGCCTAACT"	"TAL_1"
"TAGCACAAGGACGCAT"	"TAL_1"
"TAGCACAGTCTGTGCG"	"PT_1"
"TAGCACAGTGTAAATG"	"PT_1"
"TAGCACATCCGATTAG"	"PT_2"
"TAGCACATCCTATTTG"	"EC_2"
"TAGCACATCTGATGGT"	"PT_1"
"TAGGAGGCAAGCGGAT"	"iPT"
"TAGGAGGCAAGTAGTA"	"DCT"
"TAGGAGGGTATCTTCT"	"DCT"
"TAGGAGGTCATATGGC"	"TAL_1"
"TAGGAGGTCTCGTCGT"	"PT_2"
"TAGGGTTAGAACAAGG"	"POD"
"TAGGGTTAGAAGCTGC"	"PT_1"
"TAGGGTTCACAAGCAG"	"PEC"
"TAGGGTTGTCAGGTAG"	"TAL_1"
"TAGGTACAGACGGAAA"	"TAL_1"
"TAGGTACCAATGAACA"	"PT_1"
"TAGGTACCAGTAACCT"	"MC"
"TAGGTACTCATAGACC"	"EC_1"
"TAGGTACTCCTCATAT"	"POD"
"TAGGTACTCTCCGAGG"	"PT_1"
"TAGGTTGAGATACGAT"	"TAL_1"
"TAGGTTGAGCATCAGG"	"IC-A1"
"TAGGTTGAGCTAAACA"	"iPT"
"TAGGTTGAGTGGTTAA"	"IC-A1"
"TAGGTTGGTCTACATG"	"PT_1"
"TAGGTTGGTCTTCATT"	"PT_1"
"TAGGTTGTCACTGGGC"	"PT_2"
"TAGTGCAAGATCCCAT"	"EC_1"
"TAGTGCAAGCCATTCA"	"CNT"
"TAGTGCAAGGTAATCA"	"PT_2"
"TAGTGCAAGGTGGCTA"	"PT_1"
"TAGTGCAGTATTGAGA"	"PT_1"
"TAGTGCAGTGGCACTC"	"MC"
"TAGTGCATCCGATCTC"	"TAL_1"
"TAGTGCATCTACACAG"	"PT_1"
"TATACCTAGTCATCCA"	"DCT"
"TATACCTAGTCGAAAT"	"IC-B"
"TATACCTCAAACTCGT"	"TAL_3"
"TATACCTCAGGTTACT"	"EC_2"
"TATACCTTCACTGTTT"	"POD"
"TATACCTTCATTCTTG"	"PT_1"
"TATACCTTCTGTGCGG"	"IC-B"
"TATATCCAGACTTCGT"	"CNT"
"TATATCCAGTTAACAG"	"PEC"
"TATATCCCACAAGCAG"	"EC_1"
"TATATCCCACATTACG"	"TAL_2"
"TATATCCGTCCGGCAT"	"PT_1"
"TATATCCGTGCTGTCG"	"DCT"
"TATATCCGTTGTCTAG"	"iPT"
"TATATCCTCCTTTAGT"	"TAL_1"
"TATATCCTCGGCTGGT"	"CNT"
"TATCAGGCAGCGCTTG"	"TAL_1"
"TATCAGGGTCTTCCGT"	"DCT"
"TATCAGGTCAGTCACA"	"IC-A1"
"TATCCTAGTCAACCTA"	"TAL_1"
"TATCCTAGTCTCAAGT"	"PT_1"
"TATCCTAGTTGACGGA"	"PT_2"
"TATCCTATCTCACCCA"	"CNT"
"TATCGCCAGAGCATCG"	"iPT"
"TATCGCCCAAACGTGG"	"EC_2"
"TATCGCCCAAGACTGG"	"PT_1"
"TATCGCCCAATTGAGA"	"TAL_1"
"TATCGCCCACTCCACT"	"DCT"
"TATCGCCCATGAAAGT"	"DCT"
"TATCGCCGTTGACTGT"	"IC-B"
"TATCGCCTCTTCTAAC"	"IC-B"
"TATCTGTCATGGGATG"	"PT_2"
"TATCTGTGTCGAACGA"	"PT_1"
"TATCTGTTCCGATAGT"	"TAL_1"
"TATCTGTTCCTGGCTT"	"PT_2"
"TATCTGTTCTAGTGTG"	"EC_1"
"TATCTTGAGCCATTTG"	"PT_1"
"TATCTTGAGCCTCAGC"	"EC_1"
"TATCTTGAGGGAGGCA"	"PT_1"
"TATCTTGCATTCTCCG"	"EC_1"
"TATCTTGTCCCTAGGG"	"TAL_1"
"TATCTTGTCGGCATTA"	"PT_1"
"TATGTTCAGGCTAAAT"	"DCT"
"TATGTTCCAACGGTAG"	"POD"
"TATGTTCCACGCAAAG"	"POD"
"TATGTTCCACTAACGT"	"TAL_1"
"TATGTTCGTACGTAGG"	"CNT"
"TATGTTCGTAGACGTG"	"TAL_1"
"TATGTTCTCGAGCACC"	"TAL_1"
"TATTCCACAAAGCTAA"	"EC_2"
"TATTCCACAGAGGTTG"	"IC-A1"
"TATTCCAGTCCATACA"	"PT_2"
"TATTCCAGTCGGCTAC"	"DCT"
"TATTCCATCGATGCTA"	"PT_1"
"TATTCCATCGTCTAAG"	"CNT"
"TATTCCATCTCTCGAC"	"CNT"
"TATTCCATCTGGCTGG"	"PT_1"
"TATTGCTGTGTCTCCT"	"TAL_2"
"TATTGCTTCCTCACTG"	"iPT"
"TATTGGGAGGTTCCAT"	"DCT"
"TATTGGGCATTGGCAT"	"PT_2"
"TATTGGGTCGACGACC"	"IC-A1"
"TATTGGGTCGTCGATA"	"TAL_1"
"TATTGGGTCTCATTGT"	"POD"
"TATTTCGCAACCGGAA"	"TAL_2"
"TATTTCGGTTAGAAGT"	"EC_1"
"TATTTCGTCGCTTTAT"	"POD"
"TCAAGCAGTCTTACAG"	"CNT"
"TCAAGCAGTGATTCTG"	"PT_1"
"TCAAGTGAGAATACAC"	"POD"
"TCAAGTGAGCCGTAAG"	"TAL_2"
"TCAAGTGAGGTGGTTG"	"EC_2"
"TCAAGTGGTCGGTGTC"	"CNT"
"TCAAGTGGTGAGTAAT"	"PT_1"
"TCAATCTAGTGTTGAA"	"iPT"
"TCAATCTCAGACTCTA"	"PT_2"
"TCAATCTCAGGAACCA"	"iPT"
"TCAATCTGTGACACAG"	"TAL_1"
"TCAATCTGTGGGTTGA"	"PT_1"
"TCAATCTGTTGGAGGT"	"TAL_1"
"TCAATCTTCTGCTCTG"	"PT_1"
"TCAATTCCAGTAACCT"	"TAL_1"
"TCAATTCGTAGGAGGG"	"EC_2"
"TCAATTCGTCGTATGT"	"TAL_2"
"TCAATTCGTGACACAG"	"DCT"
"TCAATTCGTTCCTAGA"	"TAL_2"
"TCACAAGGTAGATTAG"	"IC-A1"
"TCACAAGGTTACACAC"	"TAL_1"
"TCACAAGTCCCAGCGA"	"PEC"
"TCACACCAGTTACGTC"	"PT_1"
"TCACACCCAACAGTGG"	"TAL_1"
"TCACACCGTACCGTCG"	"CNT"
"TCACACCGTAGCTGCC"	"PT_2"
"TCACACCGTTGCATAC"	"PT_1"
"TCACACCGTTGTTGAC"	"IC-A1"
"TCACATTAGCAACCAG"	"TAL_2"
"TCACATTAGGTGCGAT"	"CNT"
"TCACATTCACTCCCTA"	"IC-B"
"TCACATTCATAGACTC"	"PT_1"
"TCACATTCATCGAACT"	"PT_2"
"TCACATTGTACCTAGT"	"iPT"
"TCACATTGTAGGATAT"	"PT_1"
"TCACATTGTTAGAAGT"	"TAL_1"
"TCACATTTCCAGTACA"	"CNT"
"TCACATTTCCATATGG"	"PT_1"
"TCACATTTCGGACTGC"	"PEC"
"TCACGGGAGCGAATGC"	"EC_1"
"TCACTATCACTCCCTA"	"PT_2"
"TCACTATTCTAGCATG"	"iPT"
"TCACTCGAGATTAGAC"	"PT_1"
"TCACTCGAGGACTAAT"	"TAL_1"
"TCACTCGTCATTATCC"	"TAL_1"
"TCACTCGTCCTTTGAT"	"CNT"
"TCAGCAAAGAGGCGGA"	"TAL_1"
"TCAGCAAAGCTCCCTT"	"PT_2"
"TCAGCAACATCCTGTC"	"PT_2"
"TCAGCAAGTCGGTGAA"	"CNT"
"TCAGCAAGTGATCATC"	"iPT"
"TCAGCAATCGTCTAAG"	"POD"
"TCAGCCTGTCAGACTT"	"MC"
"TCAGCCTTCATTACTC"	"PT_2"
"TCAGCCTTCCTCTAGC"	"IC-B"
"TCAGGGCCAAGCCCAC"	"TAL_1"
"TCAGGGCCACTAACCA"	"PT_2"
"TCAGGGCGTTCGAACT"	"EC_2"
"TCAGGGCTCTACCCAC"	"DCT"
"TCAGGTAAGACCGTTT"	"DCT"
"TCAGGTAAGACTACCT"	"EC_1"
"TCAGGTAAGAGCGACT"	"EC_1"
"TCAGGTAAGAGGGTAA"	"TAL_1"
"TCAGGTAAGGATAATC"	"MC"
"TCAGGTACAGAGGTAC"	"TAL_1"
"TCAGGTAGTAAGGAGA"	"TAL_2"
"TCAGGTAGTCACAGTT"	"DCT"
"TCAGGTATCACCGACG"	"PT_1"
"TCAGGTATCCACGGAC"	"POD"
"TCAGGTATCGACCAAT"	"EC_2"
"TCAGTCCAGAACTCCT"	"DCT"
"TCAGTCCAGACCAGAC"	"IC-A1"
"TCAGTCCAGCTACTGT"	"TAL_1"
"TCAGTCCTCAGGAGAC"	"PT_1"
"TCAGTGAAGCAAGTGC"	"EC_1"
"TCAGTGAAGCGTGCTC"	"PT_1"
"TCAGTGAAGTGGTCAG"	"TAL_1"
"TCAGTGACAAACTAGA"	"TAL_1"
"TCAGTGACAATAGGGC"	"DCT"
"TCAGTGAGTAACAAGT"	"TAL_1"
"TCAGTGAGTATACCCA"	"POD"
"TCAGTGATCGAGCCAC"	"PT_1"
"TCAGTGATCTCCTACG"	"PT_1"
"TCAGTTTAGTCTGGTT"	"DCT"
"TCAGTTTCAGTTCACA"	"PT_1"
"TCAGTTTCATCGGCCA"	"CNT"
"TCAGTTTGTAATACCC"	"TAL_1"
"TCAGTTTGTATCGGTT"	"DCT"
"TCAGTTTGTCAAGCCC"	"POD"
"TCAGTTTGTTGGGATG"	"TAL_2"
"TCATACTGTGCTTCAA"	"IC-A1"
"TCATATCCATAATGAG"	"CNT"
"TCATATCTCGGTCGGT"	"PT_1"
"TCATCATCAAAGCTCT"	"TAL_2"
"TCATCATCAAGGGCAT"	"PT_1"
"TCATCCGCAACTCATG"	"iPT"
"TCATCCGCAAGTGGCA"	"TAL_1"
"TCATCCGCACAATTCG"	"TAL_1"
"TCATCCGGTCCTCATC"	"CNT"
"TCATCCGTCGCTCTCA"	"PT_1"
"TCATCCGTCGCTTTAT"	"IC-A1"
"TCATGAGAGGAGTCTG"	"PT_1"
"TCATGAGAGGCCTGAA"	"TAL_1"
"TCATGAGCATCCTGTC"	"TAL_2"
"TCATGAGGTAACGCGA"	"IC-A1"
"TCATGAGTCGCCAGTG"	"TAL_1"
"TCATGAGTCGTGCTCT"	"PT_2"
"TCATGAGTCTATCGCC"	"PT_1"
"TCATGCCAGACTTCCA"	"TAL_1"
"TCATGCCAGCATGGGT"	"PT_1"
"TCATGCCAGCCTCGTG"	"CNT"
"TCATGCCAGCCTTTGA"	"iPT"
"TCATGCCAGCGCCTTG"	"EC_2"
"TCATGCCCAAAGCTCT"	"POD"
"TCATGCCCACCAGCGT"	"DCT"
"TCATGCCGTATGAAGT"	"TAL_1"
"TCATGCCGTCAGCGTC"	"IC-A1"
"TCATGCCGTTACACTG"	"IC-A1"
"TCATGCCGTTACCTTT"	"IC-A1"
"TCATGCCTCCTCACGT"	"PT_1"
"TCATGCCTCTGTAACG"	"TAL_3"
"TCATGGAAGAGTGAAG"	"EC_2"
"TCATGGAGTCAGGTAG"	"PT_2"
"TCATGGAGTGCCGTAC"	"TAL_1"
"TCATGGAGTGCTATTG"	"TAL_2"
"TCATGTTAGTGATTCC"	"CNT"
"TCATGTTGTTGTAAAG"	"TAL_2"
"TCATGTTTCAGCATTG"	"PT_1"
"TCATGTTTCTTTGCGC"	"PT_1"
"TCATTACCACTAGGCC"	"TAL_2"
"TCATTACGTAATGCTC"	"TAL_1"
"TCATTACTCACAAGAA"	"CNT"
"TCATTACTCCGGCTTT"	"iPT"
"TCATTACTCGATGGAG"	"PT_2"
"TCATTACTCTATCGCC"	"PT_1"
"TCATTCAAGTAAAGCT"	"PT_1"
"TCATTCACAAACACCT"	"CNT"
"TCATTCACACCGCTGA"	"CNT"
"TCATTCAGTCCAACGC"	"TAL_1"
"TCATTCAGTCGTTCAA"	"PT_1"
"TCATTCAGTCTACAGT"	"DCT"
"TCATTCATCCGTGTCT"	"PT_1"
"TCATTGTCACAGTACT"	"IC-A1"
"TCATTGTTCATCCTGC"	"POD"
"TCATTTGAGACGCAGT"	"TAL_1"
"TCATTTGAGCTAGTTC"	"TAL_1"
"TCATTTGGTTCACGAT"	"TAL_1"
"TCATTTGTCCTTATCA"	"PT_1"
"TCATTTGTCTGCTGAA"	"PT_1"
"TCCACCACACACAGCC"	"EC_2"
"TCCACCACAGGGATAC"	"EC_1"
"TCCACCAGTACTAACC"	"iPT"
"TCCACCAGTCTGTTAG"	"POD"
"TCCACGTCACCTGCGA"	"iPT"
"TCCACGTGTAAGGTCG"	"iPT"
"TCCACGTGTACTAACC"	"CNT"
"TCCACGTTCACGGGCT"	"POD"
"TCCACGTTCATCCTGC"	"TAL_2"
"TCCAGAAAGATGACCG"	"TAL_1"
"TCCAGAAAGCTGGTGA"	"DCT"
"TCCAGAAAGTAATTGG"	"PT_2"
"TCCAGAACATTGAGCT"	"TAL_3"
"TCCAGAAGTACGTGAG"	"PT_1"
"TCCATCGAGAAGGCTC"	"EC_1"
"TCCATCGAGACCATTC"	"EC_2"
"TCCATCGTCGACCAAT"	"DCT"
"TCCATGCAGACTTCAC"	"PT_1"
"TCCATGCAGTTAGAAC"	"POD"
"TCCATGCCAGGCATGA"	"PT_2"
"TCCATGCGTATGCAAA"	"IC-A1"
"TCCATGCGTTGGTGTT"	"TAL_1"
"TCCATGCTCATACAGC"	"PT_1"
"TCCCACACAATTGCAC"	"PT_2"
"TCCCACACAGGCTTGC"	"iPT"
"TCCCAGTCAACATACC"	"TAL_3"
"TCCCAGTGTGTGCTTA"	"PT_2"
"TCCCATGAGTAGTCCT"	"PT_2"
"TCCCATGCAAGACGGT"	"PT_1"
"TCCCATGGTACACTCA"	"IC-B"
"TCCCATGGTTCAAGTC"	"CNT"
"TCCCATGTCGTTATCT"	"IC-A1"
"TCCGAAAAGCTACTAC"	"PT_1"
"TCCGAAACAGCAGGAT"	"PT_1"
"TCCGAAAGTCAGGCAA"	"DCT"
"TCCGAAAGTGCAGATG"	"iPT"
"TCCGAAAGTTTACCTT"	"CNT"
"TCCGAAATCCCAGGCA"	"EC_1"
"TCCGAAATCTGGTGCG"	"EC_2"
"TCCGATCAGATGACCG"	"PT_1"
"TCCGATCAGGACGCAT"	"TAL_2"
"TCCGATCCAATCCTAG"	"EC_2"
"TCCGATCCACATGTTG"	"TAL_1"
"TCCGATCTCTCTCTTC"	"IC-B"
"TCCGGGAAGAATGTTG"	"TAL_3"
"TCCGGGAAGCAGCCTC"	"EC_2"
"TCCGGGAAGTAGTGCG"	"iPT"
"TCCGGGACATGACTGT"	"DCT"
"TCCGGGATCAGAACCT"	"CNT"
"TCCGTGTCACACTGGC"	"TAL_1"
"TCCGTGTCAGCTGTTA"	"TAL_1"
"TCCGTGTCATCGGCCA"	"DCT"
"TCCGTGTCATTGACAC"	"TAL_3"
"TCCTAATAGAAGTATC"	"PT_1"
"TCCTAATCAGAGGTTG"	"PT_1"
"TCCTAATGTCCGGTGT"	"TAL_1"
"TCCTCCCAGAACGTGC"	"iPT"
"TCCTCCCAGCCATTCA"	"EC_1"
"TCCTCCCGTAAGGCCA"	"PT_1"
"TCCTCCCGTAGAATAC"	"EC_1"
"TCCTCCCGTGCATACT"	"EC_2"
"TCCTCCCGTGGCCACT"	"EC_1"
"TCCTCCCGTGGTCTGC"	"PT_1"
"TCCTCCCTCCTTATGT"	"PT_1"
"TCCTCGAAGAGGTCGT"	"PT_1"
"TCCTCGAAGCGGCTCT"	"PT_1"
"TCCTCGAGTCTCGGGT"	"MC"
"TCCTCGAGTTCTCCAC"	"CNT"
"TCCTCTTAGCGGTAGT"	"TAL_1"
"TCCTCTTAGTCTGCAT"	"EC_2"
"TCCTCTTAGTTGGGAC"	"PT_2"
"TCCTCTTGTAGCGCCT"	"TAL_3"
"TCCTCTTGTTCTTGTT"	"PT_1"
"TCCTCTTTCTTGAACG"	"EC_1"
"TCCTGCAAGGCTATCT"	"CNT"
"TCCTGCAAGGGCAACT"	"PEC"
"TCCTGCATCTTGCGCT"	"CNT"
"TCCTTCTAGCCTGGAA"	"TAL_3"
"TCCTTCTGTTTCGTTT"	"DCT"
"TCCTTCTTCATTACGG"	"EC_1"
"TCCTTTCGTCCTACAA"	"PT_1"
"TCCTTTCTCTACTATC"	"IC-A1"
"TCCTTTCTCTCGACCT"	"TAL_2"
"TCGAACAAGGTCCTGC"	"EC_1"
"TCGAACACAGCTATAC"	"iPT"
"TCGAACAGTCCCTGTT"	"PT_1"
"TCGAACATCGATAACC"	"PT_2"
"TCGAAGTAGAATCGAT"	"DCT"
"TCGAAGTAGCTCCATA"	"iPT"
"TCGAAGTCACCCTTAC"	"PT_1"
"TCGAAGTCATAATCGC"	"IC-B"
"TCGAAGTCATCTTTCA"	"DCT"
"TCGACCTAGATGCTAA"	"EC_1"
"TCGACCTCACCCTTAC"	"TAL_1"
"TCGACCTCATGAATCC"	"PT_1"
"TCGACCTTCTAAGAAG"	"TAL_3"
"TCGACCTTCTTACGGA"	"PT_1"
"TCGACCTTCTTACTGT"	"TAL_1"
"TCGACGGAGTCATAGA"	"EC_1"
"TCGACGGCAAGAAATC"	"TAL_2"
"TCGACGGGTCAGACTT"	"TAL_2"
"TCGACGGGTCTCGGAC"	"CNT"
"TCGACGGGTGACCTGC"	"PT_1"
"TCGACGGTCACAAGGG"	"PT_1"
"TCGACGGTCTATGCCC"	"PT_2"
"TCGACGGTCTCCTGCA"	"DCT"
"TCGATTTGTGGTATGG"	"CNT"
"TCGATTTTCAGACATC"	"MC"
"TCGATTTTCTTCGCTG"	"PT_2"
"TCGCACTAGACAGTCG"	"PT_2"
"TCGCACTAGACGTCCC"	"PT_2"
"TCGCACTAGCATAGGC"	"EC_1"
"TCGCACTGTAGGATAT"	"TAL_1"
"TCGCACTGTCTACGTA"	"PT_1"
"TCGCACTGTTGAGAGC"	"POD"
"TCGCAGGAGTCGAGGT"	"PT_1"
"TCGCAGGCAGCCGTCA"	"EC_1"
"TCGCAGGGTAGGTCAG"	"CNT"
"TCGCAGGGTATAGGAT"	"PT_1"
"TCGCAGGGTGCATGTT"	"CNT"
"TCGCTCACACTCGATA"	"PT_1"
"TCGCTCACAGCACAAG"	"DCT"
"TCGCTCATCATTTGGG"	"PT_2"
"TCGCTTGAGTAGAATC"	"EC_1"
"TCGCTTGGTATGCGGA"	"TAL_1"
"TCGCTTGGTGCACAAG"	"TAL_1"
"TCGCTTGTCGAGAATA"	"CNT"
"TCGGATAAGCCAGAGT"	"PT_2"
"TCGGATAAGCGTTCAT"	"EC_1"
"TCGGATAAGTAATTGG"	"TAL_2"
"TCGGATAGTACGTGTT"	"iPT"
"TCGGATAGTCCAGAAG"	"MC"
"TCGGATAGTCGAGATG"	"IC-A1"
"TCGGGACCAGCTACAT"	"TAL_1"
"TCGGGACCATCAGCAT"	"DCT"
"TCGGGACGTCCTCATC"	"PT_1"
"TCGGGACGTGCGCTCA"	"POD"
"TCGGGACTCTAGTTCT"	"TAL_2"
"TCGGGCAAGTTCGGTT"	"TAL_1"
"TCGGGCACAACCCGCA"	"IC-A1"
"TCGGGCACAGGCACAA"	"TAL_1"
"TCGGGCAGTACGGCAA"	"IC-A1"
"TCGGGCAGTAGCTCGC"	"PT_1"
"TCGGGCATCGCCGAGT"	"EC_2"
"TCGGGCATCTGTTCAT"	"PT_1"
"TCGGGCATCTTTCTAG"	"EC_2"
"TCGGGTGAGTGGTTCT"	"EC_1"
"TCGGGTGCACGGTGCT"	"IC-A1"
"TCGGTCTAGAATAGTC"	"iPT"
"TCGGTCTCAACCAATC"	"MC"
"TCGGTCTCAGCGATTT"	"EC_1"
"TCGGTCTCAGGTACGA"	"DCT"
"TCGGTCTTCAGCATTG"	"PT_1"
"TCGGTCTTCCCATGGG"	"TAL_2"
"TCGTAGAAGAATCGTA"	"CNT"
"TCGTAGAAGGAATCGC"	"PT_1"
"TCGTAGAAGGTACAGC"	"TAL_1"
"TCGTAGAGTTGGCTAT"	"TAL_2"
"TCGTAGATCACGGACC"	"CNT"
"TCGTAGATCTCTGCCA"	"POD"
"TCGTCCAAGCGCACAA"	"TAL_1"
"TCGTCCACAAGCGATG"	"TAL_1"
"TCGTCCACACAACCGC"	"EC_1"
"TCGTCCACACCCTCTA"	"POD"
"TCGTCCACACTTCCTG"	"CNT"
"TCGTCCAGTTTATGCG"	"TAL_1"
"TCGTCCATCAAAGAAC"	"DCT"
"TCGTCCATCTATCGGA"	"PT_1"
"TCGTGCTCACCCTGTT"	"TAL_1"
"TCGTGGGGTCAAACGG"	"PT_1"
"TCGTGGGTCAGAACCT"	"TAL_1"
"TCTAACTAGTCAGCGA"	"EC_2"
"TCTAACTCAAGCTGTT"	"IC-A1"
"TCTAACTCAGGCTTGC"	"PT_2"
"TCTAACTGTACCATAC"	"TAL_2"
"TCTACATAGACGCATG"	"EC_1"
"TCTACATAGGTACATA"	"TAL_3"
"TCTACATAGGTGCCAA"	"PT_2"
"TCTACATCAATGGGTG"	"TAL_2"
"TCTACATCAGGCACAA"	"PT_1"
"TCTACATGTAGAGGAA"	"DCT"
"TCTACCGAGGCATTTC"	"CNT"
"TCTACCGAGTGAGGCT"	"iPT"
"TCTACCGCATTCAGCA"	"PT_1"
"TCTATACCAATCGCCG"	"PT_2"
"TCTATACCACACAGCC"	"PT_1"
"TCTATACCACTGGATT"	"TAL_2"
"TCTATACGTATCTCGA"	"TAL_1"
"TCTATACGTTTCACAG"	"DCT"
"TCTATCAAGATACATG"	"TAL_1"
"TCTATCAAGCTCACTA"	"iPT"
"TCTATCACAATTGAGA"	"PT_1"
"TCTATCACACACCGCA"	"PT_1"
"TCTATCACACGTGAGA"	"TAL_1"
"TCTATCACAGCTGCCA"	"PT_1"
"TCTATCAGTCGCAGTC"	"PT_2"
"TCTATCAGTCGCTTGG"	"iPT"
"TCTATCAGTGACATCT"	"PT_1"
"TCTATCAGTTCGGGTC"	"iPT"
"TCTATCATCAAACCTG"	"PT_2"
"TCTATCATCCGCGGAT"	"EC_1"
"TCTCACGAGACGCCAA"	"IC-A1"
"TCTCACGAGCAGTAAT"	"CNT"
"TCTCACGAGGCCTTGC"	"DCT"
"TCTCACGAGTGAGGCT"	"MC"
"TCTCACGCAATACCTG"	"TAL_1"
"TCTCACGCATTGCTGA"	"iPT"
"TCTCACGGTATCGTGT"	"TAL_1"
"TCTCACGGTTATAGAG"	"DCT"
"TCTCACGTCGATCCCT"	"PT_1"
"TCTCACGTCTTTGCGC"	"PEC"
"TCTCAGCAGATAGGGA"	"TAL_2"
"TCTCAGCAGATCCCGC"	"TAL_2"
"TCTCAGCAGTCATCGT"	"TAL_1"
"TCTCAGCCACTGTGTA"	"IC-A1"
"TCTCAGCCAGGCTATT"	"EC_1"
"TCTCAGCCATGACGAG"	"CNT"
"TCTCAGCTCTTTACAC"	"TAL_1"
"TCTCCGACATACACCA"	"iPT"
"TCTCCGACATACAGGG"	"POD"
"TCTCCGATCTCTTCAA"	"TAL_1"
"TCTCTGGAGGCCTAAG"	"EC_2"
"TCTCTGGAGGTCTGGA"	"iPT"
"TCTCTGGCAGCTGCCA"	"IC-A1"
"TCTCTGGCATGAAAGT"	"TAL_1"
"TCTCTGGTCCGACAGC"	"EC_2"
"TCTCTGGTCTCGCTTG"	"IC-A1"
"TCTCTGGTCTGGCCGA"	"PT_2"
"TCTCTGGTCTGTCGTC"	"TAL_2"
"TCTGCCAAGTTCCATG"	"PT_1"
"TCTGCCAGTACAAGCG"	"PT_1"
"TCTGCCAGTGCTATTG"	"iPT"
"TCTGCCAGTTCGTAAC"	"TAL_1"
"TCTGCCATCTACCTTA"	"EC_2"
"TCTGGCTAGTGAGGCT"	"PT_1"
"TCTGGCTAGTGGAAAG"	"CNT"
"TCTGGCTCACGCGGTT"	"PT_1"
"TCTGGCTCAGTGCGCT"	"PT_1"
"TCTGGCTTCGCCTTTG"	"TAL_1"
"TCTGTCGAGGTGAGCT"	"TAL_1"
"TCTGTCGCACTTGACA"	"EC_1"
"TCTGTCGGTTCGGGTC"	"TAL_1"
"TCTGTCGTCCATACAG"	"TAL_2"
"TCTGTCGTCGTCTAAG"	"TAL_3"
"TCTGTCGTCTGTGCAA"	"EC_2"
"TCTTAGTAGGCTGTAG"	"POD"
"TCTTAGTAGTATCTGC"	"PT_2"
"TCTTAGTAGTCTCTGA"	"PT_1"
"TCTTAGTCACAGCTTA"	"CNT"
"TCTTAGTCATCGTGGC"	"TAL_2"
"TCTTAGTGTGATGTAA"	"EC_2"
"TCTTAGTTCAACTTTC"	"IC-A1"
"TCTTCCTAGCTAGATA"	"POD"
"TCTTCCTAGCTAGCCC"	"TAL_1"
"TCTTCCTGTAGATCGG"	"DCT"
"TCTTCCTTCGGATTAC"	"EC_1"
"TCTTCCTTCTAATTCC"	"PT_1"
"TCTTGCGAGCTTAAGA"	"PT_2"
"TCTTGCGAGGCTCACC"	"MC"
"TCTTGCGAGTAAACGT"	"TAL_2"
"TCTTGCGGTAGATCCT"	"PT_1"
"TCTTGCGGTGCGTCGT"	"CNT"
"TCTTGCGGTTGCCATA"	"PT_2"
"TCTTGCGTCAAGCTGT"	"iPT"
"TCTTGCGTCCTCACCA"	"TAL_1"
"TCTTGCGTCGGAAACG"	"TAL_2"
"TCTTGCGTCTTCTCAA"	"DCT"
"TCTTTGAAGGCTAAAT"	"TAL_1"
"TCTTTGACAGTGGTGA"	"DCT"
"TCTTTGACATTCCTCG"	"TAL_2"
"TCTTTGAGTAAGTTGA"	"TAL_1"
"TCTTTGAGTACGCGTC"	"TAL_1"
"TCTTTGAGTCAGTCCG"	"PT_2"
"TCTTTGAGTGAGACGT"	"EC_2"
"TCTTTGATCAAATGCC"	"IC-A1"
"TCTTTGATCCACTGGG"	"iPT"
"TCTTTGATCGGACTTA"	"PT_2"
"TGAACGTGTAAGAACT"	"PT_1"
"TGAATCGAGGGCTAAC"	"PT_1"
"TGAATCGCAAAGGTTA"	"POD"
"TGAATCGGTACAACGG"	"PT_2"
"TGAATCGGTTAGGACG"	"EC_1"
"TGAATGCAGCTCGAAG"	"POD"
"TGAATGCCAATCGTCA"	"DCT"
"TGAATGCCAGGACGAT"	"POD"
"TGAATGCGTGGTCCGT"	"CNT"
"TGAATGCTCATCCTAT"	"CNT"
"TGAATGCTCATGGTAC"	"PT_1"
"TGAATGCTCATTTCGT"	"PT_1"
"TGAATGCTCCATGAGT"	"PT_1"
"TGACAGTAGCGAATGC"	"POD"
"TGACAGTCACAGTCCG"	"iPT"
"TGACAGTGTGCATTTG"	"PT_1"
"TGACAGTTCATACAGC"	"iPT"
"TGACCCTCACAAGTGG"	"TAL_1"
"TGACCCTCACGTCATA"	"iPT"
"TGACCCTGTAAGATCA"	"IC-A1"
"TGACCCTGTCCAAAGG"	"PT_2"
"TGACCCTTCAGAGCAG"	"EC_2"
"TGACCCTTCCACTTCG"	"TAL_2"
"TGACCCTTCTCTGAGA"	"iPT"
"TGACGCGCAAGGCCTC"	"EC_1"
"TGACGCGGTCCAAATC"	"TAL_3"
"TGACGCGGTCTCGGAC"	"TAL_1"
"TGACGCGGTGACTATC"	"IC-A1"
"TGACGCGGTTATGACC"	"DCT"
"TGACGCGTCTAAGAAG"	"CNT"
"TGACGCGTCTGCTAGA"	"EC_1"
"TGACTCCAGTAAGACT"	"TAL_1"
"TGAGACTAGCACCGAA"	"EC_2"
"TGAGACTAGGGAGGTG"	"TAL_1"
"TGAGACTCACAAGCCC"	"PT_2"
"TGAGACTGTGTTTGCA"	"TAL_1"
"TGAGCATAGAGATCGC"	"PT_1"
"TGAGCATCATGACGTT"	"PT_1"
"TGAGCATCATTCTTCA"	"TAL_2"
"TGAGCATGTCAGCGTC"	"EC_2"
"TGAGCATTCGCGGACT"	"EC_1"
"TGAGCGCAGGAGCAAA"	"TAL_3"
"TGAGCGCCAGCATGCC"	"POD"
"TGAGCGCGTATTGAGA"	"CNT"
"TGAGCGCGTGCGGTAA"	"iPT"
"TGAGCGCGTGGACCAA"	"TAL_3"
"TGAGGAGAGAGCGACT"	"EC_1"
"TGAGGAGAGTATGTAG"	"PT_2"
"TGAGGAGGTATCTCTT"	"DCT"
"TGAGGAGGTTCCCACT"	"TAL_3"
"TGAGGAGTCAGTCTTT"	"PEC"
"TGAGGAGTCTTTGGAG"	"PT_2"
"TGAGGGACAAATACGA"	"TAL_2"
"TGAGGTTAGACAACAT"	"TAL_3"
"TGAGGTTAGACGCAGT"	"POD"
"TGAGGTTAGTTCCATG"	"TAL_2"
"TGAGGTTGTAATCAGA"	"PT_1"
"TGAGGTTGTGCTCCGA"	"EC_1"
"TGAGGTTGTTCCGCTT"	"CNT"
"TGAGGTTTCGGCTCTT"	"CNT"
"TGAGTCACACAGCGCT"	"POD"
"TGATCAGAGGCATCAG"	"EC_1"
"TGATCAGGTTGGGAAC"	"TAL_1"
"TGATCTTAGCATCCTA"	"PEC"
"TGATCTTTCACTCGAA"	"PT_1"
"TGATCTTTCATCCCGT"	"PT_1"
"TGATGCAAGACAACAT"	"PT_2"
"TGATGCAAGGCTGGAT"	"TAL_2"
"TGATGCAGTCTCTCAC"	"TAL_1"
"TGATGCAGTGCTGCAC"	"TAL_1"
"TGATGCATCCAGTACA"	"PT_2"
"TGATGCATCTCGAACA"	"PT_1"
"TGATGCATCTGAGATC"	"DCT"
"TGATGGTTCACTTGGA"	"iPT"
"TGATTCTCAAGATGGC"	"PT_2"
"TGATTCTCAGGTTTAC"	"TAL_1"
"TGATTCTTCCATAGGT"	"PT_1"
"TGATTCTTCCCGTTGT"	"EC_2"
"TGATTCTTCTGCCCTA"	"TAL_1"
"TGATTTCAGACTGAGC"	"TAL_1"
"TGATTTCAGTTGAAGT"	"TAL_1"
"TGATTTCGTTTACGAC"	"EC_1"
"TGATTTCTCGGTGCAC"	"DCT"
"TGCACGGAGACGGATC"	"TAL_1"
"TGCACGGAGGTCATCT"	"iPT"
"TGCACGGCATGAGGGT"	"TAL_1"
"TGCACGGGTCGAGATG"	"CNT"
"TGCACGGTCGGTGTTA"	"TAL_1"
"TGCAGATCACTCCGGA"	"EC_1"
"TGCAGATCAGGGACTA"	"PT_1"
"TGCAGATGTTAGGAGC"	"CNT"
"TGCAGGCAGGACGCAT"	"TAL_1"
"TGCAGGCAGGAGCTGT"	"IC-A1"
"TGCAGGCTCCTGTTGC"	"POD"
"TGCAGTAAGAATACAC"	"IC-B"
"TGCAGTAAGCTTAGTC"	"PT_1"
"TGCAGTACAGGATCTT"	"IC-A1"
"TGCAGTACATTGAAGA"	"TAL_1"
"TGCAGTATCCTCTAAT"	"PT_2"
"TGCATCCAGATCGACG"	"PT_2"
"TGCATCCAGGATATAC"	"PT_1"
"TGCATCCAGTCGCCCA"	"TAL_1"
"TGCATCCAGTTTCGAC"	"DCT"
"TGCATCCTCATCCCGT"	"PT_1"
"TGCATGAAGATGAAGG"	"PT_1"
"TGCATGAAGCAACAGC"	"IC-A1"
"TGCATGACACGATAGG"	"CNT"
"TGCATGACATGACGGA"	"DCT"
"TGCATGAGTAATGCGG"	"CNT"
"TGCATGAGTCAAGTTC"	"TAL_1"
"TGCATGATCTTAGCTT"	"TAL_1"
"TGCCGAGAGACCAGAC"	"PT_1"
"TGCCGAGCAATTGTGC"	"POD"
"TGCCGAGCACAATGTC"	"PT_2"
"TGCCGAGGTCCCGTGA"	"TAL_2"
"TGCCGAGGTGTTATCG"	"DCT"
"TGCCGAGTCTGACAGT"	"TAL_2"
"TGCCGAGTCTTTCGAT"	"TAL_1"
"TGCGACGCAGCCTTCT"	"EC_1"
"TGCGACGCAGGGACTA"	"TAL_3"
"TGCGACGGTCGATTCA"	"POD"
"TGCGACGTCAGGGTAG"	"DCT"
"TGCGACGTCCTACGAA"	"CNT"
"TGCGACGTCCTATTGT"	"TAL_2"
"TGCGATAAGTACCGGA"	"DCT"
"TGCGATACAACCGGAA"	"MC"
"TGCGATATCCGCACGA"	"PT_1"
"TGCGGCAGTGAGATTA"	"TAL_1"
"TGCGGGTGTTTGACAC"	"PEC"
"TGCGGGTTCTCTGACC"	"EC_1"
"TGCTCCACAATGCTCA"	"iPT"
"TGCTCCACAATTTCGG"	"CNT"
"TGCTCCACACACAGCC"	"PT_1"
"TGCTCCACACTAACGT"	"DCT"
"TGCTCCAGTAGCTAAA"	"PT_1"
"TGCTCCATCCACGAAT"	"CNT"
"TGCTCCATCCGGACGT"	"TAL_2"
"TGCTCCATCTCTCTTC"	"TAL_1"
"TGCTCGTAGTCCCGAC"	"iPT"
"TGCTCGTCAATGTCTG"	"TAL_1"
"TGCTCGTGTCGCTCGA"	"EC_1"
"TGCTCGTTCACTGCTC"	"PEC"
"TGCTCGTTCCGTGTAA"	"CNT"
"TGCTCGTTCTGCTAGA"	"TAL_3"
"TGCTGAAAGTCATACC"	"TAL_1"
"TGCTGAAGTACTGACT"	"CNT"
"TGCTGAAGTAGCCAGA"	"PT_1"
"TGCTGAAGTCCGGATC"	"TAL_1"
"TGCTGAATCCAAAGGG"	"CNT"
"TGCTGAATCTGTTCAT"	"DCT"
"TGCTTCGAGCAAACAT"	"TAL_1"
"TGCTTCGAGTAACGAT"	"EC_1"
"TGCTTCGCACCAGCTG"	"iPT"
"TGCTTCGTCCACGGGT"	"TAL_2"
"TGCTTGCGTGTCCGTG"	"PT_1"
"TGCTTGCTCAAAGAAC"	"PT_1"
"TGCTTGCTCCACATAG"	"EC_2"
"TGGAACTAGCGTACAG"	"PT_2"
"TGGAACTCACTACGGC"	"TAL_1"
"TGGAACTTCGACATAC"	"IC-A1"
"TGGAGAGAGGGAGGGT"	"TAL_1"
"TGGAGAGGTTATGTCG"	"TAL_1"
"TGGAGAGTCCTCATAT"	"CNT"
"TGGAGGAGTACCCGCA"	"PT_2"
"TGGAGGAGTGGTCAAG"	"DCT"
"TGGAGGATCTGTAAGC"	"TAL_1"
"TGGATCAAGGCGCTCT"	"TAL_2"
"TGGATGTAGGCCACTC"	"PT_1"
"TGGGAAGAGGCAGCTA"	"PT_1"
"TGGGAAGAGGGAGGCA"	"EC_1"
"TGGGAAGCAGCACAGA"	"TAL_2"
"TGGGAAGGTTACTCAG"	"EC_2"
"TGGGAAGTCCACGTCT"	"iPT"
"TGGGAAGTCCGGTTCT"	"TAL_1"
"TGGGAAGTCGCAGTCG"	"PT_1"
"TGGGAAGTCTAGCCTC"	"PT_1"
"TGGGAGAAGCAGGCTA"	"TAL_1"
"TGGGAGAAGCGATTCT"	"PT_1"
"TGGGAGAAGGGACAGG"	"PT_2"
"TGGGAGACAGAGCTAG"	"PT_1"
"TGGGAGACAGTCGGAA"	"PT_2"
"TGGGAGAGTCACAATC"	"PT_1"
"TGGGAGAGTCGTACTA"	"PT_1"
"TGGGAGATCATGGCCG"	"TAL_1"
"TGGGATTGTAGAGACC"	"TAL_1"
"TGGGATTGTGCCCGTA"	"EC_1"
"TGGGATTTCGTGCTCT"	"PT_1"
"TGGGCGTGTACGATGG"	"DCT"
"TGGGCGTGTGGCTAGA"	"IC-B"
"TGGGCGTGTTACGTAC"	"TAL_2"
"TGGGCGTTCTGTGTGA"	"IC-A1"
"TGGGCTGCAGTGAGCA"	"TAL_1"
"TGGGCTGGTGGAACAC"	"TAL_1"
"TGGGTTAAGGTTCATC"	"IC-B"
"TGGTACAAGAAGGCTC"	"EC_2"
"TGGTACAAGCAAATCA"	"EC_2"
"TGGTACAAGCATCCCG"	"TAL_1"
"TGGTACAAGGCAGCTA"	"PT_1"
"TGGTACAGTAGTGCGA"	"CNT"
"TGGTACAGTCACAATC"	"TAL_1"
"TGGTACAGTCCTCCTA"	"PT_1"
"TGGTACAGTCGATTCA"	"PT_1"
"TGGTAGTAGTTAGTAG"	"DCT"
"TGGTAGTGTATGATCC"	"TAL_2"
"TGGTAGTGTGCGACAA"	"PT_1"
"TGGTGATAGAACTCCT"	"TAL_1"
"TGGTTAGAGGCTAGCA"	"TAL_1"
"TGGTTAGCAATACAGA"	"EC_1"
"TGGTTAGCAGAGGTAC"	"PT_2"
"TGGTTAGCAGAGTGAC"	"DCT"
"TGGTTAGGTCGCGTCA"	"PT_1"
"TGGTTAGTCGCAACAT"	"PT_2"
"TGGTTAGTCTCCAATT"	"PT_1"
"TGTAACGAGACTCCGC"	"PT_1"
"TGTAACGCACGCCAGT"	"TAL_2"
"TGTAACGCAGTGTGGA"	"iPT"
"TGTAACGGTCTGTGGC"	"TAL_2"
"TGTAACGGTTCAAAGA"	"CNT"
"TGTAACGTCCGCGAGT"	"CNT"
"TGTAAGCTCCGTACGG"	"TAL_2"
"TGTACAGCAAGGTCTT"	"POD"
"TGTACAGGTATCAGCT"	"IC-A1"
"TGTAGACAGTGTTGAA"	"EC_2"
"TGTAGACCAGTTTCGA"	"PT_1"
"TGTAGACCATTCCTCG"	"TAL_2"
"TGTAGACGTATGTCAC"	"PT_1"
"TGTAGACGTGGATACG"	"MC"
"TGTAGACTCAGCGGAA"	"PT_1"
"TGTAGACTCCTATTTG"	"iPT"
"TGTCAGAAGAAGCCAC"	"PEC"
"TGTCAGACAATAAGGT"	"EC_1"
"TGTCAGATCGCTTTAT"	"iPT"
"TGTCAGATCGTCGATA"	"CNT"
"TGTCAGATCTCGAGTA"	"CNT"
"TGTCAGATCTGCGTCT"	"IC-B"
"TGTCCACGTACCTTCC"	"PT_1"
"TGTCCACGTATCGTTG"	"TAL_1"
"TGTCCACTCACTCTTA"	"EC_2"
"TGTCCACTCCCTGGTT"	"PT_1"
"TGTCCCAAGATTGGGC"	"EC_2"
"TGTCCCAGTAGGGAGG"	"CNT"
"TGTCCCAGTTCAAGGG"	"PT_2"
"TGTCCCATCGAACCTA"	"TAL_1"
"TGTCCTGGTTTGCCGG"	"PT_1"
"TGTGAGTAGCTAGCCC"	"TAL_1"
"TGTGAGTCAAGCGATG"	"PT_1"
"TGTGAGTCACGCGGTT"	"DCT"
"TGTGAGTCAGTTGTCA"	"TAL_1"
"TGTGAGTGTGAGTGAC"	"CNT"
"TGTGAGTGTTCCGCAG"	"PT_1"
"TGTGAGTTCGGACTTA"	"DCT"
"TGTGAGTTCTCCCTAG"	"PT_2"
"TGTGATGGTCTCGGAC"	"EC_1"
"TGTGATGGTTACCCTC"	"CNT"
"TGTGATGTCGCCAACG"	"TAL_3"
"TGTGATGTCGTTCTGC"	"TAL_2"
"TGTGCGGCAAAGGAGA"	"PT_2"
"TGTGCGGCATTCGATG"	"PT_2"
"TGTGCGGGTCCACGCA"	"PT_1"
"TGTGCGGGTTGCCATA"	"TAL_1"
"TGTGCGGGTTGTGCAT"	"iPT"
"TGTGCGGTCTCCACTG"	"DCT"
"TGTGGCGCACCAGCGT"	"TAL_2"
"TGTGGCGCAGCGTATT"	"PT_2"
"TGTGGCGGTGGATTTC"	"DCT"
"TGTGGCGTCAAGTTGC"	"TAL_2"
"TGTGGCGTCGCAGTCG"	"PT_2"
"TGTGGCGTCGGACTGC"	"TAL_2"
"TGTGGCGTCTCCGCAT"	"EC_2"
"TGTGTGAAGCACTGGA"	"CNT"
"TGTGTGACAAGCGATG"	"PT_1"
"TGTGTGACAGTCGTTA"	"CNT"
"TGTGTGACATGTGACT"	"TAL_2"
"TGTGTGAGTATCGCAT"	"TAL_1"
"TGTGTGATCTTCGGAA"	"TAL_2"
"TGTTACTAGGTACCTT"	"EC_1"
"TGTTACTTCTTCTCAA"	"IC-B"
"TGTTCATCATGAATCC"	"CNT"
"TGTTCATGTACTCAAC"	"PT_1"
"TGTTCATGTCGTAATC"	"POD"
"TGTTCATGTTCGCGTG"	"CNT"
"TGTTCCGAGACGCCCT"	"TAL_2"
"TGTTCCGAGTTCCTGA"	"PT_1"
"TGTTCCGCACGGAAGT"	"EC_1"
"TGTTCCGCAGCTCCTT"	"TAL_2"
"TGTTCCGGTCTTCCGT"	"TAL_2"
"TGTTCCGTCAAATGAG"	"CNT"
"TGTTCTAAGGCTTCCG"	"TAL_1"
"TGTTCTAAGGTCACCC"	"EC_1"
"TGTTCTACACGCTATA"	"DCT"
"TGTTCTACAGGAATAT"	"TAL_3"
"TGTTCTAGTCGAACGA"	"TAL_1"
"TGTTCTAGTGTCATCA"	"TAL_1"
"TGTTGAGAGAGTCTTC"	"TAL_1"
"TGTTGAGGTAAGGCTG"	"PT_2"
"TGTTGAGTCAATGTCG"	"PT_2"
"TGTTGAGTCCTAGAGT"	"PT_1"
"TGTTGGAGTAGGAGTC"	"CNT"
"TGTTGGATCCACTAGA"	"CNT"
"TGTTGGATCCGGCAGT"	"CNT"
"TGTTTGTAGTCGAATA"	"IC-B"
"TGTTTGTGTAAGATAC"	"DCT"
"TGTTTGTGTAGGTGCA"	"IC-A1"
"TGTTTGTTCATTACTC"	"CNT"
"TGTTTGTTCCAACCAA"	"iPT"
"TTAATCCAGATCGCCC"	"PT_2"
"TTAATCCCAACTGTGT"	"PT_1"
"TTAATCCGTCATACCA"	"TAL_1"
"TTAATCCGTCTGCCTT"	"EC_2"
"TTACAGGAGACCATAA"	"TAL_1"
"TTACAGGAGAGGATGA"	"iPT"
"TTACAGGCAATTGCAC"	"EC_1"
"TTACAGGCATGATCTG"	"PT_1"
"TTACAGGGTTTCACAG"	"PT_1"
"TTACAGGTCCCACAGG"	"CNT"
"TTACCATCACGTCGGT"	"IC-A1"
"TTACCATGTTGCTCGG"	"PT_1"
"TTACCGCAGAATAGTC"	"IC-A1"
"TTACCGCGTTAGGGTG"	"PT_1"
"TTACCGCGTTGCTCCT"	"PT_1"
"TTACCGCTCCCGTGTT"	"PT_2"
"TTACCGCTCGTTCAGA"	"PT_2"
"TTACGCCAGCGGGTTA"	"TAL_2"
"TTACGCCTCAAAGCCT"	"MC"
"TTACGCCTCCGTAGTA"	"CNT"
"TTACGCCTCGAAGGAC"	"TAL_3"
"TTACGTTCACCTCAGG"	"PT_1"
"TTACGTTGTACGCTTA"	"PT_1"
"TTACGTTGTGAACTAA"	"PEC"
"TTACGTTTCAGGAACG"	"CNT"
"TTACTGTAGTTAACAG"	"PT_1"
"TTACTGTGTGGCTACC"	"POD"
"TTACTGTTCGGCTGAC"	"TAL_1"
"TTAGGCAAGGTAAAGG"	"TAL_2"
"TTAGGCACAGACACAG"	"PT_1"
"TTAGGCACAGGTTCAT"	"PT_2"
"TTAGGCAGTGAGACGT"	"PT_2"
"TTAGGCAGTGAGTTGG"	"PT_1"
"TTAGGCAGTGGGTATG"	"PT_2"
"TTAGGCAGTTGTGCCG"	"EC_1"
"TTAGGCATCTAATTCC"	"IC-A1"
"TTAGGGTCAATACCTG"	"PT_1"
"TTAGGGTCACGCGCTA"	"PT_1"
"TTAGGGTCACTCAGAT"	"iPT"
"TTAGGGTGTAGGAGTC"	"PT_1"
"TTAGGGTTCAGCGGAA"	"POD"
"TTAGGGTTCTACTGAG"	"PT_1"
"TTAGGGTTCTAGTGTG"	"DCT"
"TTAGTCTCAAAGAACT"	"PT_2"
"TTAGTCTCAGCGCTTG"	"PT_1"
"TTAGTCTGTGTTGATC"	"IC-B"
"TTAGTCTGTTGCGAAG"	"TAL_1"
"TTAGTCTTCAAGCCAT"	"PT_1"
"TTAGTCTTCCTCACCA"	"IC-A1"
"TTATTGCGTATAGGGC"	"TAL_3"
"TTATTGCGTATGAGCG"	"DCT"
"TTATTGCGTATGCGGA"	"iPT"
"TTATTGCGTTGTATGC"	"TAL_1"
"TTCAATCAGAGTGTGC"	"PT_2"
"TTCAATCAGGACAGTC"	"PT_1"
"TTCAATCCACACTGGC"	"TAL_2"
"TTCAATCCACCCGTAG"	"PT_1"
"TTCAATCCACGAGGTA"	"TAL_2"
"TTCAATCCACGGCTAC"	"PT_1"
"TTCAATCCAGGTCCGT"	"EC_2"
"TTCAATCTCTATACTC"	"TAL_2"
"TTCACCGAGTAACGAT"	"IC-A1"
"TTCACCGAGTTACGTC"	"PT_1"
"TTCACCGCAACTTGCA"	"EC_1"
"TTCACCGCAATCCTTT"	"PT_2"
"TTCACCGCACTGAGTT"	"CNT"
"TTCACCGCAGTGGTGA"	"EC_1"
"TTCACCGCAGTTTCGA"	"EC_1"
"TTCACCGTCCCTCTTT"	"PT_1"
"TTCACCGTCGGTTAGT"	"iPT"
"TTCACGCAGGTTACAA"	"DCT"
"TTCACGCCAAACAGGC"	"PT_1"
"TTCACGCCAAATGGTA"	"CNT"
"TTCACGCCAAGGACAC"	"EC_2"
"TTCACGCCAGGAACCA"	"IC-B"
"TTCACGCCATCGTGCG"	"iPT"
"TTCACGCGTTCCTAAG"	"EC_1"
"TTCAGGACAGCCCACA"	"EC_2"
"TTCAGGAGTCTCGGGT"	"PT_1"
"TTCAGGATCTCCACTG"	"POD"
"TTCAGGATCTTGAGCA"	"TAL_1"
"TTCATGTGTTGCTTGA"	"CNT"
"TTCATGTTCCCTTTGG"	"PT_1"
"TTCATGTTCGCGTGCA"	"EC_1"
"TTCATTGCAACTGGTT"	"IC-A1"
"TTCATTGCACGACAGA"	"IC-A1"
"TTCATTGCAGACGGAT"	"PT_1"
"TTCATTGCATCCTTCG"	"PT_1"
"TTCATTGGTGCTAGCC"	"POD"
"TTCCAATAGTGATTCC"	"IC-A1"
"TTCCAATCATTGTCGA"	"IC-A1"
"TTCCAATGTCCGCAGT"	"POD"
"TTCCAATTCACTGCTC"	"IC-A1"
"TTCCAATTCTAGGCCG"	"CNT"
"TTCCACGCATTAGGAA"	"TAL_3"
"TTCCACGGTAGTTCCA"	"TAL_2"
"TTCCACGGTCAAAGCG"	"PT_2"
"TTCCACGGTCCTCCAT"	"EC_1"
"TTCCACGGTCGCGGTT"	"IC-B"
"TTCCGGTCACTTGGGC"	"CNT"
"TTCCGGTCACTTTAGG"	"MC"
"TTCCGGTCAGGCGTTC"	"TAL_1"
"TTCCGGTGTCCCGCAA"	"TAL_2"
"TTCCGGTTCCATCAGA"	"EC_1"
"TTCCGTGCACGTGAGA"	"DCT"
"TTCCGTGGTCCACATA"	"TAL_1"
"TTCCGTGGTTAGGCCC"	"CNT"
"TTCCGTGGTTGCGTAT"	"PT_1"
"TTCCGTGTCTGGAGAG"	"PT_2"
"TTCCTAAAGACTCATC"	"POD"
"TTCCTAAAGAGCCGTA"	"PT_1"
"TTCCTAAAGCGTCAAG"	"DCT"
"TTCCTAACAAGAGAGA"	"IC-A1"
"TTCCTAATCACACCCT"	"EC_2"
"TTCCTCTCAATATCCG"	"MC"
"TTCCTCTTCTTGGTCC"	"EC_1"
"TTCCTTCAGCATCCTA"	"TAL_2"
"TTCCTTCCAGCGTATT"	"PT_2"
"TTCCTTCCATAGAGGC"	"CNT"
"TTCCTTCCATCATGAC"	"TAL_2"
"TTCCTTCGTGGCTGAA"	"EC_1"
"TTCCTTCTCGCGTTTC"	"DCT"
"TTCCTTCTCTATGTGG"	"TAL_3"
"TTCGATTCAATGCAGG"	"PT_1"
"TTCGATTCACTTTAGG"	"CNT"
"TTCGATTCAGCAGACA"	"IC-A1"
"TTCGATTCAGCAGGAT"	"POD"
"TTCGATTCAGTGCGCT"	"EC_1"
"TTCGATTGTCGATTTG"	"CNT"
"TTCGATTGTGAGAGGG"	"TAL_2"
"TTCGATTGTGGTCTTA"	"TAL_2"
"TTCGCTGCAGACCATT"	"TAL_1"
"TTCGCTGTCTGCACCT"	"TAL_1"
"TTCGGTCAGCCAGTAG"	"TAL_2"
"TTCGGTCAGCGCACAA"	"PT_1"
"TTCGGTCTCTCCGAAA"	"iPT"
"TTCTAACCAATGCTCA"	"DCT"
"TTCTAACCAGAATCGG"	"TAL_2"
"TTCTAACGTACAAAGT"	"TAL_1"
"TTCTAACGTCGGCACT"	"PT_1"
"TTCTAACGTTACGTAC"	"TAL_1"
"TTCTAACTCCGATAGT"	"PT_2"
"TTCTAACTCGTCGCTT"	"CNT"
"TTCTAGTCACGCGTCA"	"PT_1"
"TTCTAGTCACTACTTT"	"TAL_1"
"TTCTAGTCAGCTGAGA"	"CNT"
"TTCTAGTTCCGACATA"	"PEC"
"TTCTCTCAGCGGACAT"	"PEC"
"TTCTCTCAGGGTCAAC"	"EC_2"
"TTCTCTCAGGTATAGT"	"TAL_1"
"TTCTCTCCATAGAATG"	"EC_1"
"TTCTCTCTCTGGACTA"	"EC_1"
"TTCTCTCTCTTAAGGC"	"TAL_1"
"TTCTGTAAGCGTTCCG"	"PT_1"
"TTCTGTAAGGCCCAAA"	"PT_1"
"TTCTGTACAGTCAGCC"	"TAL_3"
"TTCTGTACATTGAGGG"	"TAL_2"
"TTCTGTAGTACAAGTA"	"TAL_2"
"TTCTGTAGTCTGTGGC"	"TAL_3"
"TTCTGTAGTTCCTTGC"	"CNT"
"TTCTGTAGTTCTCTAT"	"POD"
"TTCTGTATCCGTACGG"	"POD"
"TTCTTCCAGATAGCTA"	"PT_1"
"TTCTTCCCAAGTGTCT"	"POD"
"TTCTTCCCACAATGAA"	"PEC"
"TTCTTCCGTCACGACC"	"MC"
"TTCTTCCGTCACTTAG"	"EC_2"
"TTCTTCCGTTGAAGTA"	"TAL_2"
"TTCTTCCGTTTGAAAG"	"iPT"
"TTCTTGAAGATACAGT"	"POD"
"TTCTTGACAATCGCAT"	"TAL_2"
"TTCTTGACACGACGTC"	"PT_2"
"TTCTTGACAGATACTC"	"POD"
"TTCTTGACATTGCTTT"	"PT_1"
"TTCTTGATCAGTGTGT"	"PT_1"
"TTCTTGATCCCTCGTA"	"PT_1"
"TTGAACGGTCGTATTG"	"TAL_3"
"TTGAACGGTGAATGTA"	"DCT"
"TTGAACGGTTCCGCAG"	"TAL_1"
"TTGAACGTCTACCAGA"	"TAL_1"
"TTGACCCAGACCAGAC"	"PT_1"
"TTGACCCGTAAGAACT"	"CNT"
"TTGACCCTCAAACGTC"	"CNT"
"TTGACCCTCATCTCTA"	"iPT"
"TTGAGTGAGCAGGCTA"	"PT_1"
"TTGATGGGTATTTCGG"	"PT_1"
"TTGATGGGTGGATCGA"	"TAL_1"
"TTGATGGTCCTTCTGG"	"TAL_3"
"TTGATGGTCGGCTTCT"	"PT_1"
"TTGCATTAGTCAAGCG"	"POD"
"TTGCATTAGTCATGCT"	"TAL_1"
"TTGCATTCATTGTCGA"	"TAL_2"
"TTGCATTGTACCGCGT"	"DCT"
"TTGCATTGTCTGGTTA"	"CNT"
"TTGCATTTCCATACTT"	"TAL_1"
"TTGCCTGAGTTCCGTA"	"PT_1"
"TTGCCTGCAACAAGTA"	"PT_1"
"TTGCCTGCACCCTATC"	"EC_2"
"TTGCCTGCAGCTACTA"	"TAL_2"
"TTGCCTGGTACACTCA"	"DCT"
"TTGCCTGGTGCGCTCA"	"TAL_1"
"TTGCCTGTCATCTATC"	"PT_1"
"TTGCGTCAGGCACCAA"	"EC_2"
"TTGCTGCAGCAACAAT"	"PT_1"
"TTGCTGCAGGATCATA"	"PT_1"
"TTGCTGCAGGGCAGAG"	"PT_2"
"TTGCTGCTCATGCTAG"	"MC"
"TTGGATGAGAGGCTGT"	"TAL_1"
"TTGGATGAGGTGCCAA"	"PT_2"
"TTGGATGCAAGAGCTG"	"PT_2"
"TTGGATGCAGACTCTA"	"PT_1"
"TTGGATGCATTGAAGA"	"TAL_2"
"TTGGATGGTAGATGTA"	"PT_1"
"TTGGATGGTGGTAACG"	"IC-A1"
"TTGGATGTCGACGATT"	"IC-A1"
"TTGGATGTCGGCCCAA"	"TAL_1"
"TTGGGATAGGACTATA"	"TAL_1"
"TTGGGATAGGCCCACT"	"PT_1"
"TTGGGATAGGTTCATC"	"EC_1"
"TTGGGATAGTGTTGAA"	"PT_2"
"TTGGGATGTAATCAGA"	"IC-A1"
"TTGGGATTCGGCTATA"	"PT_1"
"TTGGGATTCTACCTTA"	"TAL_2"
"TTGGGCGGTCTCGCGA"	"PEC"
"TTGGGCGGTGTCATGT"	"TAL_2"
"TTGGGCGTCTTCACAT"	"PT_1"
"TTGGGTAAGGCTTAGG"	"TAL_2"
"TTGGGTACAGATACCT"	"IC-A1"
"TTGGGTACAGGAATCG"	"PT_2"
"TTGGGTACAGTCGTTA"	"PT_1"
"TTGGGTACATCCTAAG"	"iPT"
"TTGGGTACATTGCCTC"	"IC-A1"
"TTGGGTATCCCTTGGT"	"PT_2"
"TTGGTTTAGTTCCTGA"	"PT_1"
"TTGGTTTCAGATAAAC"	"EC_2"
"TTGTGGAAGCATTTGC"	"TAL_1"
"TTGTGGAGTTCCGCAG"	"PT_2"
"TTGTGGAGTTTACGAC"	"TAL_1"
"TTGTGGATCATGCATG"	"CNT"
"TTGTGGATCCAAGCAT"	"IC-A1"
"TTGTGTTAGATGATTG"	"EC_2"
"TTGTGTTAGCCTCCAG"	"PT_2"
"TTGTGTTAGGATCACG"	"TAL_1"
"TTGTGTTGTGGGCTCT"	"TAL_2"
"TTGTGTTTCTAGGCCG"	"iPT"
"TTGTTCAAGATTCGAA"	"EC_1"
"TTGTTCACAAACCGGA"	"TAL_1"
"TTGTTCACAAAGGGTC"	"IC-A1"
"TTGTTCACATGGATCT"	"DCT"
"TTGTTCAGTCTCAGGC"	"POD"
"TTGTTCAGTGTACAGG"	"POD"
"TTGTTCAGTTCCAAAC"	"CNT"
"TTGTTCATCTGGTGGC"	"TAL_1"
"TTGTTGTAGTAGGCCA"	"PEC"
"TTGTTGTCAATAAGGT"	"POD"
"TTGTTGTGTAGACAGC"	"TAL_1"
"TTGTTGTGTGAGCGAT"	"CNT"
"TTGTTTGAGGAGGGTG"	"iPT"
"TTGTTTGAGGAGGTTC"	"PT_1"
"TTGTTTGAGGTTACAA"	"PT_2"
"TTGTTTGAGTTGGAGC"	"EC_1"
"TTGTTTGCAGGCTATT"	"TAL_1"
"TTGTTTGGTGTCTAAC"	"POD"
"TTTACCAAGTTAACAG"	"PEC"
"TTTACCACACGCGGTT"	"PT_1"
"TTTACCAGTGTAAATG"	"EC_1"
"TTTACCATCGCTGTCT"	"EC_1"
"TTTACGTAGCTGAAAT"	"TAL_1"
"TTTACGTAGTAATTGG"	"TAL_3"
"TTTACGTCAGAGGGTT"	"IC-B"
"TTTACGTGTCACTCAA"	"CNT"
"TTTACGTTCACAGTGT"	"TAL_2"
"TTTACTGGTCCAGAAG"	"PT_1"
"TTTACTGGTGACGCCT"	"TAL_1"
"TTTAGTCAGCCATATC"	"DCT"
"TTTAGTCCACTACTTT"	"PT_2"
"TTTAGTCCAGCGTGCT"	"PT_1"
"TTTAGTCGTATCGCGC"	"TAL_1"
"TTTAGTCGTTCTCGCT"	"CNT"
"TTTAGTCTCAGTAGGG"	"iPT"
"TTTATGCAGGCACTAG"	"TAL_1"
"TTTATGCAGGTACAGC"	"iPT"
"TTTATGCAGTCACTAC"	"POD"
"TTTATGCCAAAGCTCT"	"iPT"
"TTTATGCCACCACATA"	"PT_2"
"TTTATGCCAGGACTAG"	"CNT"
"TTTATGCGTTTGACAC"	"CNT"
"TTTCACATCATGGATC"	"PT_2"
"TTTCACATCTTCCAGC"	"PT_2"
"TTTCACATCTTGTTAC"	"PT_1"
"TTTCAGTAGCGACCCT"	"MC"
"TTTCAGTAGCTTTCTT"	"TAL_1"
"TTTCAGTTCAGCAGAG"	"TAL_2"
"TTTCAGTTCCGTGGGT"	"TAL_2"
"TTTCAGTTCGTTAGTG"	"CNT"
"TTTCATGAGTAGAGTT"	"TAL_1"
"TTTCATGCAACGCATT"	"TAL_1"
"TTTCATGCACTACAGT"	"IC-A1"
"TTTCATGCAGACCTGC"	"PT_2"
"TTTCATGCAGCCTACG"	"iPT"
"TTTCATGGTACTCAAC"	"PT_2"
"TTTCCTCAGGCAGTCA"	"TAL_2"
"TTTCCTCAGTGTGTTC"	"TAL_1"
"TTTCCTCCATCACGGC"	"PT_1"
"TTTCCTCTCACCTTGC"	"PT_1"
"TTTCCTCTCAGCATTG"	"PT_1"
"TTTCCTCTCGAGATAA"	"PT_1"
"TTTCCTCTCGTCGATA"	"DCT"
"TTTGACTAGGGCGAAG"	"TAL_2"
"TTTGACTTCCGATGTA"	"POD"
"TTTGATCAGATCCCAT"	"TAL_1"
"TTTGATCCACGCCAGT"	"TAL_2"
"TTTGATCCATAGGTTC"	"TAL_2"
"TTTGATCGTATGGTTC"	"iPT"
"TTTGGAGAGACGGATC"	"CNT"
"TTTGGAGCAGAATTCC"	"EC_2"
"TTTGGAGCAGAGTCTT"	"EC_1"
"TTTGGAGCATACTTTC"	"EC_1"
"TTTGGAGGTAGAGCTG"	"DCT"
"TTTGGAGGTGCATGAG"	"TAL_1"
"TTTGGAGTCGCAACAT"	"PT_2"
"TTTGGTTCAATAGAGT"	"TAL_1"
"TTTGGTTCAGAAGCTG"	"TAL_3"
"TTTGGTTGTCTCGACG"	"EC_1"
"TTTGGTTGTCTGTCAA"	"POD"
"TTTGGTTGTCTGTTAG"	"CNT"
"TTTGGTTTCTGCCTGT"	"CNT"
"TTTGTTGAGACGCTCC"	"PT_2"
"TTTGTTGGTAACATCC"	"TAL_1"
"TTTGTTGGTAAGGCTG"	"TAL_1"
"TTTGTTGTCAAGAGTA"	"DCT"
