""	"Ident"
"AAACCCATCATTCCTA"	"TPC_2"
"AAACGCTAGAGCAGTC"	"TPC_1:LowCov"
"AAACGCTTCCTCGATC"	"TPC_2"
"AAAGAACTCCACATAG"	"DCT-like_1"
"AAAGGATAGGTAGTCG"	"DCT-like_1"
"AAAGGGCCACCGTCTT"	"DCT-like_1"
"AAAGGTACAATGCAGG"	"TPC_1:LowCov"
"AAAGTCCTCAGGAACG"	"DCT-like_1"
"AACAACCCATTGCTTT"	"TPC_2"
"AACACACTCCGTATGA"	"TPC_2"
"AACCAACGTAGATTAG"	"DCT-like_1"
"AACCACAAGGTGAGCT"	"TPC_1:LowCov"
"AACCATGAGGTCTTTG"	"TPC_1:LowCov"
"AACCTGAAGTCAGCCC"	"TPC_1:LowCov"
"AACCTGAGTTATGGTC"	"TPC_1:LowCov"
"AACTTCTCAGAGGTAC"	"TPC_2"
"AAGATAGCATCGCTGG"	"DCT-like_1"
"AAGCATCGTGCTCTTC"	"DCT-like_1"
"AAGCCATGTATGGTTC"	"TPC_1:LowCov"
"AAGCGAGTCCGGTTCT"	"DCT-like_1"
"AAGTACCAGATGACAT"	"TPC_1:LowCov"
"AAGTGAAAGGATCATA"	"TPC_1:LowCov"
"AAGTTCGAGGCGACAT"	"TPC_1:LowCov"
"AAGTTCGAGTCGAGGT"	"TPC_2"
"AATCGACGTTTCGTTT"	"TPC_1:LowCov"
"AATGACCAGGGTACAC"	"TPC_2"
"AATGGAAGTGTTGAGG"	"DCT-like_1"
"AATTCCTCATACTTTC"	"TPC_1:LowCov"
"AATTTCCTCATCGCTC"	"TPC_2"
"AATTTCCTCCGGCAGT"	"TPC_2"
"ACAACCAGTAACTTCG"	"DCT-like_1"
"ACAAGCTAGAGCATCG"	"TPC_1:LowCov"
"ACAAGCTAGGAGATAG"	"TPC_1:LowCov"
"ACACAGTCATATGGCT"	"DCT-like_1"
"ACACAGTTCTAATTCC"	"DCT-like_1"
"ACATCCCAGACGAAGA"	"TPC_1:LowCov"
"ACATGCACAACGGGTA"	"TPC_2"
"ACCAACAAGGCTCTCG"	"DCT-like_1"
"ACCAACACAATGTTGC"	"DCT-like_1"
"ACCATTTAGGACTATA"	"DCT-like_1"
"ACCATTTAGTTGTAAG"	"DCT-like_1"
"ACCATTTCAATGCAGG"	"DCT-like_1"
"ACCATTTGTTCCAAAC"	"DCT-like_1"
"ACCCTCACAGCTCGGT"	"DCT-like_1"
"ACCCTCACATGTGTCA"	"TPC_2"
"ACCCTTGTCACTCGAA"	"TPC_1:LowCov"
"ACCGTTCCAAAGCTAA"	"TPC_1:LowCov"
"ACCGTTCGTATCGCTA"	"DCT-like_1"
"ACCTACCCAAGGCGTA"	"DCT-like_1"
"ACCTGTCTCACGAACT"	"DCT-like_2"
"ACGATCACAGGAGACT"	"TPC_2"
"ACGATCAGTTGTCTAG"	"TPC_2"
"ACGATCATCACGAGGA"	"TPC_2"
"ACGATGTAGCCAGTAG"	"DCT-like_1"
"ACGGAAGGTACTCCGG"	"TPC_1:LowCov"
"ACGGTCGTCCGCACGA"	"DCT-like_1"
"ACGGTCGTCGATGCTA"	"DCT-like_1"
"ACGGTTAGTAACTTCG"	"TPC_2"
"ACGGTTAGTGCCGTTG"	"TPC_1:LowCov"
"ACGTAACTCACCCATC"	"TPC_1:LowCov"
"ACGTCCTGTGTTTGCA"	"TPC_1:LowCov"
"ACGTTCCCACAGTGTT"	"TPC_1:LowCov"
"ACTATGGCACATCCCT"	"TPC_1:LowCov"
"ACTATTCAGATAGTCA"	"TPC_1:LowCov"
"ACTATTCTCACGATAC"	"DCT-like_1"
"ACTGCAAAGGTCCGAA"	"TPC_1:LowCov"
"ACTGTGAGTAATACCC"	"TPC_1:LowCov"
"ACTTAGGGTAGAGACC"	"DCT-like_1"
"ACTTAGGGTATCTCTT"	"DCT-like_1"
"ACTTATCCATACCGTA"	"TPC_2"
"ACTTTCACAAAGAGTT"	"DCT-like_1"
"ACTTTGTAGTCCGTCG"	"DCT-like_1"
"ACTTTGTGTTAATCGC"	"DCT-like_2"
"ACTTTGTGTTCTTAGG"	"DCT-like_1"
"ACTTTGTGTTTCGACA"	"DCT-like_1"
"AGAACAAGTTGCCGCA"	"DCT-like_1"
"AGAACCTGTTGCGTAT"	"TPC_1:LowCov"
"AGAACCTTCACTGCTC"	"TPC_2"
"AGAAGCGGTCACAGAG"	"TPC_1:LowCov"
"AGACACTCACTGATTG"	"DCT-like_1"
"AGACAGGAGCCTCACG"	"TPC_1:LowCov"
"AGACAGGCACCAGTAT"	"TPC_1:LowCov"
"AGACTCAGTCCGGTCA"	"TPC_2"
"AGACTCAGTTCCCAAA"	"TPC_2"
"AGAGCCCGTACGTGAG"	"DCT-like_1"
"AGAGCCCGTGAGCTCC"	"TPC_2"
"AGATAGACAACGGTAG"	"TPC_1:LowCov"
"AGATAGAGTCCTCCAT"	"TPC_1:LowCov"
"AGATCGTAGTAGTCAA"	"DCT-like_1"
"AGATCGTTCCCTAGGG"	"TPC_1:LowCov"
"AGCATCAAGACATCCT"	"DCT-like_1"
"AGCCACGAGGTTCAGG"	"TPC_2"
"AGCCACGGTTCGATTG"	"DCT-like_1"
"AGCCAGCAGCTGAGCA"	"TPC_1:LowCov"
"AGCGCTGCACTCTCGT"	"DCT-like_1"
"AGCGTCGCAGGCACTC"	"DCT-like_1"
"AGGAAATGTATGTCAC"	"TPC_2"
"AGGACGAAGCTGTACT"	"TPC_1:LowCov"
"AGGAGGTGTGCTGCAC"	"DCT-like_2"
"AGGAGGTTCCCTCTTT"	"DCT-like_1"
"AGGCATTGTTATTCCT"	"TPC_1:LowCov"
"AGGCTGCCAAAGCAAT"	"TPC_2"
"AGGGAGTGTACTCGTA"	"DCT-like_1"
"AGGGCCTGTAGGGTAC"	"DCT-like_1"
"AGGGTTTCAGGACATG"	"DCT-like_1"
"AGGTCTACAATTGCTG"	"TPC_2"
"AGGTCTACAGTAGTTC"	"TPC_1:LowCov"
"AGGTTACGTCGTACTA"	"DCT-like_1"
"AGTACCAAGTTGCGCC"	"DCT-like_1"
"AGTAGTCTCCTACAAG"	"TPC_2"
"AGTCAACGTTTGAACC"	"TPC_1:LowCov"
"AGTCATGTCGGACTGC"	"TPC_1:LowCov"
"AGTCTCCTCATACGAC"	"TPC_1:LowCov"
"AGTGACTAGAGAGCGG"	"TPC_1:LowCov"
"AGTGACTCAGCGACCT"	"DCT-like_1"
"AGTGTTGCATCGAAGG"	"DCT-like_1"
"AGTTAGCCACCGTCGA"	"TPC_2"
"AGTTCCCGTTCTGACA"	"TPC_1:LowCov"
"AGTTCGAAGCCTATCA"	"DCT-like_1"
"AGTTCGATCTCATGGA"	"TPC_1:LowCov"
"ATAGACCAGCCGGAAT"	"TPC_1:LowCov"
"ATAGACCCATCACCAA"	"TPC_2"
"ATAGGCTAGCACTCCG"	"TPC_1:LowCov"
"ATAGGCTGTGACAACG"	"TPC_1:LowCov"
"ATCACGACATCGCTAA"	"TPC_1:LowCov"
"ATCAGGTTCCTACTGC"	"TPC_1:LowCov"
"ATCCACCGTACGGTTT"	"TPC_1:LowCov"
"ATCCACCTCGTTGCCT"	"TPC_1:LowCov"
"ATCCATTTCACCACAA"	"DCT-like_1"
"ATCCCTGTCATGAGAA"	"TPC_2"
"ATCCGTCTCACGGGCT"	"TPC_1:LowCov"
"ATCCGTCTCATAAGGA"	"DCT-like_1"
"ATCGGCGTCAGATGCT"	"TPC_2"
"ATCGTAGAGGCCGCTT"	"TPC_1:LowCov"
"ATCGTAGGTCCACATA"	"DCT-like_1"
"ATCGTAGGTGTCATTG"	"DCT-like_1"
"ATCGTAGGTTGCAAGG"	"TPC_2"
"ATCTCTAGTGCGGATA"	"DCT-like_1"
"ATCTCTAGTTCTTAGG"	"TPC_1:LowCov"
"ATGAAAGAGCTGGCCT"	"TPC_1:LowCov"
"ATGAAAGCAGTGTGGA"	"DCT-like_1"
"ATGAAAGGTCGTGTTA"	"TPC_1:LowCov"
"ATGACCATCTGTTGGA"	"TPC_1:LowCov"
"ATGAGGGAGAGGTCAC"	"TPC_2"
"ATGAGTCAGTCTGCAT"	"DCT-like_1"
"ATGAGTCGTTTACTGG"	"TPC_1:LowCov"
"ATGAGTCTCCTTATCA"	"TPC_2"
"ATGAGTCTCTGTTCAT"	"TPC_1:LowCov"
"ATGCCTCTCCACTTCG"	"DCT-like_1"
"ATGGAGGAGTGGTTCT"	"DCT-like_1"
"ATGGATCAGCACCTGC"	"DCT-like_1"
"ATGGGTTAGAGAACCC"	"DCT-like_1"
"ATGTCCCAGCACCAGA"	"TPC_1:LowCov"
"ATGTCTTAGTCGGCCT"	"TPC_1:LowCov"
"ATGTCTTGTCAGTCTA"	"TPC_1:LowCov"
"ATTACCTGTTGACTAC"	"DCT-like_1"
"ATTATCCCAACCCTCT"	"TPC_1:LowCov"
"ATTCACTTCATCGTAG"	"DCT-like_1"
"ATTCACTTCTCATTAC"	"TPC_2"
"ATTCATCAGACTCCGC"	"TPC_2"
"ATTCATCTCGTCACCT"	"DCT-like_1"
"ATTCCATAGGAACGCT"	"DCT-like_1"
"ATTCCATTCGCTACAA"	"TPC_1:LowCov"
"ATTCCATTCGGTCATA"	"DCT-like_1"
"ATTCCCGTCTAGGCCG"	"TPC_2"
"ATTCCTAAGATCGGTG"	"DCT-like_1"
"ATTCCTACAACTCGAT"	"TPC_2"
"ATTCCTAGTCCTACGG"	"TPC_1:LowCov"
"ATTCGTTAGGGTATAT"	"DCT-like_1"
"ATTCGTTGTAGTCGGA"	"TPC_2"
"ATTCGTTGTCACGCTG"	"DCT-like_1"
"ATTGGGTCAAAGGCAC"	"TPC_2"
"ATTGTTCCAGAACGCA"	"TPC_2"
"ATTGTTCTCACCTCAC"	"TPC_2"
"ATTTACCAGCTCTTCC"	"TPC_2"
"ATTTCACGTACGATGG"	"DCT-like_1"
"ATTTCACTCGCCACTT"	"TPC_2"
"ATTTCTGAGACTAGAT"	"DCT-like_1"
"CAAAGAAGTCTAACGT"	"DCT-like_1"
"CAACAGTGTGAGATAT"	"TPC_1:LowCov"
"CAACCTCAGCTGTACT"	"TPC_2"
"CAACGGCAGCGTGAGT"	"DCT-like_1"
"CAAGAGGAGCCAAGTG"	"TPC_2"
"CAATACGCAAGCCCAC"	"TPC_1:LowCov"
"CAATGACTCTAGTGAC"	"TPC_1:LowCov"
"CAATTTCTCGGCTGTG"	"DCT-like_1"
"CACAACACAGGCATTT"	"TPC_2"
"CACAACACATACATCG"	"DCT-like_1"
"CACAGGCTCCACTTTA"	"TPC_1:LowCov"
"CACATGATCCGATCTC"	"TPC_2"
"CACCGTTAGCAGGGAG"	"TPC_2"
"CACGGGTAGACAGCTG"	"TPC_2"
"CACGTGGTCTGAGATC"	"TPC_2"
"CACTAAGAGAGGCGGA"	"TPC_1:LowCov"
"CACTAAGCAAATGATG"	"TPC_1:LowCov"
"CACTGAAGTTAGGGTG"	"DCT-like_1"
"CACTGAATCGTTCTCG"	"DCT-like_1"
"CACTGGGCATCTGGGC"	"DCT-like_2"
"CACTGTCCATGGCCCA"	"DCT-like_1"
"CACTGTCTCCGAGATT"	"DCT-like_1"
"CACTTCGTCCTCTAAT"	"TPC_2"
"CAGAGCCCAAGCGATG"	"DCT-like_1"
"CAGATACAGTTGCGAG"	"TPC_2"
"CAGATCAAGTTAACAG"	"TPC_2"
"CAGATTGAGAGTACCG"	"DCT-like_1"
"CAGCAATTCTCCTGAC"	"TPC_2"
"CAGCAGCCAAGTTGGG"	"DCT-like_1"
"CAGCAGCCATCATCCC"	"TPC_1:LowCov"
"CAGCAGCTCTAAGAAG"	"TPC_2"
"CAGGGCTCAAACGTGG"	"TPC_2"
"CATAGACAGCCGAACA"	"DCT-like_1"
"CATCCACAGAAACTCA"	"TPC_1:LowCov"
"CATCCACAGCCTCTTC"	"TPC_1:LowCov"
"CATCCACGTAACGATA"	"TPC_2"
"CATCCCATCATTGCGA"	"TPC_1:LowCov"
"CATCCGTAGGGAGATA"	"DCT-like_1"
"CATCGCTCACATGACT"	"TPC_1:LowCov"
"CATGAGTAGTAGCAAT"	"DCT-like_1"
"CATGAGTCAAGCGAGT"	"DCT-like_1"
"CATGCAAGTACGTACT"	"TPC_1:LowCov"
"CATGCCTGTGACTCGC"	"DCT-like_1"
"CATGGATCAGCGCGTT"	"DCT-like_1"
"CATTCATGTCTATGAC"	"DCT-like_1"
"CATTCCGGTACTAGCT"	"DCT-like_1"
"CATTCTAGTCTCAGAT"	"TPC_1:LowCov"
"CATTGTTCAAGTACCT"	"DCT-like_1"
"CATTGTTCAATCGCAT"	"TPC_1:LowCov"
"CATTGTTCAATGTGGG"	"TPC_1:LowCov"
"CATTTCAAGATTAGAC"	"DCT-like_1"
"CCAATTTCACAAACGG"	"DCT-like_1"
"CCACAAAGTAGCTCGC"	"TPC_2"
"CCACACTAGCAAATCA"	"DCT-like_1"
"CCACACTCATCTTCGC"	"TPC_2"
"CCACACTTCTTGGTGA"	"DCT-like_1"
"CCACCATTCCGCTAGG"	"DCT-like_1"
"CCACGAGAGTGTACAA"	"DCT-like_1"
"CCACTTGCAAAGGCAC"	"TPC_1:LowCov"
"CCATAAGAGTCTACCA"	"TPC_2"
"CCATAAGCAAACGGCA"	"DCT-like_1"
"CCATAAGCACATCCCT"	"TPC_1:LowCov"
"CCATAAGTCCACGTAA"	"TPC_2"
"CCATAAGTCGCTACGG"	"DCT-like_1"
"CCATCACAGTTCTCTT"	"TPC_1:LowCov"
"CCCATTGAGCAAGGAA"	"DCT-like_1"
"CCCGGAACAGTTACCA"	"TPC_1:LowCov"
"CCCTAACTCCGCAAAT"	"TPC_1:LowCov"
"CCCTCAAAGTTGCATC"	"TPC_2"
"CCCTCTCCACAGCATT"	"DCT-like_1"
"CCCTGATCATTGAGCT"	"DCT-like_1"
"CCCTTAGTCCCGAAAT"	"TPC_2"
"CCGAACGTCTGCCTCA"	"TPC_1:LowCov"
"CCGATCTAGCACTAGG"	"DCT-like_1"
"CCGATCTTCCCATAGA"	"TPC_1:LowCov"
"CCGATGGGTCGCGTCA"	"TPC_2"
"CCGATGGGTTGTGCAT"	"DCT-like_1"
"CCGATGGTCGTGCATA"	"TPC_1:LowCov"
"CCGATGGTCGTGCATG"	"TPC_1:LowCov"
"CCGCAAGCACCGGTCA"	"TPC_2"
"CCGGACACAGGGCTTC"	"TPC_1:LowCov"
"CCGGTAGGTGGTAATA"	"TPC_1:LowCov"
"CCGGTGAGTCCAAGAG"	"DCT-like_1"
"CCGGTGATCCTACAAG"	"TPC_1:LowCov"
"CCGGTGATCGTGGGAA"	"DCT-like_2"
"CCTAAGACATTGTCGA"	"DCT-like_1"
"CCTATCGTCGCGTTTC"	"TPC_2"
"CCTCAACCACCCGTAG"	"DCT-like_1"
"CCTCAACTCGACGACC"	"TPC_1:LowCov"
"CCTCACAGTGATGTAA"	"TPC_1:LowCov"
"CCTCAGTGTCTGTAAC"	"TPC_1:LowCov"
"CCTCCTCCAACCCTAA"	"TPC_1:LowCov"
"CCTCCTCCAGCGACCT"	"TPC_1:LowCov"
"CCTCCTCGTACGTACT"	"TPC_1:LowCov"
"CCTCTCCTCGAACTCA"	"TPC_1:LowCov"
"CCTTCAGCAGCATCTA"	"TPC_1:LowCov"
"CCTTGTGGTTACGTAC"	"DCT-like_1"
"CCTTTGGAGGGCCCTT"	"TPC_1:LowCov"
"CCTTTGGGTTCAAGGG"	"TPC_1:LowCov"
"CGAAGTTAGCCGTAAG"	"TPC_1:LowCov"
"CGAAGTTCACTTTATC"	"TPC_1:LowCov"
"CGAATTGTCCAACCAA"	"DCT-like_1"
"CGAGAAGAGAGAGGGC"	"TPC_1:LowCov"
"CGAGTGCAGTGGAATT"	"DCT-like_1"
"CGAGTGCTCGTAATGC"	"DCT-like_1"
"CGATGCGCAACTGTGT"	"DCT-like_1"
"CGATGGCCAATTTCCT"	"DCT-like_1"
"CGCAGGTGTGTCGCTG"	"TPC_1:LowCov"
"CGCAGGTTCAGTCAGT"	"DCT-like_1"
"CGCATGGAGCAATAAC"	"TPC_1:LowCov"
"CGCATGGTCAAATGCC"	"TPC_2"
"CGGAACCAGGATGGCT"	"TPC_1:LowCov"
"CGGAATTGTTTACCAG"	"DCT-like_1"
"CGGAATTTCCTGGTCT"	"TPC_1:LowCov"
"CGGAGAACATGACGTT"	"DCT-like_1"
"CGGCAGTAGCCATTTG"	"TPC_2"
"CGGGTCACATGGTACT"	"DCT-like_1"
"CGGTCAGTCCGCACGA"	"TPC_1:LowCov"
"CGTAATGTCGTTCCTG"	"DCT-like_1"
"CGTCAAAAGAACCCGA"	"TPC_1:LowCov"
"CGTCAAAAGCCGTCGT"	"TPC_2"
"CGTCCATCAGGCAATG"	"TPC_2"
"CGTCCATGTCAATCTG"	"TPC_1:LowCov"
"CGTGATATCAGAGCAG"	"DCT-like_1"
"CGTGTCTCAGTATACC"	"TPC_2"
"CGTGTCTGTGTTGACT"	"TPC_2"
"CGTTCTGCATCTAGAC"	"DCT-like_1"
"CGTTCTGTCAGCTCTC"	"DCT-like_1"
"CGTTGGGCATGTAACC"	"TPC_1:LowCov"
"CGTTGGGGTCAAAGCG"	"TPC_1:LowCov"
"CTAACTTAGGAAAGGT"	"DCT-like_1"
"CTAACTTCACTACCCT"	"DCT-like_1"
"CTAACTTTCCTCACTG"	"TPC_2"
"CTAAGTGAGTGCTCGC"	"TPC_1:LowCov"
"CTACATTTCCTAGCTC"	"TPC_1:LowCov"
"CTACCCAAGCGACCCT"	"TPC_1:LowCov"
"CTACCCACACTGGCCA"	"DCT-like_1"
"CTACCTGCAATCGTCA"	"DCT-like_1"
"CTACCTGGTGATTCAC"	"TPC_1:LowCov"
"CTACTATAGCAACAAT"	"TPC_2"
"CTACTATGTCATATGC"	"DCT-like_1"
"CTATCCGGTCAAGGCA"	"DCT-like_1"
"CTATCCGTCACCGGTG"	"TPC_1:LowCov"
"CTCAATTAGCACACAG"	"TPC_2"
"CTCAATTGTCTCCCTA"	"TPC_1:LowCov"
"CTCACTGCAGCGGTTC"	"DCT-like_1"
"CTCACTGCAGGACGAT"	"TPC_2"
"CTCACTGGTCAGTCCG"	"DCT-like_1"
"CTCAGAAAGAAGTCAT"	"DCT-like_1"
"CTCAGTCGTTTCTTAC"	"DCT-like_1"
"CTCATGCTCAAGTGGG"	"TPC_1:LowCov"
"CTCATTACATAATGAG"	"DCT-like_1"
"CTCATTATCTACACTT"	"TPC_1:LowCov"
"CTCCAACCAGTGCCTG"	"TPC_2"
"CTCCACACATCAGCTA"	"DCT-like_1"
"CTCCACATCAACACCA"	"TPC_2"
"CTCCCAAGTTGCATCA"	"TPC_1:LowCov"
"CTCCCTCAGCATAGGC"	"TPC_1:LowCov"
"CTCCCTCGTTTCCAAG"	"TPC_1:LowCov"
"CTCCGATTCGGATTAC"	"TPC_2"
"CTCCTCCAGCTACGTT"	"TPC_1:LowCov"
"CTCCTTTCAGATCACT"	"TPC_2"
"CTCCTTTGTTGTTGAC"	"TPC_1:LowCov"
"CTCTCAGGTTCAAACC"	"TPC_1:LowCov"
"CTCTGGTGTGGGACAT"	"TPC_2"
"CTGAATGTCCGATCTC"	"TPC_1:LowCov"
"CTGAGGCCATCATCTT"	"TPC_2"
"CTGAGGCTCTCCTACG"	"TPC_1:LowCov"
"CTGCCATCAAAGACGC"	"TPC_1:LowCov"
"CTGCCATTCACAAGGG"	"TPC_1:LowCov"
"CTGCTCAAGACGGAAA"	"TPC_1:LowCov"
"CTGCTCAAGTGGTTAA"	"TPC_1:LowCov"
"CTGCTCAGTTACCTGA"	"TPC_2"
"CTGGACGCATGGCCCA"	"TPC_2"
"CTGGACGGTGGCGCTT"	"TPC_2"
"CTGGCAGCACATAACC"	"TPC_1:LowCov"
"CTGTAGACAGCAGTTT"	"DCT-like_1"
"CTGTAGATCACTGAAC"	"DCT-like_1"
"CTGTAGATCGGTGTTA"	"TPC_1:LowCov"
"CTGTCGTTCGCTAAAC"	"DCT-like_1"
"CTTACCGCAAGTTTGC"	"TPC_1:LowCov"
"CTTCAATAGTTGTAGA"	"TPC_1:LowCov"
"CTTCAATTCCTATTTG"	"DCT-like_1"
"CTTCAATTCTGCTCTG"	"DCT-like_1"
"CTTCCGAAGACTAGAT"	"DCT-like_1"
"CTTCCGACATACGCAT"	"TPC_2"
"CTTCCTTAGTTCTCTT"	"TPC_2"
"CTTCGGTGTGATATAG"	"DCT-like_1"
"CTTCTCTCAGCCGTCA"	"TPC_1:LowCov"
"CTTCTCTTCCTGTAGA"	"DCT-like_1"
"CTTGAGAAGCCGTCGT"	"DCT-like_1"
"CTTGAGAAGGAGAGGC"	"DCT-like_1"
"CTTGAGATCTTTGATC"	"TPC_2"
"CTTTCAAAGTCTAGAA"	"DCT-like_1"
"CTTTCAAGTGCGGATA"	"TPC_1:LowCov"
"GAACACTCATTGACCA"	"TPC_2"
"GAACACTGTACAAGTA"	"DCT-like_1"
"GAACTGTAGCAATTAG"	"TPC_2"
"GAAGCGAAGTTTGAGA"	"DCT-like_1"
"GAAGGACAGTACTGTC"	"DCT-like_1"
"GAAGGACTCCTCTAAT"	"TPC_1:LowCov"
"GAAGGGTTCTCGTGGG"	"DCT-like_1"
"GAAGTAACATTCACCC"	"DCT-like_1"
"GAATAGAAGACTTGTC"	"TPC_2"
"GAATAGAAGTTGAAAC"	"TPC_2"
"GAATCACGTCGATTTG"	"TPC_1:LowCov"
"GAATCGTAGTGGCGAT"	"DCT-like_1"
"GACACGCGTAACGATA"	"TPC_1:LowCov"
"GACATCATCGAAGAAT"	"DCT-like_1"
"GACCAATAGCGCGTTC"	"TPC_1:LowCov"
"GACCAATGTCTAACGT"	"DCT-like_1"
"GACCAATGTTCTCACC"	"TPC_1:LowCov"
"GACCCAGGTAGTGTGG"	"DCT-like_1"
"GACCCTTGTGAAGCTG"	"TPC_1:LowCov"
"GACCCTTTCTTCTAAC"	"TPC_1:LowCov"
"GACCTTCCAACCAGAG"	"DCT-like_1"
"GACCTTCTCAATCTCT"	"TPC_1:LowCov"
"GACGCTGAGAAACCCG"	"TPC_1:LowCov"
"GACGTTACAGGAACCA"	"TPC_1:LowCov"
"GACTATGCACAGTATC"	"TPC_1:LowCov"
"GACTATGTCTTACGGA"	"DCT-like_1"
"GAGACCCGTCTGTCCT"	"TPC_1:LowCov"
"GAGAGGTAGTATGAAC"	"TPC_2"
"GAGATGGAGACAGCTG"	"DCT-like_1"
"GAGCTGCAGCGGATCA"	"DCT-like_1"
"GAGTCATCAGTCGTTA"	"TPC_2"
"GAGTGAGGTATCGGTT"	"DCT-like_1"
"GAGTTACTCTCACTCG"	"DCT-like_1"
"GAGTTGTCAAGGTACG"	"TPC_1:LowCov"
"GAGTTGTTCCAGGACC"	"DCT-like_1"
"GAGTTTGCAGCAGGAT"	"TPC_1:LowCov"
"GATAGAAGTCATCACA"	"DCT-like_1"
"GATCACAAGGTTCCAT"	"TPC_1:LowCov"
"GATCATGGTGCAATGG"	"TPC_2"
"GATCCCTAGCCATATC"	"TPC_2"
"GATCCCTCATACACCA"	"TPC_1:LowCov"
"GATCCCTGTGACTCTA"	"DCT-like_1"
"GATGAGGTCCCAAGTA"	"DCT-like_1"
"GATGAGGTCGAAGCCC"	"DCT-like_1"
"GATGATCAGACATAAC"	"DCT-like_1"
"GATGCTAAGTCTCGTA"	"DCT-like_1"
"GATGCTAGTGCGCTCA"	"DCT-like_1"
"GATGCTAGTGCTCTTC"	"DCT-like_1"
"GATGGAGCAACCACAT"	"TPC_2"
"GATTCGATCCTCGCAT"	"TPC_1:LowCov"
"GATTCTTCATAAGCAA"	"TPC_2"
"GATTTCTAGTTCCGTA"	"TPC_2"
"GCAACATCAGGTAGTG"	"TPC_1:LowCov"
"GCAACATGTCCGGTCA"	"DCT-like_1"
"GCAACCGTCTCTTGCG"	"DCT-like_1"
"GCACGGTAGCTTAGTC"	"TPC_2"
"GCACGGTCAACCCTAA"	"TPC_1:LowCov"
"GCACGTGAGGTTGGTG"	"TPC_2"
"GCACGTGGTGCTAGCC"	"TPC_2"
"GCACTAACAATCGCGC"	"TPC_1:LowCov"
"GCAGGCTGTAGACAAT"	"DCT-like_1"
"GCATGATCAATAACCC"	"TPC_2"
"GCCAGCAGTTGGTGTT"	"TPC_1:LowCov"
"GCCAGCATCTCTTCAA"	"TPC_2"
"GCCAGTGCACATCCCT"	"DCT-like_1"
"GCCATTCTCGAGAGAC"	"TPC_1:LowCov"
"GCCCAGAAGCTGTACT"	"TPC_2"
"GCCCAGACAGAATGTA"	"DCT-like_1"
"GCCCAGATCTTGCAAG"	"DCT-like_1"
"GCGAGAAGTGTGATGG"	"DCT-like_1"
"GCGATCGAGAGCTGCA"	"DCT-like_1"
"GCTACAACATATGCGT"	"DCT-like_1"
"GCTACCTGTAATGATG"	"DCT-like_1"
"GCTACCTTCTTCCACG"	"TPC_2"
"GCTCAAAGTCTACGTA"	"TPC_1:LowCov"
"GCTCAAATCAATCAGC"	"DCT-like_2"
"GCTGAATCATGTCAGT"	"TPC_2"
"GCTGCAGGTATCCCAA"	"DCT-like_1"
"GCTTCACCACGATAGG"	"TPC_2"
"GCTTCACGTCTACAGT"	"TPC_1:LowCov"
"GCTTTCGAGACCATTC"	"DCT-like_1"
"GCTTTCGAGGGCTGAT"	"TPC_1:LowCov"
"GGAATCTAGTTCAACC"	"TPC_1:LowCov"
"GGAATGGCACATTCTT"	"DCT-like_1"
"GGAGAACGTCCATAGT"	"DCT-like_1"
"GGAGGATAGCAATTAG"	"DCT-like_1"
"GGAGGATGTAACTTCG"	"TPC_2"
"GGATCTATCGAGTACT"	"DCT-like_1"
"GGCAGTCAGTGCACCC"	"TPC_2"
"GGCGTCATCGGCCCAA"	"DCT-like_1"
"GGCTGTGAGTCCTGCG"	"TPC_1:LowCov"
"GGCTTTCCACGTCGTG"	"TPC_1:LowCov"
"GGCTTTCGTCCACGCA"	"TPC_2"
"GGGAAGTAGGCCGCTT"	"DCT-like_1"
"GGGAAGTCATCCGGTG"	"DCT-like_1"
"GGGAAGTGTTCTAACG"	"TPC_1:LowCov"
"GGGACAAGTGGCCCAT"	"DCT-like_1"
"GGGACCTAGCATTTGC"	"DCT-like_1"
"GGGACCTAGGGAGATA"	"TPC_2"
"GGGACTCTCGTGTGAT"	"TPC_1:LowCov"
"GGGAGATGTTAGCGGA"	"TPC_2"
"GGGAGTAGTACTAAGA"	"TPC_1:LowCov"
"GGGATCCTCATTTGTC"	"TPC_2"
"GGGCGTTCAACAAGTA"	"TPC_2"
"GGGCGTTTCAGAATAG"	"DCT-like_1"
"GGGTATTTCAGCTAGT"	"DCT-like_1"
"GGGTTATTCACGTCCT"	"TPC_2"
"GGTAACTGTGATCATC"	"DCT-like_1"
"GGTAATCTCGTTCCTG"	"DCT-like_1"
"GGTAATCTCTCGTCGT"	"TPC_1:LowCov"
"GGTCACGGTCTAGGTT"	"TPC_1:LowCov"
"GGTCTGGCAAGCACAG"	"TPC_2"
"GGTCTGGCAGCGATTT"	"DCT-like_1"
"GGTGAAGTCTGCCCTA"	"DCT-like_1"
"GGTGATTTCTATCGGA"	"DCT-like_1"
"GGTGGCTAGTGAGTTA"	"TPC_1:LowCov"
"GGTGTCGCACACACGC"	"TPC_2"
"GGTTAACTCGCAGTTA"	"TPC_2"
"GGTTCTCGTCGCTTGG"	"DCT-like_1"
"GGTTGTATCGCAGATT"	"TPC_2"
"GTAACACAGACCAACG"	"DCT-like_1"
"GTAACACTCTGAACGT"	"TPC_2"
"GTAACCACAGCTGTTA"	"TPC_2"
"GTAAGTCAGCTCCACG"	"TPC_2"
"GTAAGTCGTCTTTATC"	"DCT-like_1"
"GTAAGTCTCGCTAAAC"	"DCT-like_1"
"GTAAGTCTCTGTCCCA"	"DCT-like_1"
"GTAATGCAGCACCGTC"	"TPC_2"
"GTACAACGTACCTAGT"	"TPC_2"
"GTACAACTCACCTGTC"	"DCT-like_1"
"GTAGCTAAGGTTCACT"	"TPC_2"
"GTAGCTACAAAGGCAC"	"DCT-like_1"
"GTAGCTATCGCAACAT"	"DCT-like_1"
"GTAGGAGGTAACCCGC"	"TPC_2"
"GTAGGTTGTCCAGTTA"	"DCT-like_1"
"GTAGTACAGAGCGACT"	"TPC_2"
"GTATTGGTCTCGCCTA"	"DCT-like_1"
"GTATTTCCATAGGCGA"	"TPC_2"
"GTATTTCGTTGGGTAG"	"TPC_1:LowCov"
"GTCAAACTCTGTGCGG"	"DCT-like_1"
"GTCACGGTCACCGCTT"	"DCT-like_1"
"GTCACTCCACTTGACA"	"DCT-like_1"
"GTCATCCAGTCACAGG"	"DCT-like_1"
"GTCATGAAGACATCAA"	"TPC_2"
"GTCATTTGTACAACGG"	"DCT-like_1"
"GTCCCATTCTTCCAGC"	"DCT-like_1"
"GTCCTCATCGAGAATA"	"TPC_2"
"GTCGAATGTGTTCCAA"	"TPC_1:LowCov"
"GTCGCGAAGCATCGAG"	"TPC_1:LowCov"
"GTCGCGACAACGATCT"	"TPC_1:LowCov"
"GTCGTAAAGGAACGTC"	"DCT-like_1"
"GTCGTAAAGGATTCCT"	"DCT-like_1"
"GTCGTAAGTACCCGCA"	"TPC_1:LowCov"
"GTCTACCGTATGTCTG"	"TPC_1:LowCov"
"GTCTAGACAGACAAGC"	"DCT-like_1"
"GTCTTTAAGCACGATG"	"TPC_2"
"GTCTTTATCCAATGCA"	"DCT-like_1"
"GTCTTTATCTCGTGAA"	"TPC_1:LowCov"
"GTGAGGAAGATCCAAA"	"DCT-like_1"
"GTGAGTTCACCTAAAC"	"DCT-like_1"
"GTGATGTGTTGATCGT"	"TPC_2"
"GTGCAGCCAGTTAGAA"	"DCT-like_1"
"GTGGAAGTCATTTGTC"	"TPC_1:LowCov"
"GTGGTTATCTAATTCC"	"TPC_1:LowCov"
"GTGTGATGTGTAAATG"	"TPC_1:LowCov"
"GTGTGGCGTGAATTAG"	"TPC_1:LowCov"
"GTGTTAGAGTCAGAGC"	"DCT-like_1"
"GTGTTAGCACGCTGCA"	"TPC_2"
"GTTACCCCATCTCGTC"	"TPC_1:LowCov"
"GTTACCCGTATTTCCT"	"TPC_1:LowCov"
"GTTACGACATCATCCC"	"TPC_1:LowCov"
"GTTAGACCAGCACGAA"	"TPC_2"
"GTTATGGCAATTAGGA"	"TPC_2"
"GTTCATTCACCCAACG"	"TPC_1:LowCov"
"GTTCATTCACGGCCAT"	"TPC_1:LowCov"
"GTTCATTTCCAGCACG"	"TPC_2"
"GTTGAACTCTGAATCG"	"DCT-like_1"
"GTTGCGGGTCATATGC"	"DCT-like_1"
"GTTGTCCCAATATCCG"	"TPC_1:LowCov"
"TAACCAGAGACAAGCC"	"DCT-like_1"
"TAACCAGCAGTCAACT"	"TPC_1:LowCov"
"TAACCAGGTTATGTGC"	"TPC_1:LowCov"
"TAAGCCAAGTGGATTA"	"TPC_1:LowCov"
"TAAGCCACATATCGGT"	"DCT-like_1"
"TAAGTCGTCCATGAGT"	"DCT-like_1"
"TACAACGTCAGAGCAG"	"DCT-like_1"
"TACAGGTAGCAGGGAG"	"DCT-like_1"
"TACAGGTAGTATCCTG"	"DCT-like_1"
"TACAGGTCACTACAGT"	"TPC_2"
"TACATTCCAGTCTCTC"	"TPC_2"
"TACATTCGTCCGGATC"	"DCT-like_1"
"TACCCACAGACTACCT"	"TPC_1:LowCov"
"TACCCACAGGATTTAG"	"TPC_2"
"TACCCGTAGATACAGT"	"DCT-like_1"
"TACCGGGCAATGAACA"	"DCT-like_1"
"TACTTGTAGTGCGACA"	"TPC_1:LowCov"
"TACTTGTCAACCTATG"	"DCT-like_1"
"TAGACCACATTCCTAT"	"DCT-like_1"
"TAGACCATCCTTCTTC"	"TPC_2"
"TAGACTGCAAGCTGCC"	"DCT-like_1"
"TAGCACAGTAGCACAG"	"TPC_2"
"TAGGTTGGTTGCTGAT"	"DCT-like_1"
"TAGTGCACACAATCTG"	"DCT-like_1"
"TAGTGCATCCACGAAT"	"TPC_2"
"TATACCTAGACCAAAT"	"DCT-like_1"
"TATACCTAGCTGTCCG"	"TPC_1:LowCov"
"TATACCTAGTTTCGAC"	"DCT-like_1"
"TATCCTAAGTGAACAT"	"DCT-like_1"
"TATCGCCCACCCTAAA"	"TPC_1:LowCov"
"TATCTTGCATCCGAGC"	"TPC_1:LowCov"
"TATTCCAAGTGGATAT"	"DCT-like_1"
"TATTGCTTCATGGATC"	"TPC_2"
"TATTTCGTCCCTTGGT"	"DCT-like_1"
"TCAAGACAGAGTTCGG"	"TPC_2"
"TCAAGACCATATCGGT"	"TPC_1:LowCov"
"TCAAGACTCCACACCT"	"TPC_2"
"TCAAGCAGTTCCGCAG"	"TPC_1:LowCov"
"TCAAGTGCACCTGCGA"	"DCT-like_1"
"TCAATTCGTGCCCAGT"	"TPC_2"
"TCACAAGAGAAGATCT"	"DCT-like_2"
"TCACGCTAGCACTCGC"	"TPC_1:LowCov"
"TCACGCTCACCGGTCA"	"DCT-like_1"
"TCACTATTCAGCTTGA"	"DCT-like_1"
"TCACTCGGTGGCTTAT"	"TPC_2"
"TCAGCAATCGTTGTAG"	"DCT-like_2"
"TCAGGTAGTAGCGCTC"	"TPC_1:LowCov"
"TCAGGTATCTAAGAAG"	"TPC_1:LowCov"
"TCAGTGACATGAGTAA"	"TPC_1:LowCov"
"TCAGTTTTCATACAGC"	"DCT-like_1"
"TCATGAGCAACGACAG"	"DCT-like_1"
"TCATGAGCATACACCA"	"DCT-like_1"
"TCATGAGGTATTGAGA"	"DCT-like_1"
"TCATGCCAGGTAAGAG"	"DCT-like_1"
"TCATGGACAAGGCAAC"	"DCT-like_2"
"TCATGGACACATCCCT"	"TPC_1:LowCov"
"TCATGTTGTGTTCCTC"	"DCT-like_1"
"TCATTACCAAGGCAAC"	"DCT-like_2"
"TCATTACCATCCGAAT"	"TPC_1:LowCov"
"TCATTCAGTACCACGC"	"TPC_2"
"TCATTCAGTCGTGCCA"	"TPC_1:LowCov"
"TCATTTGCATTCAGGT"	"DCT-like_1"
"TCCATGCAGTTGGACG"	"TPC_2"
"TCCATGCGTTTGATCG"	"TPC_2"
"TCCGAAAAGTAGTCAA"	"TPC_1:LowCov"
"TCCGATCGTTGCTCCT"	"DCT-like_1"
"TCCGTGTCAAAGCTAA"	"TPC_1:LowCov"
"TCCTCCCAGCTGACCC"	"TPC_2"
"TCCTCCCTCTCCGTGT"	"TPC_1:LowCov"
"TCCTCGAAGCACTCAT"	"DCT-like_1"
"TCCTGCATCCTCATAT"	"TPC_1:LowCov"
"TCCTGCATCTGCCTCA"	"DCT-like_1"
"TCCTTTCTCTGGAGAG"	"TPC_1:LowCov"
"TCGAACACAAGTCGTT"	"TPC_1:LowCov"
"TCGAACACAGAGTCAG"	"TPC_2"
"TCGAAGTGTAGCTTTG"	"TPC_1:LowCov"
"TCGACGGGTTAGGGAC"	"DCT-like_1"
"TCGCACTTCAGACAAA"	"TPC_2"
"TCGCTCAAGGCTCACC"	"DCT-like_1"
"TCGCTTGTCTAAGGAA"	"TPC_2"
"TCGGATAAGCTCCGAC"	"DCT-like_1"
"TCGGATACAGATACTC"	"TPC_1:LowCov"
"TCGGGACGTGCCTACG"	"DCT-like_1"
"TCGGGCACATAGATGA"	"TPC_1:LowCov"
"TCGGGTGTCCCAATAG"	"DCT-like_1"
"TCGGTCTGTTCGATTG"	"TPC_1:LowCov"
"TCGTAGATCGGTGTAT"	"TPC_1:LowCov"
"TCGTCCAAGTAGCTCT"	"TPC_1:LowCov"
"TCTAACTCAATTGGTC"	"TPC_1:LowCov"
"TCTAACTCAGCCGGTT"	"TPC_2"
"TCTAACTTCGCCTTTG"	"TPC_1:LowCov"
"TCTACATAGAAACCAT"	"DCT-like_1"
"TCTACCGAGGGCCAAT"	"DCT-like_1"
"TCTACCGTCACCGGTG"	"TPC_2"
"TCTATACAGTACCATC"	"DCT-like_1"
"TCTCTGGTCAAGTGTC"	"TPC_2"
"TCTGCCACAACGATCT"	"TPC_2"
"TCTGCCATCGTTCATT"	"DCT-like_1"
"TCTGGCTGTAGGTTTC"	"TPC_1:LowCov"
"TCTGTCGGTACTGTTG"	"DCT-like_1"
"TCTTCCTAGAGAGTTT"	"TPC_1:LowCov"
"TCTTCCTAGCTTCATG"	"TPC_1:LowCov"
"TCTTCCTGTGTGATGG"	"DCT-like_1"
"TCTTGCGAGGTACAGC"	"TPC_2"
"TCTTTGATCCAAGCTA"	"DCT-like_1"
"TGAACGTAGAATCTAG"	"TPC_1:LowCov"
"TGAATCGCAGATAAAC"	"DCT-like_1"
"TGACCCTGTCAGACGA"	"TPC_1:LowCov"
"TGACGCGTCTTCGATT"	"DCT-like_1"
"TGACTCCGTTCGAGCC"	"DCT-like_1"
"TGAGACTTCAACCTCC"	"DCT-like_1"
"TGAGCATCAATCGCGC"	"TPC_2"
"TGAGCATGTCGATTTG"	"TPC_1:LowCov"
"TGAGCGCCAGAGGTAC"	"DCT-like_1"
"TGAGCGCTCGTTCCTG"	"DCT-like_1"
"TGAGGAGAGGACTAAT"	"DCT-like_1"
"TGAGGGAGTGGAAGTC"	"DCT-like_2"
"TGAGGTTGTGCAATAA"	"DCT-like_1"
"TGATGGTTCTCTGCCA"	"TPC_1:LowCov"
"TGATTCTGTGAGGCAT"	"TPC_2"
"TGATTTCCAAACGGCA"	"DCT-like_1"
"TGCATCCTCCTGGGAC"	"TPC_1:LowCov"
"TGCCGAGTCTCCAATT"	"DCT-like_1"
"TGCGACGCATGGCACC"	"TPC_1:LowCov"
"TGCTCGTCAGTATGAA"	"TPC_1:LowCov"
"TGCTCGTGTCCGGTGT"	"TPC_1:LowCov"
"TGCTGAACACTACACA"	"TPC_1:LowCov"
"TGGAACTTCAGACTGT"	"DCT-like_1"
"TGGAGGAGTTGCGGCT"	"TPC_1:LowCov"
"TGGGAGAAGCCGCACT"	"TPC_1:LowCov"
"TGGGAGAGTCGGTAAG"	"TPC_2"
"TGGGAGATCGCGATCG"	"TPC_2"
"TGGGCGTCAAACGTGG"	"TPC_2"
"TGGGCTGCAGCACCCA"	"TPC_2"
"TGGGCTGGTACCTGTA"	"DCT-like_1"
"TGGGCTGGTTCCCACT"	"TPC_2"
"TGGGCTGTCATTCACT"	"DCT-like_1"
"TGGTAGTCATACTGTG"	"TPC_1:LowCov"
"TGGTGATGTCACGACC"	"DCT-like_1"
"TGGTGATTCCAACACA"	"TPC_1:LowCov"
"TGTAACGGTCCACAGC"	"TPC_1:LowCov"
"TGTAAGCTCAGCAGAG"	"DCT-like_1"
"TGTACAGCAGTCCGTG"	"TPC_1:LowCov"
"TGTCCTGCAGCGTTGC"	"TPC_2"
"TGTGCGGCAAGGACAC"	"DCT-like_1"
"TGTGCGGGTGACATCT"	"TPC_1:LowCov"
"TGTGGCGGTCTAGGCC"	"TPC_2"
"TGTGGCGTCCGTTGAA"	"DCT-like_1"
"TGTGTGATCATCGCAA"	"TPC_1:LowCov"
"TGTTACTGTTCTCCTG"	"TPC_1:LowCov"
"TGTTACTTCTCACCCA"	"DCT-like_1"
"TGTTACTTCTTAGCCC"	"TPC_1:LowCov"
"TGTTCATTCGTTGTTT"	"TPC_1:LowCov"
"TGTTCCGCACATGGTT"	"TPC_2"
"TGTTCTAAGCCTGGAA"	"TPC_1:LowCov"
"TGTTTGTAGTCCCGGT"	"TPC_1:LowCov"
"TTAATCCAGGAATTAC"	"TPC_1:LowCov"
"TTAATCCGTCGGTACC"	"TPC_2"
"TTACAGGTCCTATTTG"	"TPC_2"
"TTACCATCAAGACCTT"	"DCT-like_1"
"TTACCATCAGTCTCTC"	"TPC_2"
"TTACCATTCCAACTGA"	"DCT-like_1"
"TTACCGCCAGCCATTA"	"TPC_2"
"TTACCGCTCGAGCTGC"	"TPC_1:LowCov"
"TTACGCCTCAACCTTT"	"TPC_2"
"TTACGCCTCAGGAAAT"	"TPC_2"
"TTACGTTGTCAAAGAT"	"TPC_2"
"TTACTGTAGCGAAACC"	"DCT-like_1"
"TTACTGTTCCGGCAGT"	"TPC_2"
"TTAGTCTCAGAGTAAT"	"TPC_1:LowCov"
"TTATTGCCATGACCCG"	"TPC_1:LowCov"
"TTCACCGGTAGCGTCC"	"TPC_1:LowCov"
"TTCACGCGTGGTCTGC"	"DCT-like_1"
"TTCACGCTCTTCCTAA"	"DCT-like_1"
"TTCAGGACAACCGATT"	"TPC_1:LowCov"
"TTCAGGAGTAACATAG"	"TPC_2"
"TTCATGTCAAGTGATA"	"DCT-like_1"
"TTCATTGCATTCTGTT"	"TPC_2"
"TTCATTGGTGTTGACT"	"DCT-like_1"
"TTCCACGTCCCGTAAA"	"TPC_1:LowCov"
"TTCCGGTAGCATCCTA"	"DCT-like_1"
"TTCCGTGCAGGAGGTT"	"DCT-like_1"
"TTCCTTCTCAACCGAT"	"TPC_2"
"TTCGGTCCAGACACCC"	"TPC_1:LowCov"
"TTCGGTCCAGCCTATA"	"DCT-like_1"
"TTCTAACGTGGGTCAA"	"TPC_1:LowCov"
"TTCTCTCAGCGCACAA"	"TPC_2"
"TTCTCTCGTTCTCTCG"	"TPC_1:LowCov"
"TTCTCTCTCTTGGAAC"	"TPC_1:LowCov"
"TTCTTCCGTTCCCAAA"	"DCT-like_1"
"TTCTTCCTCTTACCAT"	"TPC_1:LowCov"
"TTGAACGCACTTCAGA"	"TPC_2"
"TTGAGTGCACTTCCTG"	"TPC_1:LowCov"
"TTGATGGAGGCCCGTT"	"DCT-like_1"
"TTGCTGCAGCCGTCGT"	"TPC_2"
"TTGGATGCAAGCACAG"	"DCT-like_1"
"TTGGGATCAGGCGTTC"	"TPC_1:LowCov"
"TTGGTTTGTACGACTT"	"DCT-like_1"
"TTGTTCAGTTTGGGTT"	"TPC_2"
"TTGTTGTAGTTCAACC"	"TPC_2"
"TTTACCACACGCTGTG"	"DCT-like_1"
"TTTACTGCAGGATGAC"	"DCT-like_1"
"TTTAGTCGTAGTGATA"	"TPC_1:LowCov"
"TTTCGATAGTCGGCAA"	"TPC_1:LowCov"
"TTTGGAGGTTGTTGTG"	"TPC_2"
"TTTGGTTGTTCCTAAG"	"TPC_2"
"TTTGTTGAGTTGCGCC"	"TPC_1:LowCov"
