""	"Ident"
"AAACCTGCAATGGAGC"	"Exclude_highmito"
"AAACCTGCACCAGGCT"	"PT-like_2"
"AAACCTGCAGCATGAG"	"PT-like_2"
"AAACCTGCAGCTGGCT"	"PT-like_1"
"AAACCTGGTAAATACG"	"DCT_2"
"AAACCTGGTAGAAAGG"	"DCT_1"
"AAACGGGAGCAGACTG"	"DCT_2"
"AAACGGGCATGAACCT"	"Proliferating_PT-like"
"AAACGGGGTCATGCAT"	"PT-like_2"
"AAACGGGGTCGGATCC"	"DCT_1"
"AAACGGGTCATCGCTC"	"PT-like_2"
"AAACGGGTCGGTCCGA"	"PT-like_1"
"AAACGGGTCTCAAACG"	"DCT_1"
"AAAGATGGTGCTAGCC"	"PT-like_1"
"AAAGATGTCTGGAGCC"	"DCT_1"
"AAAGCAAAGCTAGCCC"	"Exclude_highmito"
"AAAGCAAAGGGTGTTG"	"TPC"
"AAAGCAACAGTCGTGC"	"DCT_1"
"AAAGCAACATGTCCTC"	"Exclude_highmito"
"AAAGCAACATTTGCTT"	"TPC"
"AAAGCAAGTTGACGTT"	"PT-like_1"
"AAAGTAGAGAAGGTTT"	"DCT_1"
"AAAGTAGCAGACGTAG"	"DCT_2"
"AAAGTAGCATTTGCCC"	"DCT_2"
"AAAGTAGTCATCACCC"	"PT-like_1"
"AAATGCCAGCTTTGGT"	"Exclude_highmito"
"AAATGCCCACCCTATC"	"TPC"
"AAATGCCCAGGGTTAG"	"TPC"
"AAATGCCCATGGAATA"	"Exclude_highribosomal"
"AAATGCCCATGTCGAT"	"PT-like_1"
"AAATGCCGTGCGATAG"	"DCT_1"
"AAATGCCTCCGTAGTA"	"PEC-like_2"
"AACACGTCAGACGCCT"	"DCT_1"
"AACACGTGTGTCTGAT"	"Proliferating_PT-like"
"AACACGTTCCTATGTT"	"DCT_1"
"AACACGTTCCTTCAAT"	"Proliferating_PT-like"
"AACACGTTCTGTCTCG"	"DCT_2"
"AACCATGAGGAGTTGC"	"TPC"
"AACCATGCAGGTGCCT"	"DCT_1"
"AACCATGCATCCGCGA"	"Exclude_highmito"
"AACCATGCATTTCACT"	"PT-like_1"
"AACCATGGTATGAAAC"	"Proliferating_PT-like"
"AACCATGGTCGGCTCA"	"DCT_1"
"AACCATGTCGGAATCT"	"Proliferating_PT-like"
"AACCGCGAGGAGTACC"	"DCT_2"
"AACCGCGCAAGCCTAT"	"PT-like_2"
"AACCGCGCACCACCAG"	"Exclude_highmito"
"AACCGCGTCTGCCAGG"	"PEC-like_1"
"AACGTTGAGTTGTCGT"	"PT-like_1"
"AACGTTGCACGGCTAC"	"PT-like_2"
"AACGTTGCAGTACACT"	"Proliferating_PT-like"
"AACGTTGCATTGGGCC"	"PT-like_2"
"AACTCAGAGAATCTCC"	"Proliferating_PT-like"
"AACTCAGAGATAGCAT"	"PEC-like_1"
"AACTCAGAGCCACGCT"	"Exclude_highmito"
"AACTCAGAGGCTAGGT"	"PEC-like_1"
"AACTCAGGTCTAGCGC"	"PEC-like_1"
"AACTCAGTCCAGAGGA"	"PT-like_1"
"AACTCAGTCCGAATGT"	"PT-like_1"
"AACTCCCAGGGCTCTC"	"PT-like_2"
"AACTCCCCATTAGGCT"	"DCT_2"
"AACTCCCGTGCCTTGG"	"PT-like_2"
"AACTCCCTCAGCTCTC"	"PT-like_1"
"AACTCCCTCGAACGGA"	"DCT_2"
"AACTCCCTCGAGCCCA"	"PT-like_1"
"AACTCTTAGTCGTTTG"	"TPC"
"AACTCTTAGTGGTAAT"	"DCT_2"
"AACTCTTAGTGTTGAA"	"Proliferating_PT-like"
"AACTCTTCAGCTGTTA"	"DCT_1"
"AACTCTTCATGGATGG"	"Exclude_highmito"
"AACTCTTGTATGAAAC"	"DCT_2"
"AACTCTTGTTGATTCG"	"DCT_2"
"AACTCTTTCTTGTTTG"	"Proliferating_PT-like"
"AACTGGTAGACGCACA"	"PEC-like_2"
"AACTGGTAGTGAAGAG"	"DCT_2"
"AACTGGTAGTTGAGAT"	"DCT_2"
"AACTGGTCACGGCCAT"	"PEC-like_1"
"AACTGGTCATTGGTAC"	"DCT_1"
"AACTTTCAGAGCAATT"	"PEC-like_2"
"AACTTTCCACGTAAGG"	"DCT_2"
"AACTTTCCACTGTCGG"	"Proliferating_PT-like"
"AACTTTCCATCACAAC"	"PT-like_1"
"AACTTTCCATCGGGTC"	"PT-like_2"
"AAGACCTAGGAGTTGC"	"Exclude_highmito"
"AAGACCTCAAGGGTCA"	"TPC"
"AAGCCGCAGACAGACC"	"PT-like_2"
"AAGCCGCAGAGAGCTC"	"PT-like_1"
"AAGCCGCAGTGAATTG"	"Exclude_highribosomal"
"AAGCCGCCAATCTGCA"	"DCT_1"
"AAGCCGCGTCCAGTAT"	"Exclude_highribosomal"
"AAGCCGCGTCTCACCT"	"DCT_1"
"AAGCCGCTCGAGCCCA"	"PT-like_2"
"AAGGAGCAGGGAAACA"	"Proliferating_PT-like"
"AAGGAGCCATACTCTT"	"DCT_1"
"AAGGAGCTCGCCATAA"	"Exclude_highmito"
"AAGGCAGAGACGCTTT"	"PT-like_2"
"AAGGCAGAGCATCATC"	"DCT_2"
"AAGGCAGCAAGCGATG"	"PT-like_2"
"AAGGCAGGTCAACTGT"	"PT-like_1"
"AAGGCAGGTCTTCGTC"	"PT-like_1"
"AAGGCAGGTGGACGAT"	"PT-like_1"
"AAGGCAGTCCTTCAAT"	"TPC"
"AAGGCAGTCGCGGATC"	"PT-like_2"
"AAGGTTCAGAGCTTCT"	"TPC"
"AAGGTTCAGGCGACAT"	"DCT_2"
"AAGGTTCCAATGGATA"	"TPC"
"AAGGTTCCATTATCTC"	"PT-like_1"
"AAGGTTCTCACTTCAT"	"Exclude_highribosomal"
"AAGTCTGCAAGGACAC"	"PEC-like_2"
"AAGTCTGCAATGCCAT"	"DCT_1"
"AAGTCTGCAGGCGATA"	"DCT_1"
"AAGTCTGCATCGACGC"	"TPC"
"AAGTCTGGTACCGCTG"	"TPC"
"AAGTCTGGTCGTTGTA"	"PT-like_1"
"AAGTCTGGTTTGACTG"	"DCT_1"
"AAGTCTGTCGAATCCA"	"PT-like_1"
"AATCCAGAGTACGTTC"	"Exclude_highmito"
"AATCCAGCACATCCGG"	"PT-like_2"
"AATCCAGCACATGTGT"	"PT-like_2"
"AATCCAGCAGTAAGCG"	"PT-like_2"
"AATCCAGTCTAACTTC"	"Exclude_highmito"
"AATCGGTAGGGCATGT"	"Proliferating_PT-like"
"AATCGGTCAGCGTCCA"	"DCT_2"
"AATCGGTCATAGACTC"	"Exclude_highmito"
"AATCGGTGTAGGGTAC"	"PT-like_1"
"AATCGGTGTGAGGCTA"	"PT-like_2"
"AATCGGTGTTCTGGTA"	"DCT_1"
"AATCGGTTCACCGGGT"	"PT-like_1"
"ACACCAAAGAATGTGT"	"Exclude_highmito"
"ACACCAAAGGCTATCT"	"DCT_1"
"ACACCAAAGTTGAGAT"	"DCT_2"
"ACACCAACAGGTCTCG"	"DCT_2"
"ACACCAAGTCACTTCC"	"DCT_2"
"ACACCAAGTCTCTTTA"	"PT-like_1"
"ACACCAATCTGGCGTG"	"PT-like_2"
"ACACCAATCTTGTTTG"	"PT-like_1"
"ACACCCTAGAGAACAG"	"TPC"
"ACACCCTAGAGGGATA"	"PT-like_2"
"ACACCCTAGATGTGTA"	"Exclude_highribosomal"
"ACACCCTAGGCGCTCT"	"Exclude_highribosomal"
"ACACCCTAGGTAGCTG"	"DCT_2"
"ACACCCTCAAGTAATG"	"PT-like_2"
"ACACCCTCAGAGTGTG"	"PT-like_1"
"ACACCCTCAGCCTTGG"	"TPC"
"ACACCCTGTAGTACCT"	"DCT_1"
"ACACCCTTCACTTACT"	"DCT_1"
"ACACCCTTCGAGAGCA"	"PEC-like_1"
"ACACCCTTCGCCAAAT"	"DCT_2"
"ACACCCTTCGCTTGTC"	"PT-like_2"
"ACACCCTTCTTTAGTC"	"Exclude_highmito"
"ACACCGGAGCTTATCG"	"DCT_1"
"ACACCGGAGTATCGAA"	"PEC-like_1"
"ACACCGGAGTTCGCGC"	"DCT_1"
"ACACTGAGTTAAGACA"	"Exclude_highmito"
"ACAGCCGAGCTAGTCT"	"TPC"
"ACAGCCGCATATGCTG"	"Proliferating_PT-like"
"ACAGCCGGTACTTAGC"	"Proliferating_PT-like"
"ACAGCCGTCACCACCT"	"Proliferating_PT-like"
"ACAGCCGTCTCGTTTA"	"TPC"
"ACAGCTAAGCGTGAAC"	"PEC-like_1"
"ACAGCTAGTGATAAAC"	"DCT_2"
"ACAGCTAGTTCCACGG"	"Proliferating_PT-like"
"ACAGCTATCTGGTTCC"	"DCT_2"
"ACATACGCAGCCTTGG"	"DCT_1"
"ACATACGGTCAGATAA"	"TPC"
"ACATACGGTGCAACGA"	"TPC"
"ACATACGTCCCTCAGT"	"Exclude_highribosomal"
"ACATACGTCTCGCTTG"	"PT-like_1"
"ACATCAGAGACACTAA"	"PT-like_2"
"ACATCAGTCAACGGCC"	"TPC"
"ACATGGTAGACCCACC"	"PT-like_2"
"ACATGGTAGAGTAAGG"	"PT-like_1"
"ACATGGTAGGAATCGC"	"PT-like_2"
"ACATGGTGTAGCGTGA"	"DCT_2"
"ACATGGTGTGTATGGG"	"PT-like_1"
"ACCAGTACAGACACTT"	"DCT_1"
"ACCAGTAGTTATTCTC"	"TPC"
"ACCAGTATCTGGTGTA"	"Exclude_highmito"
"ACCCACTAGTGTCTCA"	"PT-like_1"
"ACCCACTCAATCCAAC"	"DCT_1"
"ACCCACTTCCACTCCA"	"PT-like_1"
"ACCCACTTCCTGTAGA"	"TPC"
"ACCCACTTCTTGACGA"	"TPC"
"ACCGTAAGTTCCTCCA"	"Exclude_highmito"
"ACCGTAATCGGCGCAT"	"Exclude_highmito"
"ACCGTAATCGTTGACA"	"DCT_1"
"ACCTTTACAAGCTGGA"	"TPC"
"ACCTTTACAGTAAGCG"	"DCT_2"
"ACCTTTACATCAGTAC"	"Proliferating_PT-like"
"ACCTTTAGTCTTGTCC"	"PEC-like_2"
"ACCTTTATCAAACAAG"	"PT-like_1"
"ACCTTTATCAACACTG"	"PT-like_1"
"ACGAGCCAGCACCGTC"	"PT-like_2"
"ACGAGCCAGCCGATTT"	"PT-like_1"
"ACGAGCCCAGGGAGAG"	"DCT_2"
"ACGAGCCGTGAGGGAG"	"TPC"
"ACGAGCCTCAAGAAGT"	"DCT_1"
"ACGAGGAAGCATGGCA"	"TPC"
"ACGAGGAAGCCAGAAC"	"DCT_2"
"ACGAGGAAGGTAAACT"	"TPC"
"ACGAGGATCAAGATCC"	"DCT_1"
"ACGAGGATCACTTATC"	"PT-like_1"
"ACGAGGATCTGATTCT"	"TPC"
"ACGATACAGCAGATCG"	"PT-like_2"
"ACGATACGTACAGACG"	"Proliferating_PT-like"
"ACGATACTCGTAGATC"	"DCT_1"
"ACGATACTCTCTTATG"	"PT-like_2"
"ACGATGTAGGCGCTCT"	"TPC"
"ACGATGTAGGTGCAAC"	"PT-like_2"
"ACGATGTCACCAGGTC"	"DCT_1"
"ACGATGTCACGACTCG"	"DCT_1"
"ACGATGTCATCCGTGG"	"PT-like_1"
"ACGATGTGTCCAACTA"	"Exclude_highmito"
"ACGCAGCAGAGTGAGA"	"PEC-like_1"
"ACGCAGCCAGCCTTTC"	"PEC-like_1"
"ACGCAGCCATCTCCCA"	"PT-like_1"
"ACGCAGCTCCCAACGG"	"PT-like_2"
"ACGCAGCTCGACCAGC"	"PT-like_1"
"ACGCCAGCACCGGAAA"	"Exclude_highribosomal"
"ACGCCAGGTCCCTTGT"	"PEC-like_2"
"ACGCCGAAGATCTGCT"	"Proliferating_PT-like"
"ACGCCGAAGCTCAACT"	"PT-like_1"
"ACGCCGAAGGATGGTC"	"DCT_2"
"ACGCCGAAGGCCCTCA"	"Exclude_highmito"
"ACGCCGAAGGCGCTCT"	"TPC"
"ACGCCGACACGGATAG"	"Exclude_highmito"
"ACGCCGACAGGTCCAC"	"DCT_2"
"ACGCCGATCTCAACTT"	"Exclude_highmito"
"ACGGAGAAGCGATATA"	"TPC"
"ACGGAGAGTCCGAACC"	"DCT_1"
"ACGGAGAGTCGACTAT"	"Exclude_highmito"
"ACGGAGATCTTCGAGA"	"PT-like_1"
"ACGGCCAAGTACGACG"	"PT-like_2"
"ACGGCCAAGTAGGTGC"	"Exclude_highmito"
"ACGGCCACAGACACTT"	"TPC"
"ACGGCCACATAGAAAC"	"PT-like_1"
"ACGGCCAGTAAGTTCC"	"Proliferating_PT-like"
"ACGGCCAGTAATCGTC"	"DCT_2"
"ACGGCCATCCACGAAT"	"DCT_2"
"ACGGGCTCAAAGTCAA"	"PT-like_1"
"ACGGGCTCACCCAGTG"	"DCT_1"
"ACGGGCTGTCACCTAA"	"PT-like_1"
"ACGGGCTGTGACGGTA"	"Exclude_highmito"
"ACGGGCTTCATATCGG"	"TPC"
"ACGGGTCAGGGAAACA"	"DCT_1"
"ACGGGTCCAAAGGTGC"	"Exclude_highmito"
"ACGGGTCGTACCCAAT"	"TPC"
"ACGTCAAAGCTGCGAA"	"Proliferating_PT-like"
"ACGTCAACATGGATGG"	"PT-like_2"
"ACGTCAAGTAGCTAAA"	"TPC"
"ACTATCTAGCTAACAA"	"DCT_2"
"ACTATCTGTCGCGGTT"	"DCT_2"
"ACTATCTTCAAGGCTT"	"DCT_2"
"ACTATCTTCATTATCC"	"Exclude_highmito"
"ACTATCTTCCATTCTA"	"DCT_2"
"ACTGAACAGCTATGCT"	"DCT_1"
"ACTGAACAGCTGTTCA"	"DCT_1"
"ACTGAACAGGTGATTA"	"PEC-like_1"
"ACTGAACCAAGCTGGA"	"Exclude_highmito"
"ACTGAACCACACTGCG"	"PT-like_1"
"ACTGAACCACAGTCGC"	"DCT_1"
"ACTGAACCACCTCGGA"	"PT-like_2"
"ACTGAACGTACAGACG"	"PT-like_1"
"ACTGAACGTACGACCC"	"DCT_2"
"ACTGAACGTCCTGCTT"	"PT-like_2"
"ACTGAACTCAGGTAAA"	"Proliferating_PT-like"
"ACTGAGTCAGATTGCT"	"Exclude_highmito"
"ACTGAGTGTACATCCA"	"Exclude_highmito"
"ACTGAGTGTATATGGA"	"Proliferating_PT-like"
"ACTGAGTGTTCCACAA"	"PT-like_2"
"ACTGAGTGTTCTGTTT"	"PT-like_2"
"ACTGAGTTCCGTCAAA"	"PT-like_1"
"ACTGAGTTCGTCACGG"	"PT-like_2"
"ACTGATGAGCTAGGCA"	"DCT_1"
"ACTGATGCAACACGCC"	"DCT_1"
"ACTGATGGTGTGGCTC"	"DCT_2"
"ACTGATGGTTCTGGTA"	"Exclude_highribosomal"
"ACTGATGTCAACGAAA"	"Proliferating_PT-like"
"ACTGATGTCACAGGCC"	"PEC-like_1"
"ACTGCTCAGTGTCTCA"	"PT-like_1"
"ACTGCTCCAAGGACTG"	"Exclude_highmito"
"ACTGCTCCAATGACCT"	"TPC"
"ACTGCTCCATATGGTC"	"PT-like_2"
"ACTGCTCGTCATGCAT"	"PT-like_2"
"ACTGTCCAGAAACGAG"	"DCT_1"
"ACTGTCCAGCGTTGCC"	"PT-like_1"
"ACTGTCCTCGAACGGA"	"PEC-like_1"
"ACTGTCCTCTGCTGCT"	"PT-like_1"
"ACTTACTCAGGCGATA"	"DCT_1"
"ACTTACTGTTGCGCAC"	"TPC"
"ACTTGTTAGTTCGCGC"	"DCT_1"
"ACTTGTTTCAGTTTGG"	"PT-like_1"
"ACTTTCAAGGAGCGAG"	"Exclude_highribosomal"
"ACTTTCAAGGAGTCTG"	"PEC-like_1"
"ACTTTCACAATGGACG"	"PT-like_1"
"ACTTTCACACCGAATT"	"PT-like_1"
"ACTTTCACACGGCTAC"	"PT-like_2"
"ACTTTCACAGTAACGG"	"Exclude_highmito"
"ACTTTCAGTCGCGAAA"	"PT-like_1"
"ACTTTCAGTTACGGAG"	"DCT_1"
"ACTTTCATCAGAGACG"	"DCT_1"
"ACTTTCATCAGGTTCA"	"DCT_2"
"AGAATAGAGCTCTCGG"	"Exclude_highmito"
"AGAATAGAGTCATCCA"	"DCT_2"
"AGAATAGCAAAGAATC"	"PT-like_1"
"AGAATAGCAAGACACG"	"PEC-like_2"
"AGAATAGCACCCATGG"	"DCT_1"
"AGAATAGCACGAGAGT"	"DCT_2"
"AGAATAGCATGCCCGA"	"TPC"
"AGAATAGTCTTACCTA"	"DCT_2"
"AGACGTTCACATGGGA"	"PT-like_2"
"AGACGTTCACTCTGTC"	"TPC"
"AGACGTTGTACCGGCT"	"DCT_1"
"AGACGTTTCCCAACGG"	"PEC-like_1"
"AGACGTTTCGATCCCT"	"PT-like_1"
"AGACGTTTCTGCGTAA"	"PT-like_2"
"AGAGCGAAGCAGATCG"	"Exclude_highmito"
"AGAGCGAGTATATCCG"	"DCT_2"
"AGAGCGAGTTTAGGAA"	"DCT_2"
"AGAGCTTAGGACACCA"	"DCT_2"
"AGAGCTTGTAAATGAC"	"TPC"
"AGAGCTTGTCAATGTC"	"DCT_2"
"AGAGTGGCAATAGCGG"	"PT-like_1"
"AGAGTGGGTAGAGGAA"	"TPC"
"AGAGTGGGTCAAAGAT"	"DCT_2"
"AGAGTGGGTGCCTTGG"	"PT-like_2"
"AGATCTGAGAAGGTGA"	"PEC-like_1"
"AGATCTGGTATCAGTC"	"DCT_1"
"AGATCTGGTTCAGTAC"	"PT-like_1"
"AGATCTGGTTGCCTCT"	"PT-like_1"
"AGATTGCAGATATACG"	"PT-like_1"
"AGATTGCCAGGAACGT"	"PT-like_1"
"AGATTGCGTACTTGAC"	"Exclude_highribosomal"
"AGATTGCTCCGCATAA"	"DCT_1"
"AGCAGCCAGACTTTCG"	"Exclude_highmito"
"AGCAGCCAGCGTAATA"	"PT-like_2"
"AGCAGCCAGCTGAAAT"	"DCT_2"
"AGCAGCCAGTGCGATG"	"PT-like_1"
"AGCAGCCGTCGGGTCT"	"Proliferating_PT-like"
"AGCATACAGAGCTTCT"	"Proliferating_PT-like"
"AGCATACCATTCCTGC"	"DCT_2"
"AGCATACGTAAGAGAG"	"Exclude_highmito"
"AGCATACTCAACCATG"	"PT-like_1"
"AGCATACTCGCCCTTA"	"Exclude_highmito"
"AGCATACTCGTCCGTT"	"DCT_2"
"AGCCTAAAGAAACCTA"	"DCT_2"
"AGCCTAAAGATGTTAG"	"PT-like_2"
"AGCCTAACACGGCTAC"	"Proliferating_PT-like"
"AGCCTAAGTACAAGTA"	"Proliferating_PT-like"
"AGCCTAAGTACAGTTC"	"PT-like_1"
"AGCCTAAGTACCGTAT"	"TPC"
"AGCCTAATCAATACCG"	"DCT_1"
"AGCCTAATCGCATGGC"	"PT-like_2"
"AGCCTAATCTCACATT"	"DCT_1"
"AGCGGTCAGGCGACAT"	"Exclude_highmito"
"AGCGGTCCAAGGACTG"	"PEC-like_2"
"AGCGGTCCATATACCG"	"DCT_1"
"AGCGGTCCATCCGTGG"	"TPC"
"AGCGGTCCATCTCCCA"	"PT-like_1"
"AGCGGTCGTGCGGTAA"	"DCT_2"
"AGCGGTCTCAATCACG"	"TPC"
"AGCGGTCTCTCTAAGG"	"PT-like_1"
"AGCGTATAGAGACTTA"	"DCT_2"
"AGCGTATAGCTAGTGG"	"DCT_2"
"AGCGTATAGGAGTCTG"	"Proliferating_PT-like"
"AGCGTATCAGTATAAG"	"PT-like_2"
"AGCGTATGTGCACCAC"	"DCT_2"
"AGCGTATGTTGTCTTT"	"PT-like_1"
"AGCGTATTCATGGTCA"	"Exclude_highmito"
"AGCGTCGAGCCTCGTG"	"Proliferating_PT-like"
"AGCGTCGAGGTTCCTA"	"DCT_1"
"AGCGTCGAGTACTTGC"	"PT-like_2"
"AGCGTCGCAGCATGAG"	"Exclude_highmito"
"AGCGTCGGTGTGACGA"	"Proliferating_PT-like"
"AGCGTCGTCTGCGGCA"	"Exclude_highmito"
"AGCTCCTAGAAGCCCA"	"TPC"
"AGCTCCTAGACTAAGT"	"TPC"
"AGCTCCTCAAGCGATG"	"Exclude_highmito"
"AGCTCCTGTGTCAATC"	"PT-like_1"
"AGCTCCTTCAACGGCC"	"PT-like_2"
"AGCTCTCAGCCGCCTA"	"PT-like_1"
"AGCTCTCCACGGACAA"	"Exclude_highmito"
"AGCTCTCCACGGCGTT"	"PT-like_2"
"AGCTCTCGTAGTGAAT"	"DCT_2"
"AGCTCTCGTGTGACCC"	"Exclude_highmito"
"AGCTTGACAACTGCTA"	"PEC-like_1"
"AGCTTGACATCGGACC"	"DCT_2"
"AGCTTGAGTTCGCGAC"	"Proliferating_PT-like"
"AGCTTGATCATCGGAT"	"DCT_2"
"AGCTTGATCGGAAACG"	"DCT_1"
"AGCTTGATCTAAGCCA"	"PT-like_2"
"AGCTTGATCTATGTGG"	"PT-like_2"
"AGGCCACAGTACGTTC"	"PT-like_2"
"AGGCCACAGTGAAGAG"	"PT-like_1"
"AGGCCACCAGAAGCAC"	"PEC-like_1"
"AGGCCACCAGACACTT"	"PT-like_2"
"AGGCCACGTAAAGTCA"	"PT-like_2"
"AGGCCACTCCAAATGC"	"Exclude_highmito"
"AGGCCACTCTCGTTTA"	"PT-like_1"
"AGGCCGTAGAAGATTC"	"DCT_2"
"AGGCCGTAGGTAGCTG"	"DCT_2"
"AGGCCGTCAGGCTCAC"	"Exclude_highmito"
"AGGCCGTGTCCGAGTC"	"PT-like_1"
"AGGCCGTGTGTGCGTC"	"Proliferating_PT-like"
"AGGCCGTGTTCCAACA"	"DCT_1"
"AGGCCGTTCTGTTGAG"	"PT-like_1"
"AGGGAGTAGGTGATAT"	"DCT_1"
"AGGGAGTGTAAGTAGT"	"DCT_2"
"AGGGAGTTCACCAGGC"	"PT-like_2"
"AGGGAGTTCGATGAGG"	"PT-like_1"
"AGGGATGAGACTAGAT"	"Exclude_highmito"
"AGGGATGAGTTCGATC"	"TPC"
"AGGGATGCACCACCAG"	"DCT_2"
"AGGGATGGTCGCCATG"	"PT-like_1"
"AGGGATGGTTGGACCC"	"TPC"
"AGGGATGTCCCAACGG"	"DCT_1"
"AGGGTGAAGAGTCGGT"	"Proliferating_PT-like"
"AGGGTGAAGATGTGGC"	"TPC"
"AGGGTGACACGCCAGT"	"PT-like_1"
"AGGGTGACAGGGAGAG"	"TPC"
"AGGGTGACATAGTAAG"	"PT-like_1"
"AGGGTGAGTCGATTGT"	"Proliferating_PT-like"
"AGGGTGAGTCTGGAGA"	"Proliferating_PT-like"
"AGGGTGAGTTGGTAAA"	"PT-like_1"
"AGGGTGATCGGCGCAT"	"TPC"
"AGGTCATAGCCAGTTT"	"PT-like_2"
"AGGTCATAGCTATGCT"	"DCT_2"
"AGGTCATCATCATCCC"	"Proliferating_PT-like"
"AGGTCATTCCACGTGG"	"PT-like_1"
"AGGTCATTCGAGGTAG"	"Exclude_highmito"
"AGGTCCGCAGATTGCT"	"Exclude_highmito"
"AGGTCCGGTACAGCAG"	"TPC"
"AGGTCCGGTGAGCGAT"	"PT-like_1"
"AGGTCCGGTGAGTATA"	"TPC"
"AGGTCCGGTTCTGGTA"	"DCT_1"
"AGTAGTCAGGGCTCTC"	"DCT_2"
"AGTAGTCCAAATTGCC"	"Exclude_highmito"
"AGTAGTCGTCTTCAAG"	"Proliferating_PT-like"
"AGTCTTTCAACTTGAC"	"TPC"
"AGTGAGGCAGTGGGAT"	"DCT_1"
"AGTGAGGCATCCGGGT"	"DCT_2"
"AGTGAGGTCAAACGGG"	"PT-like_1"
"AGTGAGGTCTTCTGGC"	"PT-like_1"
"AGTGGGAAGAGCAATT"	"PT-like_2"
"AGTGGGACAAGGTTCT"	"DCT_2"
"AGTGGGAGTGATGATA"	"Exclude_highribosomal"
"AGTGGGAGTTCATGGT"	"Exclude_highribosomal"
"AGTGGGATCCTGTAGA"	"Exclude_highmito"
"AGTGGGATCGGTTCGG"	"Exclude_highmito"
"AGTGTCAAGCTAGTGG"	"DCT_1"
"AGTGTCAAGGTGATAT"	"DCT_1"
"AGTGTCAAGTACGTTC"	"PEC-like_1"
"AGTGTCAAGTTTCCTT"	"DCT_2"
"AGTGTCACATGACATC"	"DCT_2"
"AGTGTCAGTTGATTGC"	"Exclude_highmito"
"AGTGTCATCCTATGTT"	"DCT_1"
"AGTTGGTAGAGCTTCT"	"TPC"
"AGTTGGTCAGATTGCT"	"Exclude_highmito"
"AGTTGGTCAGGTGGAT"	"PT-like_1"
"AGTTGGTTCGCGGATC"	"TPC"
"ATAACGCAGCGAAGGG"	"Proliferating_PT-like"
"ATAACGCCAGTCACTA"	"PT-like_2"
"ATAACGCGTCCATGAT"	"DCT_2"
"ATAACGCTCATGGTCA"	"PT-like_1"
"ATAACGCTCCGTCATC"	"DCT_2"
"ATAAGAGAGATAGTCA"	"DCT_1"
"ATAAGAGAGCGACGTA"	"DCT_1"
"ATAAGAGAGTCTCCTC"	"PT-like_2"
"ATAAGAGCACGGCGTT"	"PT-like_2"
"ATAAGAGCATCACCCT"	"Exclude_highmito"
"ATAAGAGCATCGGACC"	"DCT_1"
"ATAAGAGGTACCGGCT"	"PT-like_1"
"ATAAGAGGTCAATGTC"	"TPC"
"ATAAGAGGTGACAAAT"	"Exclude_highmito"
"ATAAGAGTCATCGGAT"	"PEC-like_2"
"ATAAGAGTCGACAGCC"	"Exclude_highmito"
"ATAAGAGTCTGCGACG"	"PT-like_1"
"ATAGACCAGTAGGCCA"	"TPC"
"ATAGACCCAAACGCGA"	"DCT_2"
"ATAGACCCACGGTTTA"	"DCT_2"
"ATAGACCCAGGAATGC"	"PT-like_2"
"ATAGACCCATTCACTT"	"PT-like_1"
"ATAGACCTCAGTTCGA"	"Exclude_highmito"
"ATAGACCTCCAGTAGT"	"DCT_2"
"ATCACGAGTACCGCTG"	"Proliferating_PT-like"
"ATCACGAGTCAAAGAT"	"PT-like_2"
"ATCACGAGTCGTCTTC"	"Exclude_highmito"
"ATCACGAGTGAGCGAT"	"DCT_1"
"ATCACGATCAACTCTT"	"Exclude_highribosomal"
"ATCACGATCAAGGCTT"	"Exclude_highmito"
"ATCACGATCGACCAGC"	"DCT_2"
"ATCACGATCGGAAATA"	"TPC"
"ATCACGATCTTCATGT"	"TPC"
"ATCATCTAGCCTTGAT"	"PT-like_1"
"ATCATCTAGGGTTTCT"	"Proliferating_PT-like"
"ATCATCTCAGGGTACA"	"TPC"
"ATCATCTGTCGTGGCT"	"Exclude_highmito"
"ATCATCTTCAGAGGTG"	"Proliferating_PT-like"
"ATCATCTTCCAGAAGG"	"DCT_1"
"ATCATGGAGTAGCGGT"	"TPC"
"ATCATGGCAATCCGAT"	"PT-like_1"
"ATCATGGGTACCCAAT"	"Proliferating_PT-like"
"ATCATGGGTAGCGTCC"	"PT-like_2"
"ATCCACCAGTCTTGCA"	"PT-like_1"
"ATCCACCCAATGTAAG"	"PT-like_1"
"ATCCACCCACTCTGTC"	"PT-like_2"
"ATCCACCCAGACAAGC"	"PEC-like_1"
"ATCCACCCATCGTCGG"	"PT-like_1"
"ATCCACCGTAGCCTCG"	"PT-like_1"
"ATCCGAACACCAGGCT"	"DCT_1"
"ATCCGAAGTTCGAATC"	"PEC-like_2"
"ATCGAGTAGACAGACC"	"Proliferating_PT-like"
"ATCGAGTCACAGGAGT"	"PT-like_2"
"ATCGAGTCAGTAAGCG"	"PT-like_1"
"ATCGAGTCATGCGCAC"	"Exclude_highmito"
"ATCGAGTGTGTAACGG"	"TPC"
"ATCGAGTTCACAGTAC"	"Proliferating_PT-like"
"ATCGAGTTCAGTGCAT"	"Exclude_highmito"
"ATCTACTCAATCTGCA"	"TPC"
"ATCTACTCACATTCGA"	"PEC-like_2"
"ATCTACTCATTCCTGC"	"DCT_1"
"ATCTACTGTGGAAAGA"	"Exclude_highmito"
"ATCTGCCAGCGTCTAT"	"TPC"
"ATCTGCCAGGTGCAAC"	"DCT_1"
"ATCTGCCAGTATTGGA"	"PT-like_2"
"ATCTGCCAGTCCGTAT"	"Exclude_highmito"
"ATCTGCCCACGTCAGC"	"TPC"
"ATCTGCCCAGAGCCAA"	"TPC"
"ATCTGCCCATTGAGCT"	"PT-like_1"
"ATCTGCCGTAAGAGAG"	"PT-like_2"
"ATCTGCCGTCCAACTA"	"TPC"
"ATCTGCCGTTTAGCTG"	"PT-like_1"
"ATCTGCCTCTATGTGG"	"Proliferating_PT-like"
"ATGAGGGAGAGTAAGG"	"DCT_1"
"ATGAGGGAGTACGTTC"	"DCT_1"
"ATGAGGGCAGAGTGTG"	"PT-like_2"
"ATGAGGGCATAGAAAC"	"Proliferating_PT-like"
"ATGAGGGGTTACGACT"	"Exclude_highmito"
"ATGAGGGGTTAGTGGG"	"PT-like_1"
"ATGAGGGTCGGCTACG"	"Exclude_highmito"
"ATGAGGGTCGTATCAG"	"PEC-like_1"
"ATGAGGGTCTGTCAAG"	"TPC"
"ATGCGATCAAATACAG"	"TPC"
"ATGGGAGAGAGTGAGA"	"PT-like_1"
"ATGGGAGAGATCCCGC"	"PT-like_1"
"ATGGGAGAGTATCTCG"	"TPC"
"ATGGGAGAGTATTGGA"	"Proliferating_PT-like"
"ATGGGAGCAGGTTTCA"	"DCT_2"
"ATGGGAGTCACTTACT"	"Proliferating_PT-like"
"ATGTGTGAGAGTCTGG"	"PT-like_2"
"ATGTGTGCACAAGTAA"	"DCT_1"
"ATGTGTGGTATCGCAT"	"DCT_1"
"ATGTGTGTCAGCTCTC"	"PT-like_1"
"ATGTGTGTCTTGCATT"	"DCT_2"
"ATTACTCAGGACACCA"	"PT-like_1"
"ATTACTCCAGCATGAG"	"PT-like_2"
"ATTACTCCATCCGGGT"	"Exclude_highmito"
"ATTACTCTCCTGCAGG"	"DCT_1"
"ATTACTCTCGCAAACT"	"TPC"
"ATTATCCAGAGCCCAA"	"DCT_2"
"ATTATCCGTCTAGCGC"	"Exclude_highmito"
"ATTCTACAGAGTCTGG"	"TPC"
"ATTCTACAGTTGAGTA"	"Exclude_highmito"
"ATTCTACTCAAAGTAG"	"Exclude_highmito"
"ATTCTACTCACCTCGT"	"TPC"
"ATTCTACTCGGCGCTA"	"DCT_1"
"ATTGGACAGCTAGTTC"	"TPC"
"ATTGGACAGTACGTAA"	"Proliferating_PT-like"
"ATTGGACCAAGAGTCG"	"PT-like_1"
"ATTGGACCAGGTGGAT"	"PEC-like_1"
"ATTGGACCATCCGTGG"	"DCT_1"
"ATTGGACCATGTTGAC"	"PT-like_1"
"ATTGGACGTCATACTG"	"PT-like_2"
"ATTGGACTCCGGGTGT"	"Exclude_highmito"
"ATTGGACTCTTATCTG"	"PT-like_1"
"ATTGGTGAGTATTGGA"	"Exclude_highmito"
"ATTGGTGCAAGAAGAG"	"PT-like_1"
"ATTGGTGCAGCTCGCA"	"Exclude_highmito"
"ATTGGTGCAGTACACT"	"Proliferating_PT-like"
"ATTGGTGCAGTAGAGC"	"Exclude_highmito"
"ATTGGTGCAGTATAAG"	"PT-like_1"
"ATTGGTGTCACTGGGC"	"PT-like_1"
"ATTGGTGTCGAATCCA"	"PT-like_1"
"ATTGGTGTCGGGAGTA"	"PEC-like_2"
"ATTTCTGAGATGTTAG"	"PT-like_2"
"ATTTCTGAGCGATAGC"	"DCT_1"
"ATTTCTGCAGGCTCAC"	"PEC-like_1"
"ATTTCTGCAGGTGGAT"	"Exclude_highmito"
"ATTTCTGGTCTTGCGG"	"TPC"
"CAACCAACACAGACAG"	"TPC"
"CAACCAACACCGAAAG"	"TPC"
"CAACCAAGTCTGATCA"	"TPC"
"CAACCTCAGGCTAGAC"	"DCT_1"
"CAACCTCCATCCGGGT"	"DCT_1"
"CAACCTCCATCGTCGG"	"Exclude_highmito"
"CAACCTCGTCCAGTTA"	"PEC-like_1"
"CAACCTCGTGAGCGAT"	"PT-like_1"
"CAACCTCGTGTGACCC"	"DCT_2"
"CAACCTCGTTGAACTC"	"Exclude_highmito"
"CAACCTCTCAATCTCT"	"Exclude_highmito"
"CAACCTCTCGGCTACG"	"PT-like_1"
"CAACCTCTCTTGTTTG"	"PT-like_2"
"CAACTAGGTAACGACG"	"Proliferating_PT-like"
"CAACTAGGTAATTGGA"	"PT-like_2"
"CAACTAGGTAGGCATG"	"Exclude_highribosomal"
"CAACTAGGTTGGGACA"	"DCT_1"
"CAACTAGTCAGGCAAG"	"TPC"
"CAACTAGTCGTGGTCG"	"DCT_2"
"CAAGAAACAACACGCC"	"PT-like_1"
"CAAGAAACACGCCAGT"	"Proliferating_PT-like"
"CAAGAAACATCACGAT"	"DCT_2"
"CAAGAAATCCGTCATC"	"Proliferating_PT-like"
"CAAGAAATCGAACTGT"	"DCT_1"
"CAAGAAATCGGATGGA"	"PT-like_2"
"CAAGATCAGCTAGTTC"	"DCT_1"
"CAAGATCTCCGATATG"	"TPC"
"CAAGGCCAGAACAATC"	"DCT_1"
"CAAGGCCGTAAATGTG"	"Exclude_highmito"
"CAAGGCCGTTCGTGAT"	"PT-like_1"
"CAAGGCCTCGGATGTT"	"DCT_2"
"CAAGTTGAGATATGGT"	"PT-like_1"
"CAAGTTGCATGCCTTC"	"PEC-like_2"
"CAAGTTGGTCTCATCC"	"DCT_1"
"CAAGTTGGTTCGTGAT"	"TPC"
"CAAGTTGGTTGTTTGG"	"Exclude_highmito"
"CAAGTTGTCTGCCAGG"	"DCT_2"
"CACAAACCACAACTGT"	"PT-like_1"
"CACAAACCATATACCG"	"Exclude_highmito"
"CACAAACGTCGAACAG"	"PT-like_1"
"CACAAACGTTGCCTCT"	"Exclude_highmito"
"CACAAACTCAAGGTAA"	"DCT_1"
"CACAAACTCTCCAGGG"	"PT-like_1"
"CACACAAAGGTGACCA"	"DCT_2"
"CACACAAAGTCCGGTC"	"Proliferating_PT-like"
"CACACAAGTGAAGGCT"	"DCT_2"
"CACACCTAGCGTGAAC"	"PT-like_1"
"CACACCTAGTAGCCGA"	"PT-like_1"
"CACACCTAGTGTGAAT"	"Proliferating_PT-like"
"CACACCTCACAACGCC"	"DCT_2"
"CACACCTCACGGCGTT"	"DCT_1"
"CACACCTCAGTCTTCC"	"TPC"
"CACACCTGTTACGACT"	"TPC"
"CACACCTGTTGTGGCC"	"DCT_2"
"CACACCTTCCGGCACA"	"PT-like_1"
"CACACTCAGAAGGGTA"	"DCT_1"
"CACACTCAGATCCCGC"	"Proliferating_PT-like"
"CACACTCCACTTACGA"	"DCT_2"
"CACACTCCAGGTTTCA"	"TPC"
"CACACTCCATCCCACT"	"Proliferating_PT-like"
"CACACTCGTTAGGGTG"	"PEC-like_1"
"CACACTCTCTCCAGGG"	"Exclude_highmito"
"CACAGGCCAAGGCTCC"	"PT-like_1"
"CACAGGCGTACTTAGC"	"Proliferating_PT-like"
"CACAGGCTCAAACGGG"	"PEC-like_1"
"CACAGGCTCATGCATG"	"TPC"
"CACAGTAAGATCTGCT"	"DCT_1"
"CACAGTAAGCTGCAAG"	"Exclude_highmito"
"CACAGTACAGCAGTTT"	"TPC"
"CACAGTAGTCCTGCTT"	"Exclude_highmito"
"CACAGTAGTCTAGCGC"	"PT-like_2"
"CACAGTATCCGGGTGT"	"TPC"
"CACATAGAGGATATAC"	"Exclude_highmito"
"CACATAGCAGATGGCA"	"PEC-like_1"
"CACATAGCATCACAAC"	"PT-like_2"
"CACATAGGTTGGTAAA"	"DCT_1"
"CACATAGTCACCACCT"	"DCT_2"
"CACATAGTCCCATTTA"	"PEC-like_1"
"CACATTTAGACTAAGT"	"TPC"
"CACATTTAGTACGACG"	"TPC"
"CACATTTAGTTTGCGT"	"PT-like_1"
"CACATTTCAAGGACAC"	"TPC"
"CACATTTCAGCCTTGG"	"DCT_2"
"CACATTTCAGTTCATG"	"Exclude_highmito"
"CACATTTCATGTTCCC"	"DCT_2"
"CACATTTTCGTACGGC"	"PT-like_1"
"CACCACTAGTACGACG"	"PT-like_2"
"CACCACTCAGGATCGA"	"DCT_1"
"CACCACTGTAAGTGGC"	"TPC"
"CACCAGGAGAAGGTGA"	"Exclude_highmito"
"CACCAGGAGACTCGGA"	"TPC"
"CACCAGGCATGCCACG"	"Exclude_highmito"
"CACCAGGTCCGTTGCT"	"TPC"
"CACCAGGTCGTAGGAG"	"PT-like_1"
"CACCTTGGTAAGGGCT"	"TPC"
"CACCTTGGTACAAGTA"	"DCT_2"
"CACCTTGGTCTACCTC"	"Proliferating_PT-like"
"CACCTTGTCAATCACG"	"PT-like_2"
"CACCTTGTCTCAAACG"	"Exclude_highmito"
"CACTCCAAGATGTGGC"	"Exclude_highmito"
"CACTCCAAGCACCGCT"	"TPC"
"CACTCCAAGCACCGTC"	"Exclude_highmito"
"CACTCCACAATGGTCT"	"TPC"
"CACTCCACATAAAGGT"	"DCT_2"
"CACTCCAGTAATAGCA"	"Proliferating_PT-like"
"CAGAATCAGGATATAC"	"TPC"
"CAGAATCCAATGGATA"	"DCT_1"
"CAGAATCCATCATCCC"	"TPC"
"CAGAATCGTATTCGTG"	"PT-like_2"
"CAGAGAGAGACTGGGT"	"PEC-like_1"
"CAGAGAGCACGGCCAT"	"PT-like_1"
"CAGAGAGCAGAGCCAA"	"PT-like_2"
"CAGAGAGTCGTTTGCC"	"PT-like_2"
"CAGAGAGTCTTACCTA"	"DCT_1"
"CAGATCAAGCTGTCTA"	"PT-like_1"
"CAGATCAAGTTTGCGT"	"TPC"
"CAGATCACACCATGTA"	"PT-like_1"
"CAGATCACACCCATTC"	"PT-like_1"
"CAGATCAGTAGCTGCC"	"TPC"
"CAGATCAGTATTCTCT"	"Exclude_highmito"
"CAGCAGCAGGTGGGTT"	"PT-like_1"
"CAGCAGCAGTGGACGT"	"Proliferating_PT-like"
"CAGCAGCCACCAACCG"	"DCT_1"
"CAGCAGCCACTTAAGC"	"DCT_1"
"CAGCAGCCATCTCCCA"	"PT-like_1"
"CAGCAGCTCATCGGAT"	"DCT_1"
"CAGCAGCTCGAGAACG"	"PEC-like_1"
"CAGCATAGTGGTACAG"	"DCT_2"
"CAGCATATCGCTAGCG"	"PT-like_1"
"CAGCCGAAGAGGGATA"	"PT-like_2"
"CAGCCGAAGATACACA"	"TPC"
"CAGCCGAAGGGCTCTC"	"Exclude_highmito"
"CAGCCGAAGTCCTCCT"	"Exclude_highmito"
"CAGCCGAAGTGTTTGC"	"Proliferating_PT-like"
"CAGCCGACAAGCTGGA"	"PT-like_2"
"CAGCCGACACAAGCCC"	"PT-like_2"
"CAGCCGAGTGGTCTCG"	"PT-like_2"
"CAGCCGATCAACACAC"	"Proliferating_PT-like"
"CAGCCGATCAACGCTA"	"Proliferating_PT-like"
"CAGCGACCACAAGTAA"	"Exclude_highmito"
"CAGCGACCACCGAAAG"	"PT-like_1"
"CAGCGACCAGAGTGTG"	"DCT_1"
"CAGCGACCAGATCTGT"	"PT-like_1"
"CAGCGACGTTCAGACT"	"PT-like_2"
"CAGCGACTCTCCCTGA"	"Exclude_highmito"
"CAGCGACTCTGTCTCG"	"TPC"
"CAGCTAAAGAATAGGG"	"PT-like_1"
"CAGCTAAAGATGTGTA"	"PT-like_1"
"CAGCTAAAGATGTTAG"	"PT-like_1"
"CAGCTAAAGGGAAACA"	"PT-like_1"
"CAGCTAAAGGTACTCT"	"Exclude_highmito"
"CAGCTAAGTAACGCGA"	"DCT_1"
"CAGCTAAGTCATACTG"	"PT-like_2"
"CAGCTAATCACGACTA"	"DCT_1"
"CAGCTAATCATGTAGC"	"Proliferating_PT-like"
"CAGCTGGAGTTACCCA"	"DCT_1"
"CAGCTGGCAGGTCGTC"	"TPC"
"CAGCTGGTCAGTTTGG"	"Proliferating_PT-like"
"CAGGTGCAGTCGTACT"	"PT-like_1"
"CAGGTGCAGTTCGCAT"	"PEC-like_1"
"CAGGTGCCACATTCGA"	"DCT_1"
"CAGGTGCCACGGCTAC"	"PEC-like_2"
"CAGGTGCCAGAGTGTG"	"Proliferating_PT-like"
"CAGGTGCGTCGCGTGT"	"PT-like_1"
"CAGGTGCGTTCCATGA"	"Proliferating_PT-like"
"CAGGTGCGTTTAGGAA"	"PEC-like_1"
"CAGTAACCAATACGCT"	"Exclude_highmito"
"CAGTAACCATTACCTT"	"PT-like_2"
"CAGTAACGTACCAGTT"	"DCT_2"
"CAGTAACGTGATGCCC"	"DCT_2"
"CAGTAACTCATCATTC"	"Exclude_highmito"
"CAGTCCTAGGCAGGTT"	"DCT_1"
"CAGTCCTAGGCCCGTT"	"Exclude_highribosomal"
"CAGTCCTCAAGCTGTT"	"TPC"
"CAGTCCTTCCTAAGTG"	"TPC"
"CAGTCCTTCTTACCTA"	"Proliferating_PT-like"
"CATATGGAGCTGCAAG"	"Proliferating_PT-like"
"CATATGGAGTCAAGCG"	"DCT_2"
"CATATGGCAACGCACC"	"Exclude_highmito"
"CATATTCAGTGAATTG"	"Exclude_highmito"
"CATATTCCAACAACCT"	"PEC-like_2"
"CATATTCCAAGACGTG"	"TPC"
"CATATTCGTGGTCCGT"	"DCT_2"
"CATCAAGAGAGCTATA"	"Proliferating_PT-like"
"CATCAAGAGAGGTTAT"	"PT-like_1"
"CATCAAGCAGCTTAAC"	"PT-like_1"
"CATCAAGCAGTTTACG"	"DCT_1"
"CATCAAGTCACGCATA"	"PT-like_1"
"CATCAAGTCGCTTAGA"	"PEC-like_2"
"CATCAAGTCGGCTTGG"	"Proliferating_PT-like"
"CATCAGAGTCATTAGC"	"DCT_1"
"CATCAGATCGGTGTTA"	"DCT_2"
"CATCCACAGAAAGTGG"	"PT-like_2"
"CATCCACAGGACGAAA"	"TPC"
"CATCCACCATCCCACT"	"PT-like_1"
"CATCCACGTATTACCG"	"TPC"
"CATCGAAAGCCCAGCT"	"PT-like_1"
"CATCGAACAGGGTTAG"	"PT-like_1"
"CATCGAACATCTACGA"	"PT-like_1"
"CATCGAAGTTGATTGC"	"Exclude_highmito"
"CATCGGGAGCTGTCTA"	"TPC"
"CATCGGGAGTCCGTAT"	"DCT_2"
"CATCGGGCACAAGTAA"	"PT-like_1"
"CATCGGGCAGCGTCCA"	"Proliferating_PT-like"
"CATCGGGGTGATAAAC"	"PT-like_1"
"CATCGGGGTTCTGAAC"	"PT-like_2"
"CATCGGGGTTTAGCTG"	"PT-like_2"
"CATCGGGTCCAAGCCG"	"Exclude_highmito"
"CATCGGGTCGGATGTT"	"DCT_2"
"CATGACAAGCTAGGCA"	"PEC-like_1"
"CATGACAAGGTAGCTG"	"DCT_1"
"CATGACAAGTGCTGCC"	"DCT_2"
"CATGACACACCGTTGG"	"Proliferating_PT-like"
"CATGACACATGGAATA"	"TPC"
"CATGACAGTATTCGTG"	"Proliferating_PT-like"
"CATGCCTAGTGGAGTC"	"PT-like_1"
"CATGCCTCAAGGGTCA"	"DCT_2"
"CATGCCTCACCATCCT"	"PT-like_1"
"CATGCCTGTGCCTGTG"	"PT-like_1"
"CATGCCTGTTGGTAAA"	"DCT_1"
"CATGCCTTCACTATTC"	"DCT_1"
"CATGCCTTCGTGTAGT"	"DCT_1"
"CATGCCTTCTGGGCCA"	"PEC-like_1"
"CATGGCGAGGACTGGT"	"DCT_2"
"CATGGCGCACGAAATA"	"PT-like_2"
"CATTATCAGGCGTACA"	"TPC"
"CATTATCCATGCAACT"	"Proliferating_PT-like"
"CATTATCGTGTCAATC"	"DCT_2"
"CATTCGCAGTTTCCTT"	"DCT_1"
"CATTCGCCATCGGACC"	"TPC"
"CATTCGCGTACGCACC"	"PEC-like_2"
"CATTCGCGTAGGCTGA"	"PT-like_1"
"CATTCGCTCGAATGCT"	"TPC"
"CATTCGCTCGTACCGG"	"PT-like_1"
"CCAATCCAGCTAACAA"	"DCT_1"
"CCAATCCAGTCAAGCG"	"PT-like_2"
"CCAATCCCATCTCCCA"	"PT-like_2"
"CCAATCCGTCTCATCC"	"Exclude_highmito"
"CCAATCCTCTAACCGA"	"PT-like_1"
"CCAATCCTCTAAGCCA"	"DCT_2"
"CCACCTACACGGCGTT"	"PT-like_1"
"CCACCTACAGTTAACC"	"Exclude_highmito"
"CCACCTACATCGGAAG"	"DCT_1"
"CCACCTAGTCGGGTCT"	"TPC"
"CCACCTAGTTGTCGCG"	"PT-like_2"
"CCACCTATCATGTGGT"	"Proliferating_PT-like"
"CCACGGAAGATGTGGC"	"TPC"
"CCACGGAAGTAGGTGC"	"Exclude_highmito"
"CCACGGAGTGTTAAGA"	"PT-like_2"
"CCACTACAGAAACCTA"	"PT-like_2"
"CCACTACAGTGTACGG"	"DCT_1"
"CCACTACCAGTAAGAT"	"Exclude_highmito"
"CCACTACGTGGCTCCA"	"DCT_2"
"CCACTACGTGTTGAGG"	"DCT_1"
"CCAGCGAAGGCACATG"	"DCT_2"
"CCAGCGACATGCCCGA"	"DCT_2"
"CCAGCGAGTTACGACT"	"PT-like_1"
"CCAGCGAGTTGGTGGA"	"TPC"
"CCAGCGATCCAAAGTC"	"PT-like_1"
"CCATGTCCATAGTAAG"	"Exclude_highmito"
"CCATGTCGTGACGGTA"	"DCT_1"
"CCATGTCTCCTTTCTC"	"PT-like_2"
"CCATTCGAGAAAGTGG"	"PT-like_1"
"CCATTCGCAAGTAATG"	"TPC"
"CCATTCGCAGGGCATA"	"Proliferating_PT-like"
"CCATTCGCATGGATGG"	"DCT_1"
"CCATTCGTCACTATTC"	"Proliferating_PT-like"
"CCATTCGTCCACGACG"	"PT-like_1"
"CCATTCGTCTCAAGTG"	"Exclude_highmito"
"CCCAATCAGGAGTAGA"	"DCT_2"
"CCCAATCAGTGAAGTT"	"TPC"
"CCCAATCCATTGGTAC"	"DCT_1"
"CCCAATCGTATAGGGC"	"Exclude_highmito"
"CCCAATCGTTGACGTT"	"TPC"
"CCCAGTTAGAGTAAGG"	"DCT_2"
"CCCAGTTAGATCCCGC"	"Exclude_highmito"
"CCCAGTTAGGCCCTTG"	"TPC"
"CCCAGTTGTCAAAGCG"	"PT-like_1"
"CCCAGTTTCCACGAAT"	"PT-like_1"
"CCCAGTTTCGACAGCC"	"PEC-like_1"
"CCCAGTTTCGGAAACG"	"TPC"
"CCCAGTTTCTGTCAAG"	"Proliferating_PT-like"
"CCCATACAGTCTTGCA"	"DCT_2"
"CCCATACCAGGTCGTC"	"Proliferating_PT-like"
"CCCATACGTAAAGTCA"	"Exclude_highmito"
"CCCATACTCCATGAGT"	"Proliferating_PT-like"
"CCCTCCTCAAACCTAC"	"Proliferating_PT-like"
"CCCTCCTGTTGGTAAA"	"PT-like_1"
"CCCTCCTTCGCATGAT"	"Proliferating_PT-like"
"CCCTCCTTCTCGAGTA"	"DCT_1"
"CCGGGATCAAGTTGTC"	"PT-like_1"
"CCGGGATCACCCTATC"	"Exclude_highmito"
"CCGGGATCAGGGTATG"	"Proliferating_PT-like"
"CCGGGATGTCCGTCAG"	"PT-like_2"
"CCGGGATGTGAAGGCT"	"Proliferating_PT-like"
"CCGGGATGTGCCTGGT"	"DCT_1"
"CCGGGATGTGTCCTCT"	"TPC"
"CCGGTAGCAGATAATG"	"DCT_1"
"CCGGTAGGTGAGGGAG"	"Exclude_highmito"
"CCGGTAGTCATTTGGG"	"PEC-like_2"
"CCGGTAGTCGATAGAA"	"Proliferating_PT-like"
"CCGTACTAGCAGCCTC"	"TPC"
"CCGTACTAGCATGGCA"	"Exclude_highmito"
"CCGTACTAGGACGAAA"	"PT-like_1"
"CCGTACTAGGGTTTCT"	"DCT_1"
"CCGTACTCACAACGCC"	"PT-like_2"
"CCGTACTGTGCCTTGG"	"PT-like_2"
"CCGTACTGTGTCTGAT"	"DCT_2"
"CCGTACTGTTCGCTAA"	"TPC"
"CCGTACTTCACGATGT"	"TPC"
"CCGTGGACATACCATG"	"PT-like_1"
"CCGTGGACATGAACCT"	"Exclude_highmito"
"CCGTGGATCATGTCTT"	"PT-like_2"
"CCGTTCACAGCCTATA"	"PT-like_1"
"CCGTTCACAGCTGCAC"	"PT-like_1"
"CCGTTCACATGCTGGC"	"PT-like_1"
"CCGTTCAGTCTCGTTC"	"TPC"
"CCGTTCATCTACTCAT"	"Exclude_highmito"
"CCTAAAGAGTGCCAGA"	"DCT_2"
"CCTAAAGCATCGGAAG"	"PT-like_2"
"CCTAAAGTCAACGGGA"	"DCT_2"
"CCTAAAGTCCTCATTA"	"Proliferating_PT-like"
"CCTAAAGTCTCTGAGA"	"PT-like_1"
"CCTACACAGCGTCAAG"	"PT-like_1"
"CCTACACAGCGTTGCC"	"TPC"
"CCTACACAGCTAGCCC"	"Proliferating_PT-like"
"CCTACACAGTCCGTAT"	"TPC"
"CCTACACGTGAGTATA"	"PEC-like_2"
"CCTACACTCCAGAAGG"	"PT-like_1"
"CCTACACTCCTTCAAT"	"PT-like_2"
"CCTACCACAAGTCATC"	"PEC-like_1"
"CCTACCACAGATCGGA"	"PT-like_1"
"CCTACCAGTGAGCGAT"	"PT-like_2"
"CCTACCATCAGCTTAG"	"DCT_1"
"CCTAGCTAGGGATCTG"	"PEC-like_1"
"CCTAGCTCACTCGACG"	"PT-like_1"
"CCTAGCTTCAATCACG"	"PT-like_1"
"CCTAGCTTCAGAGCTT"	"Exclude_highmito"
"CCTATTAAGCGACGTA"	"Exclude_highmito"
"CCTATTAGTCATGCCG"	"TPC"
"CCTATTATCTGATTCT"	"PT-like_1"
"CCTATTATCTGTCTAT"	"PT-like_1"
"CCTCAGTAGGATGCGT"	"PT-like_2"
"CCTCAGTAGTGGTAAT"	"PT-like_1"
"CCTCAGTAGTGTGAAT"	"PT-like_2"
"CCTCAGTCACATCCGG"	"DCT_1"
"CCTCAGTCATTCCTCG"	"PT-like_1"
"CCTCAGTGTGCTAGCC"	"DCT_2"
"CCTCAGTGTGGTTTCA"	"PEC-like_1"
"CCTCAGTGTTACCGAT"	"DCT_2"
"CCTCAGTGTTCAGCGC"	"DCT_2"
"CCTCAGTTCAGTCAGT"	"Proliferating_PT-like"
"CCTCAGTTCGCTTAGA"	"Proliferating_PT-like"
"CCTCTGAAGCTAGTTC"	"DCT_2"
"CCTCTGAAGGTGCTAG"	"DCT_1"
"CCTCTGAAGTACACCT"	"Exclude_highribosomal"
"CCTCTGAAGTAGCGGT"	"PEC-like_1"
"CCTCTGACACCCAGTG"	"PT-like_1"
"CCTCTGACACCGGAAA"	"DCT_1"
"CCTCTGAGTAGCGCTC"	"PT-like_2"
"CCTCTGATCAGGCAAG"	"PT-like_1"
"CCTTACGAGATGCCTT"	"DCT_2"
"CCTTACGAGCCCGAAA"	"Exclude_highribosomal"
"CCTTACGAGTATCGAA"	"DCT_2"
"CCTTACGCAAGCGCTC"	"PT-like_1"
"CCTTACGCACCCAGTG"	"DCT_2"
"CCTTACGTCAGAGGTG"	"PT-like_1"
"CCTTCCCAGACAGACC"	"DCT_1"
"CCTTCCCCAAATACAG"	"DCT_2"
"CCTTCCCCACGGACAA"	"Exclude_highribosomal"
"CCTTCCCCAGTGACAG"	"PT-like_1"
"CCTTCCCCAGTGAGTG"	"PT-like_1"
"CCTTCCCGTACGCTGC"	"TPC"
"CCTTCCCGTCAGTGGA"	"DCT_2"
"CCTTCCCTCAGAGGTG"	"Proliferating_PT-like"
"CCTTCCCTCTACCTGC"	"Exclude_highmito"
"CCTTCCCTCTACGAGT"	"PT-like_1"
"CCTTCCCTCTTAGCCC"	"DCT_1"
"CCTTCGACACAGCGTC"	"DCT_2"
"CCTTCGACAGGACGTA"	"TPC"
"CCTTCGACATCGGTTA"	"PT-like_1"
"CCTTCGACATTCTTAC"	"Exclude_highmito"
"CCTTCGAGTAGAGCTG"	"PT-like_2"
"CCTTCGAGTGCAGACA"	"PT-like_1"
"CCTTCGAGTTAAGGGC"	"Exclude_highribosomal"
"CCTTTCTCATACTCTT"	"DCT_2"
"CCTTTCTTCGGGAGTA"	"DCT_2"
"CCTTTCTTCTCGTTTA"	"DCT_2"
"CGAACATAGATCTGCT"	"DCT_2"
"CGAACATAGCCGCCTA"	"TPC"
"CGAACATAGGTAGCTG"	"DCT_1"
"CGAACATCACCTATCC"	"PT-like_1"
"CGAACATGTACCCAAT"	"Exclude_highribosomal"
"CGAACATGTGAAGGCT"	"Proliferating_PT-like"
"CGAACATGTTCCAACA"	"DCT_1"
"CGAACATGTTGCGCAC"	"TPC"
"CGAACATTCACTTCAT"	"Exclude_highmito"
"CGAACATTCCTAGTGA"	"PT-like_1"
"CGAACATTCGGAAATA"	"Exclude_highmito"
"CGAATGTAGACAGGCT"	"Exclude_highmito"
"CGAATGTAGGTCATCT"	"Exclude_highmito"
"CGAATGTGTAAGTTCC"	"PT-like_2"
"CGAATGTGTATTACCG"	"PEC-like_1"
"CGAATGTGTCTTCTCG"	"PT-like_1"
"CGAATGTGTGTATGGG"	"Exclude_highribosomal"
"CGAATGTTCCACGTGG"	"Exclude_highmito"
"CGACCTTAGAAACCAT"	"DCT_2"
"CGACCTTCACGAAAGC"	"Proliferating_PT-like"
"CGACCTTGTGACCAAG"	"DCT_2"
"CGACCTTGTGTGTGCC"	"TPC"
"CGACCTTTCTCCAACC"	"TPC"
"CGACTTCAGACTAAGT"	"PT-like_1"
"CGACTTCAGGATGTAT"	"DCT_2"
"CGACTTCCAATCTGCA"	"DCT_1"
"CGACTTCCAATTCCTT"	"TPC"
"CGACTTCGTGTAATGA"	"PT-like_1"
"CGAGAAGCAAATCCGT"	"DCT_1"
"CGAGAAGCAATCGGTT"	"PT-like_2"
"CGAGAAGCACACAGAG"	"Exclude_highribosomal"
"CGAGAAGCAGTGACAG"	"PT-like_1"
"CGAGAAGGTAGAAAGG"	"DCT_2"
"CGAGAAGTCAGCTCTC"	"PT-like_1"
"CGAGAAGTCGAATGCT"	"DCT_1"
"CGAGCACAGTGACATA"	"DCT_1"
"CGAGCACCACCTATCC"	"PT-like_2"
"CGAGCACCATCAGTCA"	"DCT_2"
"CGAGCACGTCTTCGTC"	"PT-like_2"
"CGAGCACTCTACCTGC"	"Exclude_highmito"
"CGAGCCAAGTGGTAAT"	"PT-like_2"
"CGAGCCACAATACGCT"	"Proliferating_PT-like"
"CGAGCCACAGGTTTCA"	"DCT_1"
"CGAGCCACATGTCGAT"	"TPC"
"CGAGCCAGTCGTTGTA"	"TPC"
"CGAGCCAGTGCAGTAG"	"TPC"
"CGAGCCATCGAACTGT"	"TPC"
"CGAGCCATCGGTTAAC"	"TPC"
"CGATCGGAGCGTGAAC"	"Proliferating_PT-like"
"CGATCGGAGCTACCTA"	"PT-like_1"
"CGATCGGCACAACGTT"	"PT-like_1"
"CGATCGGCAGTGACAG"	"TPC"
"CGATCGGTCTGTCAAG"	"DCT_1"
"CGATCGGTCTTCGAGA"	"Exclude_highmito"
"CGATGGCAGCACCGTC"	"PT-like_1"
"CGATGGCAGGACATTA"	"PT-like_1"
"CGATGGCAGTGCTGCC"	"DCT_1"
"CGATGGCCATATACCG"	"TPC"
"CGATGGCCATGGTAGG"	"DCT_1"
"CGATGGCTCATATCGG"	"PT-like_1"
"CGATGTAAGTCGTTTG"	"Exclude_highribosomal"
"CGATGTACACGGTAGA"	"TPC"
"CGATGTATCGTCACGG"	"PT-like_2"
"CGATTGACAATGGAGC"	"DCT_1"
"CGATTGACACGGCCAT"	"Proliferating_PT-like"
"CGATTGACAGTCTTCC"	"PEC-like_2"
"CGATTGATCCAATGGT"	"DCT_2"
"CGCCAAGAGTGGAGAA"	"Exclude_highribosomal"
"CGCCAAGGTTCACCTC"	"DCT_2"
"CGCGGTAAGCAGCCTC"	"DCT_2"
"CGCGGTACACATGACT"	"DCT_1"
"CGCGGTACAGTTCATG"	"PT-like_1"
"CGCGGTAGTCGAACAG"	"PT-like_1"
"CGCGGTAGTGATAAGT"	"TPC"
"CGCGGTAGTTATGTGC"	"DCT_1"
"CGCGGTATCACCATAG"	"PT-like_1"
"CGCGGTATCCAGAAGG"	"PT-like_1"
"CGCGTTTTCCGTAGGC"	"TPC"
"CGCTATCAGCAGCGTA"	"PT-like_1"
"CGCTATCAGTACTTGC"	"Exclude_highmito"
"CGCTATCGTTCCGGCA"	"TPC"
"CGCTATCTCCTCTAGC"	"PT-like_1"
"CGCTATCTCTTACCTA"	"Exclude_highmito"
"CGCTGGAAGCTAGTCT"	"PT-like_2"
"CGCTGGAAGGATGGAA"	"PT-like_2"
"CGCTGGAAGGATGGTC"	"DCT_2"
"CGCTGGACACAGCCCA"	"TPC"
"CGCTGGACATGAGCGA"	"DCT_1"
"CGCTGGAGTAACGTTC"	"TPC"
"CGCTGGAGTGCAGGTA"	"Exclude_highmito"
"CGCTTCATCGCGTTTC"	"Exclude_highmito"
"CGCTTCATCTACTCAT"	"DCT_1"
"CGGACACGTCCAACTA"	"DCT_2"
"CGGACACTCGTAGATC"	"TPC"
"CGGACGTAGCTAAACA"	"Exclude_highribosomal"
"CGGACGTAGCTAACTC"	"PT-like_1"
"CGGACGTCAAAGCAAT"	"Exclude_highmito"
"CGGACGTCACGGTAGA"	"DCT_2"
"CGGACGTGTTATGTGC"	"PT-like_2"
"CGGACGTTCTATCGCC"	"TPC"
"CGGACTGAGTGAACGC"	"Exclude_highmito"
"CGGACTGCAAGTTCTG"	"Exclude_highmito"
"CGGACTGGTGCGGTAA"	"PT-like_1"
"CGGACTGTCAGTTCGA"	"PEC-like_2"
"CGGACTGTCCGAGCCA"	"TPC"
"CGGAGCTAGTTTCCTT"	"Exclude_highmito"
"CGGAGCTCAGATGGCA"	"DCT_2"
"CGGAGCTCATGCCTAA"	"PT-like_2"
"CGGAGCTGTAAGCACG"	"PT-like_1"
"CGGAGCTGTCGAGTTT"	"PT-like_2"
"CGGAGCTGTTACTGAC"	"TPC"
"CGGAGTCAGCCACGCT"	"DCT_1"
"CGGAGTCAGGCCGAAT"	"PT-like_1"
"CGGAGTCCAATAGCAA"	"PEC-like_2"
"CGGAGTCTCATGTCTT"	"PT-like_1"
"CGGAGTCTCGGTGTCG"	"DCT_1"
"CGGAGTCTCTGCTTGC"	"Proliferating_PT-like"
"CGGCTAGAGACAGGCT"	"DCT_2"
"CGGCTAGAGCGGATCA"	"TPC"
"CGGCTAGAGCGTGTCC"	"Proliferating_PT-like"
"CGGCTAGGTATAGGGC"	"DCT_1"
"CGGCTAGGTATCACCA"	"PEC-like_1"
"CGGCTAGTCTTCGGTC"	"PEC-like_2"
"CGGGTCAGTTCGGGCT"	"PT-like_1"
"CGGTTAAGTAAGAGAG"	"Proliferating_PT-like"
"CGGTTAAGTGAGCGAT"	"PT-like_1"
"CGGTTAAGTGGTACAG"	"PT-like_2"
"CGGTTAATCCCAACGG"	"PT-like_2"
"CGGTTAATCCTTAATC"	"Exclude_highmito"
"CGTAGCGAGACTGTAA"	"PT-like_2"
"CGTAGCGAGTGGTCCC"	"TPC"
"CGTAGCGAGTTACGGG"	"DCT_2"
"CGTAGCGGTAGCGCAA"	"PT-like_1"
"CGTAGCGGTTAGATGA"	"PEC-like_2"
"CGTAGGCAGAAGGTGA"	"PT-like_1"
"CGTAGGCCACTGTGTA"	"PT-like_1"
"CGTAGGCCAGGCAGTA"	"PT-like_1"
"CGTAGGCCATAAAGGT"	"PT-like_2"
"CGTAGGCCATGTAAGA"	"PT-like_1"
"CGTAGGCCATTCTTAC"	"Proliferating_PT-like"
"CGTAGGCCATTGTGCA"	"PT-like_2"
"CGTAGGCTCAACACAC"	"TPC"
"CGTCACTAGGGCTTCC"	"Proliferating_PT-like"
"CGTCACTCACGCTTTC"	"PT-like_1"
"CGTCACTCAGTCAGAG"	"Exclude_highmito"
"CGTCACTGTCTCACCT"	"PT-like_1"
"CGTCACTGTGAGTGAC"	"PEC-like_2"
"CGTCACTTCGGAGCAA"	"DCT_2"
"CGTCAGGAGCTGCAAG"	"PT-like_2"
"CGTCAGGAGGCAGGTT"	"Proliferating_PT-like"
"CGTCAGGCAAGTAATG"	"PEC-like_2"
"CGTCAGGCAGCGTTCG"	"Proliferating_PT-like"
"CGTCAGGCATGTCCTC"	"PT-like_1"
"CGTCAGGTCAAAGACA"	"PT-like_1"
"CGTCCATAGAAGGTTT"	"Proliferating_PT-like"
"CGTCCATAGAGTGAGA"	"PT-like_2"
"CGTCCATAGGGTGTTG"	"DCT_1"
"CGTCCATTCGGCATCG"	"PT-like_2"
"CGTCTACAGGTGCAAC"	"PEC-like_2"
"CGTCTACAGTACCGGA"	"Proliferating_PT-like"
"CGTCTACCACGACTCG"	"PT-like_1"
"CGTCTACGTGAGGGAG"	"TPC"
"CGTCTACGTGGACGAT"	"PT-like_1"
"CGTGAGCAGATGGCGT"	"TPC"
"CGTGAGCAGCAATCTC"	"DCT_2"
"CGTGAGCAGCGCCTCA"	"TPC"
"CGTGAGCGTGCGGTAA"	"DCT_2"
"CGTGAGCTCCAAAGTC"	"DCT_1"
"CGTGAGCTCCTGTAGA"	"PEC-like_1"
"CGTGTAAAGTAGGCCA"	"DCT_1"
"CGTGTAAGTCATATCG"	"Exclude_highmito"
"CGTGTAATCAGGTTCA"	"PT-like_2"
"CGTGTAATCCGAGCCA"	"PEC-like_2"
"CGTGTAATCTTGACGA"	"PT-like_2"
"CGTGTCTAGGGCTTGA"	"Exclude_highmito"
"CGTGTCTAGGGTGTTG"	"PT-like_1"
"CGTGTCTCAAGCTGGA"	"PT-like_2"
"CGTGTCTCAGACGCCT"	"DCT_2"
"CGTGTCTTCTAACTTC"	"Exclude_highmito"
"CGTTAGAAGAGCCTAG"	"DCT_1"
"CGTTAGACAGACTCGC"	"PT-like_2"
"CGTTAGAGTCTCTCGT"	"Proliferating_PT-like"
"CGTTAGAGTTTGGCGC"	"DCT_1"
"CGTTAGATCGCGATCG"	"Exclude_highmito"
"CGTTCTGAGGGATCTG"	"PT-like_1"
"CGTTCTGCACCTGGTG"	"PT-like_2"
"CGTTCTGCATCAGTAC"	"DCT_2"
"CGTTCTGGTCGTGGCT"	"Exclude_highmito"
"CGTTCTGGTGAGGGAG"	"DCT_1"
"CGTTCTGTCCGTCAAA"	"DCT_2"
"CGTTGGGAGTATCTCG"	"PT-like_1"
"CGTTGGGAGTGCGATG"	"PT-like_1"
"CGTTGGGCAATAAGCA"	"DCT_2"
"CGTTGGGCACGCATCG"	"DCT_1"
"CGTTGGGGTCTGGTCG"	"Proliferating_PT-like"
"CTAACTTAGTTAACGA"	"DCT_1"
"CTAACTTTCAACGCTA"	"DCT_2"
"CTAACTTTCGCCATAA"	"PT-like_2"
"CTAAGACAGAGACGAA"	"PT-like_1"
"CTAAGACAGAGCTGCA"	"Exclude_highmito"
"CTAAGACAGTCTCCTC"	"Proliferating_PT-like"
"CTAAGACCAATCCAAC"	"PT-like_2"
"CTAAGACCACCTTGTC"	"Exclude_highribosomal"
"CTAAGACGTAAATGTG"	"DCT_1"
"CTAATGGCATAAGACA"	"TPC"
"CTAATGGGTTCCTCCA"	"Proliferating_PT-like"
"CTACACCAGACGCAAC"	"DCT_2"
"CTACACCAGATGCGAC"	"PT-like_2"
"CTACACCAGCACACAG"	"Exclude_highmito"
"CTACACCAGTGGTAGC"	"TPC"
"CTACACCCAGCTCGAC"	"DCT_2"
"CTACACCCAGGGATTG"	"PT-like_1"
"CTACACCGTACGACCC"	"PT-like_2"
"CTACACCGTTCCGTCT"	"DCT_1"
"CTACATTAGACAGACC"	"DCT_2"
"CTACATTAGGACTGGT"	"DCT_1"
"CTACATTAGTAGATGT"	"PT-like_2"
"CTACATTCAAACGTGG"	"PT-like_1"
"CTACATTCAGTAACGG"	"PT-like_2"
"CTACATTGTTAAGACA"	"Exclude_highmito"
"CTACATTGTTACCAGT"	"Exclude_highmito"
"CTACATTTCTCCCTGA"	"DCT_2"
"CTACCCAAGGAGTTGC"	"DCT_1"
"CTACCCAAGGATGGAA"	"PT-like_1"
"CTACCCAAGGGTCTCC"	"DCT_1"
"CTACCCAAGTACGCGA"	"TPC"
"CTACCCAGTAGAGCTG"	"DCT_1"
"CTACCCATCGTTTATC"	"TPC"
"CTACGTCAGTGTACTC"	"PT-like_1"
"CTACGTCCACAGAGGT"	"Exclude_highmito"
"CTACGTCCATGTCTCC"	"DCT_1"
"CTACGTCGTAGCGATG"	"PEC-like_2"
"CTACGTCTCCTATTCA"	"TPC"
"CTAGAGTAGATCTGCT"	"Exclude_highmito"
"CTAGAGTAGCAGCCTC"	"DCT_1"
"CTAGAGTAGCTGAAAT"	"DCT_1"
"CTAGAGTTCACCACCT"	"PT-like_2"
"CTAGCCTAGGAGCGTT"	"PT-like_1"
"CTAGCCTAGGCAATTA"	"Exclude_highmito"
"CTAGCCTAGGTGTTAA"	"Exclude_highmito"
"CTAGCCTAGTGCGTGA"	"DCT_2"
"CTAGCCTCAATGGATA"	"DCT_1"
"CTAGCCTGTCACAAGG"	"Exclude_highribosomal"
"CTAGCCTGTCTAGCCG"	"DCT_2"
"CTAGCCTTCGGCCGAT"	"Proliferating_PT-like"
"CTAGCCTTCTGTCTCG"	"Proliferating_PT-like"
"CTAGTGAAGATCGATA"	"TPC"
"CTAGTGAAGCCACGCT"	"Proliferating_PT-like"
"CTAGTGAAGCTGAACG"	"PEC-like_1"
"CTAGTGAAGGTAGCCA"	"Exclude_highmito"
"CTAGTGACAAACGCGA"	"PT-like_1"
"CTAGTGACACCAGATT"	"Proliferating_PT-like"
"CTAGTGACACCGAATT"	"PT-like_1"
"CTAGTGACACTGTTAG"	"DCT_1"
"CTCACACAGAACAATC"	"PT-like_1"
"CTCACACAGCGTGAGT"	"PEC-like_1"
"CTCACACAGGGAGTAA"	"DCT_1"
"CTCACACCAAGCCGCT"	"PT-like_1"
"CTCACACCACTGTTAG"	"TPC"
"CTCACACCATGCTGGC"	"DCT_2"
"CTCACACTCGCATGGC"	"TPC"
"CTCAGAACATACGCTA"	"PT-like_1"
"CTCAGAACATCCCACT"	"Exclude_highribosomal"
"CTCAGAACATGAAGTA"	"Proliferating_PT-like"
"CTCAGAAGTCATATGC"	"Exclude_highmito"
"CTCAGAAGTCTAAAGA"	"Exclude_highribosomal"
"CTCAGAAGTTTAGCTG"	"TPC"
"CTCAGAATCATAAAGG"	"Exclude_highmito"
"CTCAGAATCCCATTAT"	"Exclude_highmito"
"CTCAGAATCCTGTACC"	"Exclude_highmito"
"CTCATTAGTTGCCTCT"	"TPC"
"CTCATTATCGCCCTTA"	"PT-like_1"
"CTCATTATCGGGAGTA"	"DCT_1"
"CTCCTAGAGGACATTA"	"DCT_1"
"CTCCTAGCAGGCTCAC"	"Exclude_highribosomal"
"CTCCTAGCATACGCCG"	"DCT_1"
"CTCCTAGCATTCACTT"	"DCT_1"
"CTCCTAGCATTGTGCA"	"Exclude_highmito"
"CTCCTAGGTGCGGTAA"	"PT-like_1"
"CTCCTAGGTTCACGGC"	"DCT_2"
"CTCCTAGGTTCCGGCA"	"PT-like_2"
"CTCCTAGTCGCAAGCC"	"PT-like_1"
"CTCCTAGTCTAACTCT"	"DCT_2"
"CTCCTAGTCTGCCCTA"	"Exclude_highmito"
"CTCGAAAAGATGTGGC"	"DCT_2"
"CTCGAAAAGGGAAACA"	"Exclude_highmito"
"CTCGAAAAGTTAGCGG"	"PT-like_2"
"CTCGAAACAAGGGTCA"	"PT-like_1"
"CTCGAAACAGGCGATA"	"TPC"
"CTCGAAACATCCGTGG"	"Exclude_highmito"
"CTCGAAAGTTCGGGCT"	"Proliferating_PT-like"
"CTCGAAATCCGTAGGC"	"DCT_2"
"CTCGAAATCCTCATTA"	"Proliferating_PT-like"
"CTCGAAATCTACCTGC"	"PT-like_1"
"CTCGAGGAGACTAGGC"	"PT-like_2"
"CTCGAGGCAGAAGCAC"	"PT-like_1"
"CTCGAGGCAGAGTGTG"	"PT-like_1"
"CTCGAGGCAGCCTATA"	"PT-like_1"
"CTCGAGGCAGGTCCAC"	"Exclude_highmito"
"CTCGAGGCATGCTAGT"	"PT-like_1"
"CTCGAGGGTAGCTAAA"	"Exclude_highmito"
"CTCGAGGGTCGCGGTT"	"PT-like_1"
"CTCGAGGGTGTTCTTT"	"DCT_2"
"CTCGAGGTCAGCTCTC"	"DCT_1"
"CTCGAGGTCCTCGCAT"	"DCT_2"
"CTCGAGGTCTTATCTG"	"PT-like_1"
"CTCGGAGCACAGTCGC"	"TPC"
"CTCGGAGGTGAAATCA"	"PT-like_1"
"CTCGGAGTCAAGGCTT"	"Proliferating_PT-like"
"CTCGGGAAGTAGCGGT"	"PT-like_2"
"CTCGGGAAGTTATCGC"	"Exclude_highmito"
"CTCGGGATCCTGCTTG"	"TPC"
"CTCGGGATCTCTAAGG"	"PT-like_1"
"CTCGTACGTGAGGGAG"	"Exclude_highribosomal"
"CTCGTACGTTTGGCGC"	"TPC"
"CTCGTCAAGCTCCCAG"	"PT-like_2"
"CTCGTCAGTTTAGGAA"	"DCT_1"
"CTCGTCATCCTAGGGC"	"Proliferating_PT-like"
"CTCGTCATCTAACTTC"	"PT-like_2"
"CTCTAATAGGCCATAG"	"PT-like_2"
"CTCTAATAGTCCCACG"	"PT-like_2"
"CTCTAATAGTGGGATC"	"Proliferating_PT-like"
"CTCTAATAGTTGAGAT"	"DCT_1"
"CTCTAATCAGTTAACC"	"Proliferating_PT-like"
"CTCTAATGTTTCCACC"	"DCT_2"
"CTCTAATTCAGGCAAG"	"TPC"
"CTCTAATTCCACGTTC"	"TPC"
"CTCTAATTCCCTCTTT"	"Exclude_highribosomal"
"CTCTAATTCGAATCCA"	"TPC"
"CTCTACGAGAGACTTA"	"Exclude_highribosomal"
"CTCTACGAGCGTTTAC"	"DCT_2"
"CTCTACGCAGACGCTC"	"PT-like_1"
"CTCTACGCATGCATGT"	"PT-like_2"
"CTCTACGGTATTCTCT"	"DCT_1"
"CTCTACGGTGGTCCGT"	"PT-like_2"
"CTCTACGTCGCATGAT"	"DCT_1"
"CTCTGGTAGACTGTAA"	"PT-like_2"
"CTCTGGTAGCAAATCA"	"PT-like_2"
"CTCTGGTAGGGTCTCC"	"TPC"
"CTCTGGTCACGACGAA"	"Exclude_highmito"
"CTCTGGTCAGATGGGT"	"PT-like_1"
"CTCTGGTTCCGTACAA"	"PT-like_1"
"CTGAAACAGCCGATTT"	"DCT_1"
"CTGAAACAGGCAATTA"	"Exclude_highmito"
"CTGAAACGTAGGCATG"	"Exclude_highribosomal"
"CTGAAACGTGAGTATA"	"Exclude_highmito"
"CTGAAACTCTGATTCT"	"PT-like_2"
"CTGAAACTCTGTCCGT"	"PT-like_1"
"CTGAAGTAGTAGGTGC"	"Proliferating_PT-like"
"CTGAAGTCAACTGCTA"	"DCT_2"
"CTGAAGTCAAGAAGAG"	"DCT_2"
"CTGAAGTCAATGAATG"	"PT-like_1"
"CTGAAGTCACAGATTC"	"Exclude_highmito"
"CTGAAGTCACCGAAAG"	"PT-like_2"
"CTGAAGTCATACTACG"	"PT-like_2"
"CTGAAGTGTTTGTTGG"	"Exclude_highribosomal"
"CTGATAGAGCCACGCT"	"DCT_1"
"CTGATAGAGGACAGAA"	"DCT_2"
"CTGATAGCAAATACAG"	"DCT_1"
"CTGATAGCAAGAGTCG"	"DCT_1"
"CTGATAGGTAGCGTAG"	"DCT_2"
"CTGATAGTCGCAGGCT"	"PT-like_2"
"CTGATAGTCTCACATT"	"DCT_2"
"CTGATCCAGACTAGAT"	"PEC-like_2"
"CTGATCCCAGTGGGAT"	"PT-like_2"
"CTGATCCGTAGGCTGA"	"PT-like_1"
"CTGCCTACAGTCGATT"	"PEC-like_2"
"CTGCCTAGTTCCTCCA"	"PEC-like_2"
"CTGCCTATCAGAGGTG"	"PT-like_2"
"CTGCCTATCCCAAGAT"	"Exclude_highmito"
"CTGCCTATCCTCAATT"	"PT-like_1"
"CTGCGGACAATCCAAC"	"PT-like_2"
"CTGCGGACACTTCGAA"	"PT-like_1"
"CTGCGGACAGTGACAG"	"DCT_2"
"CTGCGGACATTACGAC"	"DCT_1"
"CTGCGGAGTTCGTGAT"	"DCT_2"
"CTGCGGAGTTTGACAC"	"PT-like_2"
"CTGCTGTAGCAGGCTA"	"PT-like_1"
"CTGCTGTCAGATCGGA"	"Exclude_highmito"
"CTGCTGTGTGCATCTA"	"PT-like_2"
"CTGGTCTAGGGAGTAA"	"Proliferating_PT-like"
"CTGGTCTAGGGCACTA"	"PT-like_1"
"CTGGTCTCACATTTCT"	"DCT_1"
"CTGGTCTCAGTAGAGC"	"DCT_2"
"CTGGTCTGTAAGGGCT"	"Proliferating_PT-like"
"CTGGTCTGTAATCACC"	"Exclude_highmito"
"CTGGTCTGTAGATTAG"	"PT-like_1"
"CTGGTCTGTGTGACCC"	"Exclude_highmito"
"CTGGTCTTCGTATCAG"	"DCT_2"
"CTGTGCTAGAACTCGG"	"PT-like_1"
"CTGTGCTAGAAGCCCA"	"Exclude_highmito"
"CTGTGCTAGATCCCAT"	"PT-like_1"
"CTGTGCTAGGTAGCCA"	"PT-like_2"
"CTGTGCTCATGACGGA"	"TPC"
"CTGTGCTGTAAATGTG"	"DCT_2"
"CTGTGCTTCTACTATC"	"Exclude_highmito"
"CTGTTTACAAACAACA"	"TPC"
"CTGTTTACAGCTTCGG"	"PT-like_1"
"CTGTTTAGTTCTGGTA"	"DCT_2"
"CTGTTTATCGCGTTTC"	"Exclude_highribosomal"
"CTTAACTCAAGCGCTC"	"Exclude_highmito"
"CTTAACTCAGCCTATA"	"DCT_2"
"CTTAACTCATTACGAC"	"PT-like_1"
"CTTAACTGTGCTGTAT"	"Exclude_highribosomal"
"CTTAACTGTTAAGGGC"	"PT-like_1"
"CTTAACTTCGGCTTGG"	"Exclude_highmito"
"CTTACCGAGAGCCCAA"	"DCT_2"
"CTTACCGAGTTAGGTA"	"TPC"
"CTTACCGCAAGCTGGA"	"PT-like_1"
"CTTACCGCAGTCACTA"	"PT-like_1"
"CTTACCGCATACCATG"	"Proliferating_PT-like"
"CTTACCGGTGAAGGCT"	"PT-like_2"
"CTTACCGGTGACCAAG"	"Exclude_highmito"
"CTTACCGTCCACTGGG"	"DCT_1"
"CTTAGGAAGTCCGTAT"	"TPC"
"CTTAGGAAGTGTCCCG"	"PT-like_2"
"CTTAGGACATCGGAAG"	"PEC-like_1"
"CTTAGGACATCGGTTA"	"DCT_1"
"CTTAGGATCATCATTC"	"Exclude_highmito"
"CTTCTCTAGTTCGCGC"	"DCT_1"
"CTTCTCTCAGACAAGC"	"PT-like_2"
"CTTCTCTGTTAGGGTG"	"Exclude_highribosomal"
"CTTCTCTGTTTACTCT"	"PEC-like_2"
"CTTCTCTTCCTAGGGC"	"Proliferating_PT-like"
"CTTCTCTTCTGACCTC"	"DCT_1"
"CTTGGCTAGATGGCGT"	"TPC"
"CTTGGCTAGTCGTTTG"	"PT-like_1"
"CTTGGCTCAGGGTACA"	"PT-like_1"
"CTTGGCTTCCCGGATG"	"DCT_1"
"CTTGGCTTCTCGATGA"	"PT-like_1"
"CTTTGCGCAAGTACCT"	"DCT_1"
"CTTTGCGCACAGTCGC"	"DCT_2"
"CTTTGCGGTAAGAGGA"	"Exclude_highmito"
"CTTTGCGGTACCAGTT"	"Proliferating_PT-like"
"CTTTGCGGTATAGGTA"	"DCT_1"
"CTTTGCGGTCGAAAGC"	"PEC-like_1"
"CTTTGCGGTGCCTGCA"	"PT-like_1"
"CTTTGCGTCAACACAC"	"DCT_1"
"CTTTGCGTCTAACTGG"	"PEC-like_1"
"CTTTGCGTCTACTTAC"	"DCT_1"
"GAAACTCAGACTAGGC"	"Exclude_highmito"
"GAAACTCAGGGCTCTC"	"Proliferating_PT-like"
"GAAACTCCAAGGTTCT"	"DCT_1"
"GAAACTCGTTCTGGTA"	"PEC-like_2"
"GAAACTCGTTGAGTTC"	"DCT_2"
"GAAATGAAGAGGTACC"	"Exclude_highmito"
"GAAATGAAGATAGTCA"	"DCT_2"
"GAAATGAAGTTCGATC"	"PT-like_2"
"GAAATGACAAGAAAGG"	"DCT_1"
"GAAATGACACGTCTCT"	"PT-like_2"
"GAAATGAGTTCAGCGC"	"PEC-like_2"
"GAAATGATCCCAGGTG"	"TPC"
"GAAATGATCGTAGATC"	"PT-like_1"
"GAACATCAGAGTTGGC"	"PT-like_1"
"GAACATCAGCGCTTAT"	"TPC"
"GAACATCCACGACGAA"	"PT-like_1"
"GAACATCGTAAATGAC"	"DCT_1"
"GAACATCGTGATGTGG"	"PT-like_2"
"GAACATCTCATAACCG"	"PT-like_2"
"GAACATCTCCTGTAGA"	"PT-like_1"
"GAACCTAAGTATCGAA"	"Exclude_highmito"
"GAACCTACAATTCCTT"	"Exclude_highribosomal"
"GAACCTACACTTGGAT"	"Proliferating_PT-like"
"GAACCTACAGTGAGTG"	"TPC"
"GAACCTATCCATGAAC"	"DCT_1"
"GAACCTATCTGACCTC"	"DCT_1"
"GAACGGAAGATATACG"	"PT-like_2"
"GAACGGAAGATGTGGC"	"PT-like_2"
"GAACGGACAATCCAAC"	"Proliferating_PT-like"
"GAAGCAGAGACTTTCG"	"PT-like_2"
"GAAGCAGAGCAATATG"	"Proliferating_PT-like"
"GAAGCAGAGGCTAGCA"	"TPC"
"GAAGCAGCACGGCGTT"	"DCT_1"
"GAAGCAGGTGCACGAA"	"DCT_1"
"GAAGCAGGTTCCTCCA"	"Exclude_highmito"
"GAATAAGCAAGAAAGG"	"DCT_1"
"GAATAAGCATAAGACA"	"Proliferating_PT-like"
"GAATAAGGTAAATGAC"	"Proliferating_PT-like"
"GAATAAGTCAGAGGTG"	"PEC-like_1"
"GAATGAAAGGATCGCA"	"PT-like_2"
"GAATGAAAGTCCTCCT"	"PT-like_1"
"GAATGAACATTCACTT"	"PT-like_1"
"GAATGAATCCTTGACC"	"PT-like_1"
"GAATGAATCGAGAGCA"	"DCT_1"
"GACACGCAGCCTATGT"	"DCT_2"
"GACACGCAGCGTTCCG"	"PT-like_1"
"GACACGCAGCTAAGAT"	"TPC"
"GACACGCCATCGACGC"	"Exclude_highmito"
"GACACGCGTTCATGGT"	"TPC"
"GACACGCTCAGTTTGG"	"PT-like_1"
"GACACGCTCTGAAAGA"	"Exclude_highmito"
"GACACGCTCTGCAAGT"	"PT-like_1"
"GACAGAGAGGACACCA"	"PT-like_2"
"GACAGAGAGGTCATCT"	"PT-like_2"
"GACAGAGCATCAGTCA"	"Exclude_highmito"
"GACAGAGGTTCAGCGC"	"PT-like_1"
"GACAGAGGTTGTTTGG"	"TPC"
"GACAGAGGTTTGACAC"	"Exclude_highmito"
"GACAGAGTCTAACTGG"	"PT-like_1"
"GACAGAGTCTTCATGT"	"PT-like_1"
"GACCAATAGATGTCGG"	"PEC-like_1"
"GACCAATAGCTTCGCG"	"DCT_1"
"GACCAATAGGGAACGG"	"Proliferating_PT-like"
"GACCAATGTCCTCTTG"	"PT-like_2"
"GACCAATGTCTAACGT"	"PT-like_1"
"GACCAATGTGCACTTA"	"TPC"
"GACCAATGTGCTTCTC"	"Exclude_highmito"
"GACCAATTCGCGATCG"	"PT-like_1"
"GACCTGGAGCTGTTCA"	"TPC"
"GACCTGGCAAAGAATC"	"DCT_2"
"GACCTGGCATGGTCTA"	"PT-like_1"
"GACCTGGGTACATGTC"	"DCT_1"
"GACCTGGGTAGCCTAT"	"Proliferating_PT-like"
"GACCTGGTCAACACCA"	"PT-like_2"
"GACCTGGTCATCGCTC"	"Exclude_highribosomal"
"GACGCGTAGGCCATAG"	"PT-like_1"
"GACGCGTGTGACTACT"	"PT-like_1"
"GACGCGTGTGGTAACG"	"TPC"
"GACGCGTTCCAAACAC"	"Exclude_highmito"
"GACGCGTTCCCTTGTG"	"DCT_2"
"GACGCGTTCTATCCCG"	"DCT_1"
"GACGGCTAGCCTATGT"	"DCT_2"
"GACGGCTCAAACCTAC"	"DCT_1"
"GACGGCTCAGATTGCT"	"Exclude_highmito"
"GACGGCTCAGGTCTCG"	"PEC-like_1"
"GACGGCTGTCTAAACC"	"PT-like_1"
"GACGGCTTCTGGTGTA"	"PT-like_1"
"GACGGCTTCTTGTATC"	"Exclude_highmito"
"GACGTGCCAAGTTCTG"	"DCT_1"
"GACGTGCCACTATCTT"	"Exclude_highribosomal"
"GACGTGCGTAAGGATT"	"TPC"
"GACGTGCGTCGTCTTC"	"Exclude_highmito"
"GACGTGCGTCTGCGGT"	"DCT_1"
"GACGTGCGTTCGGCAC"	"TPC"
"GACGTGCTCAGGCCCA"	"DCT_1"
"GACGTGCTCAGTCAGT"	"PT-like_2"
"GACGTGCTCGAACGGA"	"PT-like_1"
"GACGTGCTCGAATCCA"	"PT-like_1"
"GACGTTAAGGATCGCA"	"DCT_2"
"GACGTTACAGGCAGTA"	"DCT_2"
"GACGTTAGTCATCCCT"	"PEC-like_1"
"GACGTTAGTGAGTGAC"	"TPC"
"GACGTTAGTGATAAAC"	"DCT_1"
"GACGTTAGTGTGACGA"	"Proliferating_PT-like"
"GACGTTATCGAGAACG"	"Proliferating_PT-like"
"GACTAACAGATGCGAC"	"PT-like_2"
"GACTAACCAAGTTGTC"	"DCT_1"
"GACTAACCACCTCGTT"	"TPC"
"GACTAACGTCCGAACC"	"DCT_2"
"GACTAACTCTATCCCG"	"Exclude_highribosomal"
"GACTAACTCTTACCTA"	"PT-like_2"
"GACTACACACATGACT"	"PT-like_2"
"GACTACACACTGCCAG"	"PT-like_2"
"GACTACAGTAGAGCTG"	"DCT_1"
"GACTACATCTGGAGCC"	"PEC-like_1"
"GACTGCGAGAGTTGGC"	"PT-like_1"
"GACTGCGAGGCTCATT"	"PT-like_1"
"GACTGCGAGGTGTTAA"	"DCT_1"
"GACTGCGCACCGAAAG"	"DCT_1"
"GACTGCGCAGACGCAA"	"PT-like_1"
"GACTGCGCATAGACTC"	"TPC"
"GACTGCGGTCAGCTAT"	"Proliferating_PT-like"
"GAGCAGATCCGCATAA"	"PT-like_1"
"GAGGTGACAGATCCAT"	"DCT_2"
"GAGGTGACAGTTTACG"	"DCT_1"
"GAGGTGACATGACATC"	"Exclude_highmito"
"GAGGTGAGTCCCTACT"	"PT-like_1"
"GAGTCCGCAAGAAGAG"	"Proliferating_PT-like"
"GAGTCCGCAGATAATG"	"Exclude_highmito"
"GAGTCCGCATGCTAGT"	"PT-like_1"
"GAGTCCGGTCTAGCGC"	"PT-like_1"
"GAGTCCGGTTCGGGCT"	"PT-like_1"
"GAGTCCGTCTCCTATA"	"DCT_2"
"GATCAGTCATACTACG"	"PT-like_1"
"GATCAGTGTACTCTCC"	"PT-like_1"
"GATCAGTGTGTATGGG"	"DCT_1"
"GATCAGTTCAACGCTA"	"Exclude_highmito"
"GATCAGTTCACTTACT"	"Exclude_highmito"
"GATCAGTTCCATGAAC"	"Exclude_highmito"
"GATCGATAGCTAGCCC"	"PT-like_1"
"GATCGATAGGGCTTGA"	"PT-like_1"
"GATCGATAGGTACTCT"	"Exclude_highmito"
"GATCGATCACGGTTTA"	"TPC"
"GATCGATCATCACGTA"	"DCT_1"
"GATCGATGTAAAGTCA"	"PT-like_1"
"GATCGATGTTATGTGC"	"PT-like_1"
"GATCGATGTTGAGGTG"	"DCT_2"
"GATCGATTCCGTACAA"	"DCT_2"
"GATCGCGAGATGTGTA"	"PT-like_1"
"GATCGCGAGCGATGAC"	"PT-like_2"
"GATCGCGAGGATGGTC"	"Exclude_highmito"
"GATCGCGCAGTAAGAT"	"TPC"
"GATCGCGGTAAGAGGA"	"TPC"
"GATCGCGGTTTGACAC"	"PT-like_1"
"GATCGCGTCACTATTC"	"PT-like_1"
"GATCGCGTCCACGACG"	"Proliferating_PT-like"
"GATCGTAAGATGCCAG"	"Exclude_highribosomal"
"GATCGTAAGCCTTGAT"	"PEC-like_1"
"GATCGTAAGGAGTTTA"	"PT-like_1"
"GATCGTACAACGCACC"	"PEC-like_2"
"GATCGTACAGGTCTCG"	"DCT_1"
"GATCGTAGTAAATGAC"	"PT-like_1"
"GATCGTAGTTTGTGTG"	"PT-like_1"
"GATCTAGCATAGACTC"	"DCT_1"
"GATCTAGGTCTAGTGT"	"PT-like_1"
"GATCTAGTCTTTAGGG"	"TPC"
"GATGAAAAGGTAGCCA"	"Proliferating_PT-like"
"GATGAAACACAACTGT"	"PT-like_1"
"GATGAAACATCCCACT"	"PT-like_1"
"GATGAAATCCAAGTAC"	"PT-like_1"
"GATGAGGAGGTAGCTG"	"DCT_2"
"GATGAGGCAGAGTGTG"	"DCT_2"
"GATGAGGCAGGCGATA"	"DCT_2"
"GATGAGGTCACTTATC"	"Exclude_highmito"
"GATGAGGTCGCCAAAT"	"PT-like_2"
"GATGCTACAAAGTGCG"	"PT-like_2"
"GATGCTAGTTCACCTC"	"DCT_1"
"GATGCTATCAGAGCTT"	"PT-like_2"
"GATGCTATCCGCTGTT"	"DCT_1"
"GATTCAGAGATAGGAG"	"PT-like_2"
"GATTCAGCAATCAGAA"	"DCT_1"
"GATTCAGCAATCGGTT"	"PT-like_1"
"GATTCAGCACCCATTC"	"PT-like_1"
"GATTCAGGTTACGTCA"	"Proliferating_PT-like"
"GCAAACTAGTACGTTC"	"DCT_2"
"GCAAACTCAGCAGTTT"	"TPC"
"GCAAACTCAGGCGATA"	"PT-like_2"
"GCAAACTGTCGAAAGC"	"PT-like_1"
"GCAAACTGTGCAGTAG"	"DCT_2"
"GCAAACTTCACCATAG"	"DCT_1"
"GCAAACTTCTCAAGTG"	"DCT_1"
"GCAAACTTCTGACCTC"	"PT-like_1"
"GCAATCAAGCTATGCT"	"PT-like_1"
"GCAATCAAGTAGATGT"	"TPC"
"GCAATCACAATGGAGC"	"DCT_2"
"GCAATCAGTTATCGGT"	"DCT_2"
"GCAATCATCGGCCGAT"	"Proliferating_PT-like"
"GCACATACACGCGAAA"	"PT-like_1"
"GCACATACAGCATACT"	"DCT_1"
"GCACATACAGGGCATA"	"TPC"
"GCACATACATCCGGGT"	"DCT_2"
"GCACATACATCGTCGG"	"PT-like_1"
"GCACATAGTAAATGTG"	"DCT_1"
"GCACATAGTCATACTG"	"DCT_1"
"GCACATATCGCCCTTA"	"PT-like_1"
"GCACTCTAGGGCTTCC"	"TPC"
"GCACTCTCACATAACC"	"PT-like_1"
"GCACTCTGTTCCACTC"	"TPC"
"GCACTCTTCTCTTGAT"	"Exclude_highmito"
"GCACTCTTCTGTCTCG"	"DCT_1"
"GCAGCCAAGGGAACGG"	"DCT_2"
"GCAGCCACAACACGCC"	"PT-like_2"
"GCAGCCAGTATATGAG"	"Proliferating_PT-like"
"GCAGCCAGTTACGACT"	"PT-like_1"
"GCAGCCAGTTTGGCGC"	"Proliferating_PT-like"
"GCAGCCATCCGTACAA"	"DCT_2"
"GCAGCCATCTCCGGTT"	"PEC-like_1"
"GCAGTTAAGAAGGTTT"	"PEC-like_1"
"GCAGTTAAGGGAACGG"	"PT-like_2"
"GCAGTTAAGTTAACGA"	"DCT_2"
"GCAGTTACATGTAAGA"	"PT-like_1"
"GCAGTTAGTGCTGTAT"	"Exclude_highmito"
"GCAGTTAGTTCAGGCC"	"TPC"
"GCAGTTAGTTGCTCCT"	"TPC"
"GCATACAAGTAGATGT"	"PEC-like_1"
"GCATACACATCTCCCA"	"PT-like_1"
"GCATACATCTGTCAAG"	"TPC"
"GCATGATAGTTAAGTG"	"Proliferating_PT-like"
"GCATGATAGTTGTAGA"	"TPC"
"GCATGATCAAGCCGCT"	"PT-like_1"
"GCATGATCATCGGAAG"	"TPC"
"GCATGATGTACTTAGC"	"TPC"
"GCATGATGTCTTCTCG"	"DCT_1"
"GCATGATTCCAGAAGG"	"DCT_1"
"GCATGATTCCGATATG"	"DCT_2"
"GCATGCGAGATGGCGT"	"PT-like_2"
"GCATGCGCATCCCACT"	"PT-like_1"
"GCATGCGGTAATCGTC"	"Exclude_highmito"
"GCATGCGGTATATCCG"	"PT-like_2"
"GCATGCGGTATTCTCT"	"Exclude_highmito"
"GCATGCGGTTACGGAG"	"PT-like_1"
"GCATGTAAGTTTCCTT"	"PT-like_2"
"GCATGTACAGACGCAA"	"PT-like_1"
"GCATGTAGTCCGACGT"	"PT-like_2"
"GCATGTATCTACTTAC"	"PT-like_2"
"GCCAAATAGGACAGAA"	"TPC"
"GCCAAATGTCACTGGC"	"PT-like_1"
"GCCAAATGTCATATCG"	"DCT_1"
"GCCAAATTCCCTAATT"	"Proliferating_PT-like"
"GCCAAATTCCTACAGA"	"TPC"
"GCCTCTAAGCCGGTAA"	"TPC"
"GCCTCTAAGCGTGTCC"	"DCT_2"
"GCCTCTAAGCTGCCCA"	"PT-like_1"
"GCCTCTACAATCTACG"	"Exclude_highmito"
"GCCTCTAGTCGGGTCT"	"DCT_1"
"GCCTCTAGTGAGTATA"	"DCT_1"
"GCCTCTAGTGTCTGAT"	"TPC"
"GCGACCAAGGAATGGA"	"PT-like_2"
"GCGACCACAGACGCCT"	"PEC-like_2"
"GCGACCAGTAGGACAC"	"Exclude_highmito"
"GCGAGAACAATGGACG"	"DCT_2"
"GCGAGAACAGTATGCT"	"PT-like_1"
"GCGAGAAGTACTCGCG"	"PT-like_1"
"GCGAGAAGTCATATCG"	"Proliferating_PT-like"
"GCGAGAAGTCGCATAT"	"TPC"
"GCGAGAAGTCGTTGTA"	"PT-like_1"
"GCGAGAATCGCCAGCA"	"TPC"
"GCGAGAATCGTACGGC"	"Proliferating_PT-like"
"GCGCAACCAACACCTA"	"TPC"
"GCGCAACCACTGCCAG"	"PT-like_1"
"GCGCAACCATGTCTCC"	"PT-like_1"
"GCGCAACGTAATCGTC"	"DCT_1"
"GCGCAACGTATTCTCT"	"DCT_2"
"GCGCAACGTGCCTGGT"	"PT-like_1"
"GCGCAACGTGTTCGAT"	"DCT_2"
"GCGCAACTCGCCATAA"	"DCT_2"
"GCGCCAACATCTATGG"	"PT-like_1"
"GCGCCAATCTAACCGA"	"TPC"
"GCGCGATAGCACCGTC"	"DCT_1"
"GCGCGATAGGATGGAA"	"PT-like_2"
"GCGCGATAGGCAATTA"	"PT-like_1"
"GCGCGATAGGCTAGCA"	"PT-like_1"
"GCGCGATAGTGGTCCC"	"Exclude_highmito"
"GCGCGATGTAAACCTC"	"PT-like_1"
"GCGGGTTAGCCGATTT"	"Exclude_highribosomal"
"GCGGGTTAGCTTTGGT"	"PEC-like_1"
"GCGGGTTCATGATCCA"	"DCT_2"
"GCTCCTACAATCCGAT"	"TPC"
"GCTCCTACACAGGAGT"	"DCT_2"
"GCTCCTAGTGTGGCTC"	"PT-like_1"
"GCTCCTAGTTAGTGGG"	"PT-like_1"
"GCTCCTATCTCGAGTA"	"DCT_1"
"GCTCCTATCTTCGGTC"	"DCT_2"
"GCTCTGTCATGTTCCC"	"TPC"
"GCTCTGTTCACCCGAG"	"Proliferating_PT-like"
"GCTCTGTTCTGCTTGC"	"Exclude_highmito"
"GCTGCAGCAGGTCCAC"	"Proliferating_PT-like"
"GCTGCAGCATGACGGA"	"PT-like_2"
"GCTGCAGCATTCCTCG"	"Exclude_highmito"
"GCTGCAGCATTCGACA"	"TPC"
"GCTGCAGGTCAACATC"	"PT-like_2"
"GCTGCAGGTGTGGTTT"	"DCT_2"
"GCTGCAGGTTCGCGAC"	"Proliferating_PT-like"
"GCTGCAGTCCAAAGTC"	"DCT_2"
"GCTGCAGTCCATTCTA"	"TPC"
"GCTGCAGTCCCTTGCA"	"PT-like_2"
"GCTGCAGTCGTCTGAA"	"DCT_1"
"GCTGCAGTCTTTAGGG"	"PT-like_1"
"GCTGCGAGTGCAGTAG"	"DCT_2"
"GCTGCGATCGGAAACG"	"DCT_2"
"GCTGCTTAGGATATAC"	"TPC"
"GCTGCTTAGTGGTAAT"	"DCT_2"
"GCTGCTTCAACTGCGC"	"DCT_2"
"GCTGCTTCAGGACGTA"	"PT-like_1"
"GCTGCTTGTCACTGGC"	"Proliferating_PT-like"
"GCTGCTTGTCATGCCG"	"PT-like_2"
"GCTGCTTGTCCATGAT"	"PT-like_1"
"GCTGCTTGTCGCATCG"	"DCT_1"
"GCTGCTTGTCTTTCAT"	"PT-like_2"
"GCTGCTTTCATGTAGC"	"DCT_1"
"GCTGGGTAGAGGGCTT"	"PT-like_1"
"GCTGGGTAGGTCATCT"	"PT-like_1"
"GCTGGGTAGTTGAGAT"	"Exclude_highmito"
"GCTGGGTGTGTTTGGT"	"Exclude_highmito"
"GCTGGGTTCAGGTTCA"	"Proliferating_PT-like"
"GCTTCCAAGAGGGCTT"	"DCT_2"
"GCTTCCAAGGTCGGAT"	"DCT_1"
"GCTTCCACAAGCGTAG"	"DCT_1"
"GCTTCCACACCTGGTG"	"DCT_1"
"GCTTCCAGTCATCGGC"	"PT-like_1"
"GCTTCCATCGCCATAA"	"PEC-like_1"
"GCTTGAACACGGCGTT"	"PT-like_2"
"GCTTGAACAGTACACT"	"PT-like_2"
"GCTTGAAGTGCAACGA"	"Exclude_highmito"
"GCTTGAAGTTACGACT"	"DCT_2"
"GCTTGAAGTTCACCTC"	"DCT_1"
"GCTTGAATCTAGCACA"	"TPC"
"GGAAAGCCACGTGAGA"	"PT-like_1"
"GGAAAGCGTGGACGAT"	"PT-like_1"
"GGAAAGCTCTTCAACT"	"TPC"
"GGAACTTAGCGTGAAC"	"Proliferating_PT-like"
"GGAACTTAGTCTCCTC"	"PT-like_1"
"GGAACTTCAGGATTGG"	"PT-like_1"
"GGAACTTTCACTTACT"	"Proliferating_PT-like"
"GGAATAAAGACAGACC"	"PT-like_2"
"GGAATAAAGGGATACC"	"DCT_2"
"GGAATAACACGGCCAT"	"TPC"
"GGAATAACAGGGTACA"	"Exclude_highribosomal"
"GGAATAACAGTACACT"	"DCT_1"
"GGAATAATCCCTAACC"	"TPC"
"GGAATAATCCTCAATT"	"DCT_1"
"GGAATAATCTGTTGAG"	"DCT_1"
"GGACAAGAGCAGGCTA"	"PT-like_1"
"GGACAAGAGGCGACAT"	"TPC"
"GGACAAGAGGTGCTTT"	"DCT_1"
"GGACAAGTCAAGCCTA"	"Exclude_highribosomal"
"GGACAAGTCCATGCTC"	"DCT_1"
"GGACAGAAGTTCGCGC"	"DCT_2"
"GGACAGACAAAGCGGT"	"TPC"
"GGACAGACACTAAGTC"	"Exclude_highmito"
"GGACAGACATATACGC"	"PT-like_1"
"GGACAGATCTCCCTGA"	"PEC-like_2"
"GGACAGATCTTACCTA"	"TPC"
"GGACATTAGCCGCCTA"	"DCT_1"
"GGACATTGTGCACGAA"	"PT-like_1"
"GGACATTGTTGATTGC"	"DCT_2"
"GGACATTTCAGGCCCA"	"PT-like_1"
"GGACGTCAGGCCATAG"	"Exclude_highmito"
"GGACGTCAGTGATCGG"	"DCT_1"
"GGACGTCAGTTACGGG"	"PT-like_2"
"GGACGTCGTACAAGTA"	"Exclude_highmito"
"GGACGTCTCGCGATCG"	"DCT_1"
"GGAGCAAAGAACTCGG"	"Proliferating_PT-like"
"GGAGCAAAGTGGGCTA"	"TPC"
"GGAGCAACAAGGACAC"	"Proliferating_PT-like"
"GGAGCAACAATGACCT"	"DCT_2"
"GGAGCAACAGCGTAAG"	"DCT_1"
"GGAGCAATCAACCAAC"	"DCT_1"
"GGAGCAATCACAACGT"	"Proliferating_PT-like"
"GGAGCAATCAGCTCGG"	"PT-like_2"
"GGAGCAATCATGTAGC"	"PT-like_1"
"GGATGTTAGCGTGTCC"	"TPC"
"GGATGTTAGTCTTGCA"	"PEC-like_1"
"GGATGTTGTCCGAACC"	"Exclude_highribosomal"
"GGATGTTTCACCTCGT"	"DCT_1"
"GGATTACAGTCCGGTC"	"PT-like_1"
"GGATTACCAATGCCAT"	"DCT_1"
"GGATTACCAGATCGGA"	"PT-like_1"
"GGATTACGTAGCCTCG"	"PT-like_2"
"GGATTACTCGGAAACG"	"Proliferating_PT-like"
"GGCAATTAGTACTTGC"	"DCT_2"
"GGCAATTAGTGAACGC"	"TPC"
"GGCAATTCAAGTAGTA"	"DCT_1"
"GGCAATTCATCTGGTA"	"Proliferating_PT-like"
"GGCAATTGTAGGCTGA"	"PT-like_2"
"GGCCGATAGAGCTGCA"	"DCT_2"
"GGCCGATAGCGTTTAC"	"PT-like_1"
"GGCCGATGTGCGATAG"	"PT-like_2"
"GGCCGATTCCGTTGCT"	"PT-like_2"
"GGCCGATTCGCGCCAA"	"Proliferating_PT-like"
"GGCGACTGTGTCGCTG"	"PT-like_2"
"GGCGACTTCAACACTG"	"Exclude_highribosomal"
"GGCGACTTCTGCGTAA"	"PT-like_2"
"GGCGTGTAGTAACCCT"	"TPC"
"GGCGTGTAGTAGCGGT"	"Exclude_highmito"
"GGCGTGTCATTATCTC"	"TPC"
"GGCGTGTGTGCAGTAG"	"Exclude_highmito"
"GGCGTGTTCGCCATAA"	"Exclude_highmito"
"GGCGTGTTCGGCTTGG"	"Exclude_highmito"
"GGCGTGTTCTACGAGT"	"Exclude_highmito"
"GGCTCGAAGCACCGCT"	"PT-like_2"
"GGCTCGAAGCTGTTCA"	"TPC"
"GGCTCGAAGGAGTTGC"	"PEC-like_2"
"GGCTCGACAATACGCT"	"DCT_1"
"GGCTCGAGTTACCGAT"	"Exclude_highmito"
"GGCTCGATCCTCATTA"	"TPC"
"GGCTGGTCATGGGAAC"	"DCT_1"
"GGCTGGTGTCTCCCTA"	"PT-like_1"
"GGCTGGTGTTATCGGT"	"PT-like_1"
"GGGAATGCACAGACTT"	"PT-like_2"
"GGGAATGCAGTCGTGC"	"DCT_2"
"GGGAATGCATAGTAAG"	"DCT_2"
"GGGAATGGTTGGGACA"	"Proliferating_PT-like"
"GGGACCTAGAAGCCCA"	"PT-like_1"
"GGGACCTAGTGACTCT"	"PT-like_2"
"GGGACCTCAATCTGCA"	"DCT_1"
"GGGACCTCACCCTATC"	"PEC-like_1"
"GGGACCTGTATTCGTG"	"Exclude_highmito"
"GGGACCTTCCGCATAA"	"DCT_1"
"GGGAGATAGGCTAGAC"	"PT-like_1"
"GGGAGATCACGAGAGT"	"Exclude_highmito"
"GGGAGATCATGTCTCC"	"Exclude_highmito"
"GGGAGATGTCGTGGCT"	"Proliferating_PT-like"
"GGGAGATGTGTTGGGA"	"DCT_1"
"GGGAGATTCGTGGGAA"	"DCT_1"
"GGGAGATTCTTGTTTG"	"PT-like_2"
"GGGATGACATGATCCA"	"DCT_1"
"GGGATGAGTCAACATC"	"Exclude_highribosomal"
"GGGATGAGTCCCGACA"	"DCT_1"
"GGGATGATCACCTCGT"	"PT-like_2"
"GGGATGATCTTACCGC"	"TPC"
"GGGCACTCAACACGCC"	"TPC"
"GGGCATCAGCTCTCGG"	"PEC-like_1"
"GGGCATCAGGTGCTAG"	"Proliferating_PT-like"
"GGGCATCAGTAGGCCA"	"PT-like_1"
"GGGCATCCATTTCACT"	"DCT_1"
"GGGCATCTCCTTGCCA"	"PT-like_1"
"GGGCATCTCCTTGGTC"	"PT-like_1"
"GGGTCTGAGAAGAAGC"	"DCT_1"
"GGGTCTGAGATGTAAC"	"TPC"
"GGGTCTGCATATGCTG"	"Exclude_highmito"
"GGGTCTGGTATGCTTG"	"TPC"
"GGGTCTGGTCATGCAT"	"DCT_2"
"GGGTCTGGTGTGTGCC"	"Exclude_highmito"
"GGGTCTGTCAGCTGGC"	"PEC-like_1"
"GGGTCTGTCCGAATGT"	"PT-like_1"
"GGGTCTGTCCTCATTA"	"PT-like_2"
"GGGTTGCAGTACGATA"	"Proliferating_PT-like"
"GGGTTGCAGTCCCACG"	"DCT_2"
"GGGTTGCTCCGCATAA"	"PT-like_1"
"GGTATTGAGAAACCGC"	"Proliferating_PT-like"
"GGTATTGAGCGAAGGG"	"DCT_1"
"GGTATTGAGTGATCGG"	"PT-like_1"
"GGTATTGAGTTCCACA"	"PT-like_2"
"GGTATTGCACGGCCAT"	"PT-like_1"
"GGTATTGTCACGGTTA"	"TPC"
"GGTATTGTCACTTACT"	"TPC"
"GGTATTGTCAGCTCTC"	"PT-like_1"
"GGTGAAGAGTAGATGT"	"PT-like_2"
"GGTGAAGCATCGATTG"	"PT-like_1"
"GGTGAAGGTCATACTG"	"DCT_1"
"GGTGAAGTCGTACCGG"	"PT-like_2"
"GGTGAAGTCTGCGACG"	"DCT_1"
"GGTGCGTAGGATATAC"	"PT-like_1"
"GGTGCGTAGGTCATCT"	"PT-like_2"
"GGTGCGTCAAGGTTTC"	"TPC"
"GGTGCGTGTCCGAATT"	"TPC"
"GGTGCGTGTGTGCGTC"	"Exclude_highmito"
"GGTGCGTGTTGATTGC"	"Exclude_highmito"
"GGTGCGTTCCGAGCCA"	"Exclude_highmito"
"GGTGCGTTCTTGACGA"	"PT-like_2"
"GGTGTTACAAATACAG"	"DCT_1"
"GGTGTTACAGTTTACG"	"Proliferating_PT-like"
"GGTGTTATCAAGGCTT"	"DCT_1"
"GGTGTTATCGCAAACT"	"PT-like_1"
"GTAACGTAGATGGCGT"	"TPC"
"GTAACGTAGGGATGGG"	"Proliferating_PT-like"
"GTAACGTAGGTTACCT"	"PEC-like_2"
"GTAACGTAGTGTGGCA"	"Exclude_highribosomal"
"GTAACGTCATCGGAAG"	"Exclude_highmito"
"GTAACGTGTATAAACG"	"DCT_1"
"GTAACGTTCTGGCGTG"	"PT-like_1"
"GTAACTGAGAGTAATC"	"Exclude_highmito"
"GTAACTGCAGGTCTCG"	"TPC"
"GTAACTGTCTGGTGTA"	"DCT_2"
"GTACGTAAGTGCGTGA"	"DCT_1"
"GTACGTACAATTCCTT"	"Proliferating_PT-like"
"GTACGTAGTACACCGC"	"PT-like_1"
"GTACGTAGTCCATGAT"	"TPC"
"GTACGTAGTCTAGTCA"	"Exclude_highmito"
"GTACGTAGTTACGCGC"	"TPC"
"GTACGTAGTTCAGTAC"	"PT-like_1"
"GTACGTAGTTCTGAAC"	"DCT_1"
"GTACGTATCATTGCCC"	"PEC-like_1"
"GTACGTATCCACTGGG"	"PT-like_2"
"GTACTCCAGAAACCTA"	"TPC"
"GTACTCCAGGATGCGT"	"TPC"
"GTACTCCAGGGCACTA"	"PT-like_1"
"GTACTCCCAAGAGTCG"	"PT-like_2"
"GTACTCCCACATGGGA"	"PT-like_2"
"GTACTCCCAGCTGTGC"	"DCT_1"
"GTACTCCGTCCGAGTC"	"Exclude_highmito"
"GTACTCCGTGCGGTAA"	"DCT_1"
"GTACTCCGTGTAAGTA"	"DCT_1"
"GTACTCCTCACGCATA"	"DCT_2"
"GTACTCCTCATTATCC"	"PT-like_1"
"GTACTCCTCCTTTCGG"	"DCT_2"
"GTACTCCTCTGTCAAG"	"TPC"
"GTACTTTAGATAGCAT"	"DCT_1"
"GTACTTTGTACCTACA"	"Proliferating_PT-like"
"GTACTTTGTCCAAGTT"	"DCT_1"
"GTACTTTGTCGCGGTT"	"TPC"
"GTACTTTTCCTTTACA"	"DCT_1"
"GTAGGCCAGGTAAACT"	"DCT_2"
"GTAGGCCAGTACCGGA"	"Proliferating_PT-like"
"GTAGGCCAGTGGGTTG"	"TPC"
"GTAGGCCCACAGAGGT"	"DCT_1"
"GTAGGCCCATTTGCCC"	"DCT_1"
"GTAGGCCCATTTGCTT"	"PEC-like_2"
"GTAGGCCGTTAAAGAC"	"PEC-like_2"
"GTAGGCCGTTACCAGT"	"Proliferating_PT-like"
"GTAGGCCTCAGCTGGC"	"TPC"
"GTAGGCCTCCAGGGCT"	"PT-like_2"
"GTAGGCCTCGCAGGCT"	"DCT_1"
"GTAGGCCTCGCTTGTC"	"PT-like_2"
"GTAGTCAAGGAGCGTT"	"Exclude_highmito"
"GTAGTCACACATGTGT"	"DCT_1"
"GTAGTCACAGTTCATG"	"Exclude_highmito"
"GTAGTCAGTAGGGTAC"	"DCT_1"
"GTAGTCATCATTTGGG"	"PEC-like_1"
"GTAGTCATCTGACCTC"	"DCT_1"
"GTATCTTAGAAGGCCT"	"DCT_2"
"GTATCTTGTAGCAAAT"	"Exclude_highmito"
"GTATTCTCAAGCGTAG"	"Proliferating_PT-like"
"GTATTCTCAATTGCTG"	"PT-like_1"
"GTATTCTCAGCTGCTG"	"PT-like_1"
"GTATTCTCATTACGAC"	"PEC-like_1"
"GTATTCTGTTGATTCG"	"PEC-like_2"
"GTCAAGTAGGACACCA"	"TPC"
"GTCAAGTAGTGTCTCA"	"Proliferating_PT-like"
"GTCAAGTCAATGGATA"	"DCT_1"
"GTCAAGTCATCAGTAC"	"DCT_1"
"GTCAAGTGTGATGATA"	"PT-like_2"
"GTCAAGTGTGTGTGCC"	"DCT_2"
"GTCACAAAGGACGAAA"	"PT-like_1"
"GTCACAAAGTTAGGTA"	"TPC"
"GTCACAACAACACGCC"	"PT-like_1"
"GTCACAACACGGCTAC"	"DCT_1"
"GTCACAACACTTCGAA"	"TPC"
"GTCACAACATATGCTG"	"PT-like_1"
"GTCACAATCTGATACG"	"TPC"
"GTCACGGAGAGTAATC"	"PT-like_1"
"GTCACGGAGTGGTCCC"	"PT-like_1"
"GTCACGGCAAGGACTG"	"DCT_2"
"GTCACGGGTCTTCTCG"	"PT-like_1"
"GTCACGGGTTCGTGAT"	"TPC"
"GTCATTTCAAATTGCC"	"PT-like_1"
"GTCATTTCAACACCCG"	"TPC"
"GTCATTTCATCGGGTC"	"DCT_1"
"GTCATTTGTCCGTGAC"	"PT-like_2"
"GTCATTTGTTAAGTAG"	"Exclude_highribosomal"
"GTCATTTTCTCGCATC"	"Proliferating_PT-like"
"GTCCTCAAGCGACGTA"	"PT-like_2"
"GTCCTCACAGCTGGCT"	"PEC-like_2"
"GTCCTCACAGTGGGAT"	"PT-like_1"
"GTCCTCACATCAGTAC"	"TPC"
"GTCCTCAGTGTATGGG"	"PT-like_2"
"GTCCTCAGTTGATTCG"	"PT-like_2"
"GTCCTCATCGTCACGG"	"DCT_1"
"GTCGGGTAGAGTAAGG"	"PT-like_2"
"GTCGGGTAGCAATATG"	"PT-like_1"
"GTCGGGTCAAGGCTCC"	"DCT_2"
"GTCGGGTCATCTATGG"	"Exclude_highmito"
"GTCGGGTGTAAGTAGT"	"DCT_1"
"GTCGGGTGTCTAGCCG"	"TPC"
"GTCGGGTGTTAAAGAC"	"Proliferating_PT-like"
"GTCGTAAAGCACACAG"	"Exclude_highmito"
"GTCGTAAAGTTGAGTA"	"TPC"
"GTCGTAACAAATTGCC"	"TPC"
"GTCGTAACAGAGTGTG"	"PT-like_1"
"GTCGTAAGTCTCCCTA"	"DCT_1"
"GTCGTAATCCACGAAT"	"TPC"
"GTCGTAATCCCATTTA"	"Exclude_highmito"
"GTCGTAATCTGAGGGA"	"TPC"
"GTCTCGTGTAGCTCCG"	"Exclude_highribosomal"
"GTCTCGTTCAAGCCTA"	"Exclude_highmito"
"GTCTCGTTCGGCGCAT"	"PT-like_1"
"GTCTTCGAGACTAGGC"	"PT-like_2"
"GTCTTCGAGGCTCAGA"	"PT-like_1"
"GTCTTCGCATGGTTGT"	"Proliferating_PT-like"
"GTCTTCGTCGTTTATC"	"DCT_1"
"GTGAAGGAGATGTTAG"	"TPC"
"GTGAAGGAGTCGATAA"	"PT-like_1"
"GTGAAGGAGTGTGGCA"	"PEC-like_1"
"GTGAAGGCAACGCACC"	"DCT_1"
"GTGAAGGCATTGAGCT"	"PT-like_1"
"GTGAAGGTCAAACAAG"	"Exclude_highmito"
"GTGAAGGTCATCTGTT"	"TPC"
"GTGAAGGTCGCTTGTC"	"PT-like_1"
"GTGAAGGTCTTCATGT"	"Proliferating_PT-like"
"GTGCAGCAGTACATGA"	"Proliferating_PT-like"
"GTGCAGCCAGGTCGTC"	"Proliferating_PT-like"
"GTGCATACAGACGTAG"	"DCT_2"
"GTGCATACATCCGGGT"	"PT-like_2"
"GTGCATATCACAATGC"	"PT-like_1"
"GTGCATATCCCGGATG"	"DCT_2"
"GTGCGGTAGGCCCGTT"	"DCT_1"
"GTGCGGTGTCGAACAG"	"PEC-like_1"
"GTGCGGTTCTGCTTGC"	"TPC"
"GTGCTTCAGCTCTCGG"	"PT-like_1"
"GTGCTTCCACCCATGG"	"PT-like_1"
"GTGCTTCGTCCGTGAC"	"DCT_1"
"GTGCTTCTCAGCGATT"	"PEC-like_2"
"GTGGGTCCATCCCACT"	"PEC-like_1"
"GTGGGTCTCAACGAAA"	"TPC"
"GTGGGTCTCAAGCCTA"	"PT-like_1"
"GTGGGTCTCGCTGATA"	"PT-like_1"
"GTGTGCGAGATAGCAT"	"DCT_1"
"GTGTGCGAGCCGGTAA"	"PT-like_1"
"GTGTGCGAGCGTCAAG"	"PT-like_1"
"GTGTGCGTCTCAAGTG"	"PEC-like_1"
"GTGTGCGTCTCGTATT"	"DCT_2"
"GTGTTAGAGATATGCA"	"PT-like_2"
"GTGTTAGGTAGCGTCC"	"DCT_2"
"GTGTTAGGTGACAAAT"	"PT-like_1"
"GTGTTAGTCTGTCCGT"	"DCT_2"
"GTTAAGCAGAACAATC"	"DCT_1"
"GTTAAGCAGAAGGACA"	"Proliferating_PT-like"
"GTTAAGCAGAGGGATA"	"DCT_1"
"GTTAAGCAGATGCGAC"	"PT-like_1"
"GTTAAGCGTATCAGTC"	"Exclude_highmito"
"GTTAAGCTCAACGAAA"	"Proliferating_PT-like"
"GTTAAGCTCCGAACGC"	"DCT_2"
"GTTACAGAGCCGTCGT"	"PT-like_1"
"GTTACAGCAATCAGAA"	"DCT_2"
"GTTACAGGTACAGTTC"	"TPC"
"GTTACAGTCAGAGACG"	"TPC"
"GTTCATTCACACTGCG"	"PT-like_2"
"GTTCATTCATTCACTT"	"PT-like_2"
"GTTCATTGTAGCGATG"	"PT-like_1"
"GTTCATTGTTACCAGT"	"Proliferating_PT-like"
"GTTCATTGTTCAGACT"	"PT-like_1"
"GTTCATTTCAGTTTGG"	"Exclude_highmito"
"GTTCATTTCCGGCACA"	"TPC"
"GTTCGGGAGCACAGGT"	"DCT_1"
"GTTCGGGCAAGCGAGT"	"PT-like_1"
"GTTCGGGCATCCAACA"	"TPC"
"GTTCGGGCATGTAAGA"	"Exclude_highmito"
"GTTCGGGCATTCCTGC"	"PT-like_1"
"GTTCGGGGTGCGCTTG"	"PEC-like_2"
"GTTCGGGGTTATGTGC"	"DCT_1"
"GTTCGGGGTTGTGGAG"	"PEC-like_1"
"GTTCGGGTCAGCGATT"	"TPC"
"GTTCGGGTCCTTGGTC"	"PT-like_2"
"GTTCTCGAGCCAGGAT"	"PT-like_1"
"GTTCTCGAGCTGATAA"	"DCT_2"
"GTTCTCGAGTCGTACT"	"Exclude_highmito"
"GTTCTCGGTGCCTTGG"	"PEC-like_1"
"GTTTCTAGTCCCGACA"	"Exclude_highmito"
"GTTTCTAGTGCATCTA"	"Exclude_highmito"
"GTTTCTATCACTGGGC"	"Exclude_highribosomal"
"GTTTCTATCTGGGCCA"	"DCT_2"
"TAAACCGAGTGATCGG"	"Proliferating_PT-like"
"TAAACCGGTGTGGTTT"	"TPC"
"TAAACCGGTTGATTCG"	"Proliferating_PT-like"
"TAAACCGTCGACCAGC"	"PT-like_2"
"TAAACCGTCGGCATCG"	"PT-like_2"
"TAAGAGAAGCAAATCA"	"Proliferating_PT-like"
"TAAGAGAAGCGATTCT"	"Exclude_highmito"
"TAAGAGAAGTCTCAAC"	"TPC"
"TAAGAGAAGTTGTAGA"	"DCT_2"
"TAAGAGACAGTTCATG"	"PT-like_1"
"TAAGCGTAGGAGTCTG"	"PEC-like_1"
"TAAGCGTCAATGGAGC"	"Exclude_highmito"
"TAAGCGTGTGTCCTCT"	"PT-like_1"
"TAAGCGTGTTTGGGCC"	"Exclude_highmito"
"TAAGCGTTCTGATACG"	"PT-like_1"
"TAAGCGTTCTGGTTCC"	"PT-like_1"
"TAAGTGCCACCAGGCT"	"DCT_1"
"TAAGTGCCATGCCTTC"	"PEC-like_1"
"TAAGTGCGTAAGGGAA"	"PT-like_1"
"TAAGTGCTCAAGCCTA"	"TPC"
"TAAGTGCTCGGATGGA"	"TPC"
"TACACGAAGACGACGT"	"Proliferating_PT-like"
"TACACGACACAGACTT"	"Exclude_highmito"
"TACACGACACCGGAAA"	"DCT_2"
"TACACGACATGTCTCC"	"TPC"
"TACACGATCCAACCAA"	"PT-like_1"
"TACACGATCGGCGCTA"	"Proliferating_PT-like"
"TACAGTGCAAGAGGCT"	"PT-like_1"
"TACAGTGGTATATGGA"	"PT-like_1"
"TACAGTGGTGGACGAT"	"TPC"
"TACCTATCAGGACCCT"	"DCT_1"
"TACCTATGTATCTGCA"	"PT-like_2"
"TACCTTAAGCGTTGCC"	"Exclude_highmito"
"TACCTTAAGTAATCCC"	"PT-like_2"
"TACCTTACAGCTCGAC"	"PT-like_1"
"TACGGATAGATCTGCT"	"PT-like_2"
"TACGGATAGGACTGGT"	"Proliferating_PT-like"
"TACGGATCAGGGTTAG"	"PT-like_1"
"TACGGATGTCTGCGGT"	"Exclude_highribosomal"
"TACGGATTCATAAAGG"	"Exclude_highmito"
"TACGGGCAGAACAACT"	"PT-like_1"
"TACGGGCAGCCGTCGT"	"Proliferating_PT-like"
"TACGGGCAGCGAAGGG"	"Exclude_highmito"
"TACGGGCAGTCCATAC"	"PT-like_1"
"TACGGGCCAATAGCAA"	"TPC"
"TACGGGCCATACTACG"	"Exclude_highmito"
"TACGGGCTCGACCAGC"	"Proliferating_PT-like"
"TACGGTACAAGCCCAC"	"TPC"
"TACGGTACATTTCAGG"	"PT-like_2"
"TACGGTAGTCTCTCGT"	"PT-like_2"
"TACTCATAGACGCAAC"	"DCT_1"
"TACTCATAGCAACGGT"	"TPC"
"TACTCATAGTGCGTGA"	"PT-like_2"
"TACTCATCAACGCACC"	"Exclude_highribosomal"
"TACTCATCAGGCGATA"	"PT-like_2"
"TACTCGCAGAGCTGGT"	"PEC-like_1"
"TACTCGCAGCAGGCTA"	"DCT_2"
"TACTCGCAGGTGCAAC"	"DCT_1"
"TACTCGCCACACATGT"	"PEC-like_1"
"TACTCGCGTCGTTGTA"	"PT-like_1"
"TACTCGCGTGGTTTCA"	"DCT_1"
"TACTTACAGTCAATAG"	"TPC"
"TACTTACCAATGAAAC"	"DCT_2"
"TACTTACCATATGGTC"	"TPC"
"TACTTACGTAACGCGA"	"PEC-like_1"
"TACTTACTCATAGCAC"	"PT-like_1"
"TACTTACTCCGAATGT"	"DCT_1"
"TACTTACTCGTGGACC"	"TPC"
"TACTTACTCTGGGCCA"	"TPC"
"TACTTGTAGACAGGCT"	"TPC"
"TACTTGTAGACCACGA"	"PT-like_1"
"TACTTGTAGCTGATAA"	"PT-like_1"
"TACTTGTGTAAGGGAA"	"Proliferating_PT-like"
"TACTTGTGTTTGGGCC"	"PT-like_1"
"TACTTGTTCAGCTTAG"	"PEC-like_1"
"TACTTGTTCATCACCC"	"PEC-like_1"
"TACTTGTTCCGTTGCT"	"Proliferating_PT-like"
"TACTTGTTCTCTTATG"	"Exclude_highmito"
"TAGACCACAAAGAATC"	"Exclude_highmito"
"TAGACCACACGTGAGA"	"PT-like_1"
"TAGACCACACTACAGT"	"PT-like_2"
"TAGACCACAGCGTAAG"	"Proliferating_PT-like"
"TAGACCAGTAGCTAAA"	"TPC"
"TAGACCATCGAATGCT"	"Exclude_highmito"
"TAGACCATCGCTAGCG"	"PT-like_1"
"TAGACCATCGTCACGG"	"TPC"
"TAGACCATCTAACCGA"	"PT-like_2"
"TAGAGCTAGAGACTTA"	"Exclude_highmito"
"TAGAGCTCACTTCGAA"	"TPC"
"TAGAGCTTCTACTTAC"	"DCT_1"
"TAGCCGGAGATGTCGG"	"DCT_1"
"TAGCCGGAGGAGTACC"	"PT-like_1"
"TAGCCGGCAATAAGCA"	"PT-like_2"
"TAGCCGGCATCACGTA"	"DCT_1"
"TAGCCGGGTGGTTTCA"	"PT-like_1"
"TAGCCGGTCATGCAAC"	"PT-like_2"
"TAGGCATAGTATTGGA"	"PT-like_1"
"TAGGCATAGTCAAGCG"	"Proliferating_PT-like"
"TAGGCATGTCGTCTTC"	"PT-like_2"
"TAGGCATGTGGTTTCA"	"PT-like_1"
"TAGGCATTCTCGCTTG"	"DCT_2"
"TAGGCATTCTGACCTC"	"DCT_1"
"TAGTGGTAGAAACCGC"	"Proliferating_PT-like"
"TAGTGGTAGACGCACA"	"PEC-like_2"
"TAGTGGTAGGATGCGT"	"DCT_1"
"TAGTGGTCACCAGTTA"	"PT-like_1"
"TAGTGGTCAGCGTAAG"	"Proliferating_PT-like"
"TAGTGGTCATCGATTG"	"PT-like_1"
"TAGTGGTTCCGCATCT"	"Exclude_highmito"
"TAGTTGGAGCAATATG"	"Exclude_highmito"
"TAGTTGGAGCAGACTG"	"DCT_2"
"TAGTTGGCAACACGCC"	"PT-like_2"
"TAGTTGGTCAGATAAG"	"TPC"
"TATCAGGCAAGAGGCT"	"PT-like_2"
"TATCAGGCAAGGACTG"	"TPC"
"TATCAGGTCACAAACC"	"Exclude_highribosomal"
"TATCAGGTCTAACCGA"	"DCT_1"
"TATCTCAAGACAAAGG"	"PT-like_2"
"TATCTCAAGAGGGCTT"	"DCT_1"
"TATCTCAAGAGTGAGA"	"PT-like_1"
"TATCTCAAGCCAACAG"	"PT-like_1"
"TATCTCAAGCTACCGC"	"PT-like_1"
"TATCTCATCACCACCT"	"TPC"
"TATCTCATCATGTCCC"	"TPC"
"TATCTCATCGCAAACT"	"Exclude_highmito"
"TATCTCATCTTAGAGC"	"DCT_2"
"TATGCCCAGAAGGTGA"	"Proliferating_PT-like"
"TATGCCCAGATGAGAG"	"DCT_1"
"TATGCCCAGCTCCCAG"	"PT-like_2"
"TATGCCCAGGCCGAAT"	"PT-like_2"
"TATGCCCCACAGGTTT"	"DCT_1"
"TATGCCCGTCTGATCA"	"PT-like_2"
"TATGCCCTCAACGGGA"	"PT-like_2"
"TATGCCCTCACTCCTG"	"PEC-like_1"
"TATGCCCTCCAACCAA"	"DCT_1"
"TATGCCCTCGATCCCT"	"Proliferating_PT-like"
"TATTACCCACCACGTG"	"DCT_1"
"TATTACCGTCCAGTAT"	"TPC"
"TATTACCTCAGCGATT"	"PT-like_2"
"TATTACCTCGAACTGT"	"Exclude_highmito"
"TCAACGAAGACTGTAA"	"PT-like_1"
"TCAACGAAGAGCTTCT"	"DCT_2"
"TCAACGAAGTGCCAGA"	"TPC"
"TCAACGAGTACCGTTA"	"Exclude_highmito"
"TCAACGAGTGTGACGA"	"DCT_1"
"TCAATCTAGAGGACGG"	"Exclude_highmito"
"TCAATCTAGGACTGGT"	"PT-like_2"
"TCAATCTAGGGTCTCC"	"PT-like_1"
"TCAATCTCAGGATTGG"	"PEC-like_2"
"TCAATCTGTCGCATCG"	"Exclude_highmito"
"TCAATCTTCTTCATGT"	"DCT_2"
"TCACAAGAGATATGCA"	"Exclude_highmito"
"TCACAAGCAAGACACG"	"PT-like_1"
"TCACAAGGTCAAAGAT"	"Exclude_highmito"
"TCACAAGGTCCAAGTT"	"PT-like_1"
"TCACAAGGTCTTCGTC"	"PT-like_1"
"TCACAAGGTTCATGGT"	"TPC"
"TCACAAGTCAGCTCGG"	"DCT_1"
"TCACAAGTCCAAGCCG"	"PEC-like_2"
"TCACGAAAGTACGCCC"	"DCT_2"
"TCACGAAAGTAGCCGA"	"DCT_1"
"TCACGAAAGTCCTCCT"	"DCT_1"
"TCACGAACATATGGTC"	"Exclude_highmito"
"TCACGAATCAACGGGA"	"PT-like_1"
"TCACGAATCCGAACGC"	"TPC"
"TCACGAATCCTGCTTG"	"DCT_1"
"TCACGAATCGCCGTGA"	"Exclude_highmito"
"TCAGATGCAAGTACCT"	"TPC"
"TCAGATGCAATCCGAT"	"Exclude_highmito"
"TCAGATGGTACCAGTT"	"PT-like_2"
"TCAGATGTCTCAAGTG"	"Exclude_highribosomal"
"TCAGCAAAGTGTCTCA"	"Exclude_highmito"
"TCAGCAACAAATTGCC"	"DCT_1"
"TCAGCAACATGCCACG"	"Exclude_highmito"
"TCAGCAAGTAAGTGGC"	"PT-like_1"
"TCAGCAAGTCCCTTGT"	"DCT_1"
"TCAGCAATCATAAAGG"	"PT-like_2"
"TCAGCAATCGAATCCA"	"PT-like_1"
"TCAGCAATCGTACCGG"	"DCT_2"
"TCAGCAATCTCGGACG"	"DCT_2"
"TCAGCAATCTTGAGAC"	"DCT_2"
"TCAGCTCCAATGGTCT"	"PT-like_1"
"TCAGCTCCAGCTCGAC"	"TPC"
"TCAGCTCGTCTCTTAT"	"PT-like_1"
"TCAGCTCTCCTCAACC"	"PT-like_2"
"TCAGGATAGACTGTAA"	"PT-like_1"
"TCAGGATAGTACGATA"	"Exclude_highmito"
"TCAGGATGTACTCTCC"	"DCT_1"
"TCAGGATGTCGCTTTC"	"PT-like_1"
"TCAGGATTCAACGAAA"	"DCT_2"
"TCAGGATTCCACGCAG"	"Exclude_highmito"
"TCAGGATTCTGGGCCA"	"DCT_1"
"TCAGGTACAACTGCTA"	"Proliferating_PT-like"
"TCAGGTACAGACAAAT"	"Exclude_highribosomal"
"TCAGGTACAGATGGCA"	"PT-like_1"
"TCAGGTAGTCATCGGC"	"TPC"
"TCAGGTAGTGCAGGTA"	"Proliferating_PT-like"
"TCAGGTAGTGTTGGGA"	"Proliferating_PT-like"
"TCAGGTAGTTCTGAAC"	"Exclude_highmito"
"TCAGGTATCACGGTTA"	"DCT_1"
"TCAGGTATCTACTCAT"	"PEC-like_1"
"TCATTACAGTGAAGTT"	"DCT_2"
"TCATTACCAGGGCATA"	"Exclude_highribosomal"
"TCATTACGTAAGTGTA"	"Exclude_highmito"
"TCATTACGTTAAGTAG"	"DCT_1"
"TCATTACTCCGTCATC"	"PT-like_1"
"TCATTTGAGGAGCGAG"	"TPC"
"TCATTTGCAGGTCGTC"	"PT-like_1"
"TCATTTGCATCTCCCA"	"TPC"
"TCATTTGCATGACGGA"	"Exclude_highribosomal"
"TCATTTGGTAACGACG"	"Proliferating_PT-like"
"TCATTTGGTACCGGCT"	"TPC"
"TCATTTGTCTACCTGC"	"DCT_2"
"TCCACACAGTCCCACG"	"PT-like_1"
"TCCACACCATCCGTGG"	"PT-like_1"
"TCCACACGTAACGCGA"	"DCT_2"
"TCCACACGTATAATGG"	"PT-like_1"
"TCCACACGTCTACCTC"	"DCT_2"
"TCCACACGTGAAAGAG"	"Proliferating_PT-like"
"TCCACACTCCTCAACC"	"PT-like_2"
"TCCCGATCACCGATAT"	"Exclude_highmito"
"TCCCGATCATCGGGTC"	"PT-like_2"
"TCCCGATCATGCCCGA"	"Proliferating_PT-like"
"TCCCGATGTGATAAGT"	"PT-like_2"
"TCCCGATGTTTAGGAA"	"PT-like_1"
"TCGAGGCAGAGTCGGT"	"TPC"
"TCGAGGCAGCCGTCGT"	"Proliferating_PT-like"
"TCGAGGCCACGCGAAA"	"DCT_1"
"TCGAGGCGTAAACCTC"	"Exclude_highmito"
"TCGAGGCGTATCAGTC"	"DCT_2"
"TCGAGGCGTGGACGAT"	"DCT_2"
"TCGAGGCGTTAGTGGG"	"Exclude_highmito"
"TCGAGGCTCGTGACAT"	"PT-like_1"
"TCGAGGCTCTACTTAC"	"Proliferating_PT-like"
"TCGAGGCTCTGCTGCT"	"PT-like_2"
"TCGCGAGAGGCGATAC"	"TPC"
"TCGCGAGCAAGCTGTT"	"DCT_2"
"TCGCGAGCAATAACGA"	"TPC"
"TCGCGAGCATCCGTGG"	"Proliferating_PT-like"
"TCGCGAGGTCCGAAGA"	"DCT_1"
"TCGCGAGGTTACGACT"	"PT-like_2"
"TCGCGAGTCACTCCTG"	"PT-like_1"
"TCGCGTTAGCGTCAAG"	"DCT_2"
"TCGCGTTCAGGTCGTC"	"DCT_1"
"TCGCGTTTCACAACGT"	"DCT_1"
"TCGCGTTTCAGGCCCA"	"TPC"
"TCGCGTTTCCTATGTT"	"DCT_1"
"TCGCGTTTCGTGGACC"	"TPC"
"TCGGGACAGTTAACGA"	"PT-like_1"
"TCGGGACCAGTGAGTG"	"PT-like_2"
"TCGGGACGTGCTCTTC"	"DCT_2"
"TCGGTAAAGTGGGATC"	"DCT_1"
"TCGGTAACAAGTCTGT"	"DCT_1"
"TCGGTAAGTACCGCTG"	"DCT_1"
"TCGGTAAGTAGCGTGA"	"DCT_2"
"TCGGTAATCTGGTATG"	"TPC"
"TCGTACCCATGGTAGG"	"PT-like_2"
"TCGTACCGTATTCTCT"	"Exclude_highmito"
"TCGTACCGTCCAGTGC"	"DCT_1"
"TCGTACCTCAACGGGA"	"TPC"
"TCGTACCTCTCCAACC"	"PT-like_1"
"TCGTAGAAGCTACCTA"	"PT-like_1"
"TCGTAGACAGGGTACA"	"DCT_2"
"TCGTAGATCACCCTCA"	"PT-like_1"
"TCGTAGATCATCTGTT"	"PT-like_2"
"TCGTAGATCGTCCGTT"	"DCT_2"
"TCGTAGATCTCTGCTG"	"TPC"
"TCGTAGATCTGTCTAT"	"Exclude_highmito"
"TCGTAGATCTGTTGAG"	"PT-like_1"
"TCTATTGAGGTGATTA"	"PT-like_2"
"TCTATTGCAAACCCAT"	"Exclude_highmito"
"TCTATTGCAAAGCAAT"	"DCT_2"
"TCTATTGCAATCGAAA"	"PT-like_1"
"TCTATTGGTAACGTTC"	"Exclude_highmito"
"TCTCATAAGTTGCAGG"	"DCT_1"
"TCTCATACAAGTACCT"	"PT-like_1"
"TCTCATACATACTCTT"	"PT-like_1"
"TCTCATAGTTGCGTTA"	"PT-like_1"
"TCTCATAGTTTCCACC"	"PT-like_1"
"TCTCATATCAACACCA"	"PT-like_2"
"TCTCATATCCAAATGC"	"PT-like_1"
"TCTCTAAAGACCACGA"	"PT-like_1"
"TCTCTAAGTCTCTCGT"	"Proliferating_PT-like"
"TCTCTAAGTCTTGTCC"	"PT-like_2"
"TCTCTAAGTGGCGAAT"	"DCT_1"
"TCTCTAAGTTTGGGCC"	"PT-like_1"
"TCTCTAATCGTGGACC"	"DCT_1"
"TCTCTAATCTCTTATG"	"Proliferating_PT-like"
"TCTGAGACAAACGCGA"	"DCT_1"
"TCTGAGAGTCATACTG"	"Exclude_highmito"
"TCTGAGAGTCTCAACA"	"Proliferating_PT-like"
"TCTGAGAGTGGACGAT"	"PT-like_1"
"TCTGAGATCCAACCAA"	"PEC-like_1"
"TCTGAGATCGGAAACG"	"PT-like_1"
"TCTGAGATCTAGCACA"	"Proliferating_PT-like"
"TCTGGAAAGAGTGACC"	"PT-like_1"
"TCTGGAAAGCGCCTCA"	"Exclude_highmito"
"TCTGGAACATCCGTGG"	"PEC-like_1"
"TCTGGAAGTCCATGAT"	"PT-like_1"
"TCTGGAATCGCTGATA"	"Exclude_highmito"
"TCTTCGGAGAGGGATA"	"Exclude_highmito"
"TCTTCGGAGTGTCCAT"	"PT-like_2"
"TCTTCGGTCAGAGCTT"	"DCT_2"
"TCTTCGGTCCTCAATT"	"DCT_1"
"TCTTCGGTCTACCAGA"	"TPC"
"TCTTTCCGTAATCGTC"	"PT-like_1"
"TCTTTCCGTGGACGAT"	"DCT_1"
"TCTTTCCGTGGTCCGT"	"Exclude_highmito"
"TCTTTCCTCAGGTTCA"	"DCT_2"
"TCTTTCCTCCTTAATC"	"PT-like_1"
"TCTTTCCTCTGTCTCG"	"PEC-like_1"
"TCTTTCCTCTTGAGGT"	"TPC"
"TGAAAGAAGTCCATAC"	"TPC"
"TGAAAGACAATAGAGT"	"TPC"
"TGAAAGACACATCTTT"	"PT-like_2"
"TGAAAGAGTAAGGGCT"	"Exclude_highmito"
"TGAAAGAGTTTCCACC"	"PT-like_1"
"TGAAAGATCAAACCGT"	"PT-like_1"
"TGAAAGATCCAAACAC"	"Proliferating_PT-like"
"TGAAAGATCTGGCGTG"	"PT-like_1"
"TGACAACAGTGTCCAT"	"DCT_1"
"TGACAACCACGAGAGT"	"PT-like_2"
"TGACAACCACTTCTGC"	"PT-like_1"
"TGACAACGTCATGCCG"	"TPC"
"TGACAACTCACCTCGT"	"Exclude_highmito"
"TGACAACTCAGCTCTC"	"Exclude_highmito"
"TGACAACTCATCGCTC"	"DCT_2"
"TGACGGCAGTAACCCT"	"Exclude_highmito"
"TGACGGCCAAGCGTAG"	"Exclude_highmito"
"TGACGGCCAATCCAAC"	"TPC"
"TGACGGCCACGAAAGC"	"DCT_1"
"TGACGGCCATGAGCGA"	"TPC"
"TGACGGCGTCTGATCA"	"DCT_1"
"TGACGGCGTCTTGATG"	"PEC-like_1"
"TGACGGCGTTCAGACT"	"PT-like_2"
"TGACGGCTCACTGGGC"	"PT-like_2"
"TGACTAGAGATCGATA"	"PT-like_2"
"TGACTAGAGCTCCTTC"	"PEC-like_1"
"TGACTAGAGTATGACA"	"DCT_1"
"TGACTAGAGTTGAGAT"	"DCT_1"
"TGACTAGCAAAGCAAT"	"Exclude_highmito"
"TGACTAGGTCACCCAG"	"Proliferating_PT-like"
"TGACTAGGTCGTTGTA"	"PEC-like_1"
"TGACTAGTCAGGTAAA"	"PT-like_1"
"TGACTAGTCCCAAGAT"	"DCT_2"
"TGACTAGTCGTCTGCT"	"Proliferating_PT-like"
"TGACTAGTCTTTCCTC"	"Exclude_highribosomal"
"TGACTTTAGTGGAGAA"	"DCT_2"
"TGACTTTCAGTATCTG"	"DCT_1"
"TGACTTTCATGCCACG"	"DCT_2"
"TGACTTTGTCGAGTTT"	"DCT_1"
"TGACTTTGTGTTCTTT"	"TPC"
"TGACTTTTCCAATGGT"	"TPC"
"TGAGAGGCAAACTGCT"	"PT-like_1"
"TGAGAGGCACACATGT"	"PT-like_1"
"TGAGAGGGTATGGTTC"	"DCT_1"
"TGAGAGGGTTCCACTC"	"PT-like_2"
"TGAGAGGTCTGCTGCT"	"PT-like_2"
"TGAGCATCAGTGGGAT"	"Proliferating_PT-like"
"TGAGCATGTGCTTCTC"	"PT-like_2"
"TGAGCATTCAATAAGG"	"DCT_1"
"TGAGCATTCGAGAGCA"	"PT-like_2"
"TGAGCATTCGGCGCTA"	"DCT_1"
"TGAGCCGAGAAGGTTT"	"TPC"
"TGAGCCGAGCCGTCGT"	"PT-like_1"
"TGAGCCGCAATGGAAT"	"PT-like_1"
"TGAGCCGCATTCTCAT"	"Proliferating_PT-like"
"TGAGCCGGTACCGTAT"	"TPC"
"TGAGCCGGTAGGGTAC"	"Exclude_highmito"
"TGAGCCGGTTGTACAC"	"DCT_1"
"TGAGGGAAGCTACCTA"	"DCT_1"
"TGAGGGAAGGATATAC"	"DCT_1"
"TGAGGGACACAGGAGT"	"PT-like_2"
"TGAGGGATCTTAACCT"	"PT-like_2"
"TGATTTCCAAGCCATT"	"DCT_1"
"TGATTTCCAGGAATGC"	"TPC"
"TGATTTCGTAGAGTGC"	"PEC-like_1"
"TGATTTCGTTACCAGT"	"Exclude_highmito"
"TGATTTCTCTTCAACT"	"TPC"
"TGCACCTAGTAGCGGT"	"PT-like_1"
"TGCACCTCAAGCCGCT"	"PT-like_1"
"TGCACCTCAATAAGCA"	"DCT_1"
"TGCACCTCACCTATCC"	"PT-like_1"
"TGCACCTCAGAGTGTG"	"DCT_1"
"TGCACCTGTCTCGTTC"	"Exclude_highribosomal"
"TGCACCTTCTCGAGTA"	"TPC"
"TGCACCTTCTGCTTGC"	"DCT_1"
"TGCCAAAAGCAGACTG"	"Exclude_highmito"
"TGCCAAAAGCGCTCCA"	"DCT_1"
"TGCCAAAAGCGTCAAG"	"DCT_2"
"TGCCAAAAGGTACTCT"	"Proliferating_PT-like"
"TGCCAAACAATAGCAA"	"PT-like_2"
"TGCCCATAGGTGTTAA"	"PT-like_2"
"TGCCCTAAGAATTGTG"	"Exclude_highmito"
"TGCCCTAAGCCGGTAA"	"DCT_2"
"TGCCCTAAGCGTAGTG"	"Exclude_highmito"
"TGCCCTACATGCCCGA"	"TPC"
"TGCCCTATCAACTCTT"	"DCT_1"
"TGCCCTATCTTTACAC"	"Exclude_highmito"
"TGCGCAGAGAATTGTG"	"TPC"
"TGCGCAGAGCTGCGAA"	"PT-like_2"
"TGCGCAGCAGTACACT"	"PT-like_2"
"TGCGCAGGTGACAAAT"	"DCT_1"
"TGCGCAGGTTCGTGAT"	"DCT_2"
"TGCGGGTTCAGGCGAA"	"DCT_1"
"TGCGGGTTCTTGAGAC"	"PEC-like_1"
"TGCGTGGAGCGTTGCC"	"PT-like_2"
"TGCGTGGTCCCGGATG"	"TPC"
"TGCTACCAGAGTGACC"	"Proliferating_PT-like"
"TGCTACCAGCCACCTG"	"PT-like_2"
"TGCTACCAGCGAGAAA"	"PT-like_1"
"TGCTACCCAATCTGCA"	"DCT_1"
"TGCTACCCAATGGACG"	"PEC-like_2"
"TGCTACCCATGCCTTC"	"PT-like_1"
"TGCTACCGTAGTACCT"	"Proliferating_PT-like"
"TGCTACCTCGATCCCT"	"PT-like_2"
"TGCTACCTCGTGGTCG"	"PT-like_2"
"TGCTGCTAGCCACGTC"	"Proliferating_PT-like"
"TGCTGCTAGGATGGTC"	"DCT_1"
"TGCTGCTCAACGATCT"	"PT-like_1"
"TGCTGCTCAATGGAAT"	"PT-like_1"
"TGCTGCTCACCGAAAG"	"PT-like_1"
"TGCTGCTCACGAAATA"	"TPC"
"TGCTGCTGTACGCTGC"	"PT-like_1"
"TGCTGCTGTCGGCTCA"	"PT-like_2"
"TGCTGCTGTTCGTTGA"	"PT-like_2"
"TGCTGCTTCAACGCTA"	"DCT_1"
"TGGACGCAGCTGCCCA"	"PT-like_1"
"TGGACGCAGCTGTCTA"	"DCT_1"
"TGGACGCCACGACTCG"	"TPC"
"TGGACGCGTAAGGGAA"	"Proliferating_PT-like"
"TGGACGCGTATAGGGC"	"Proliferating_PT-like"
"TGGCCAGCAGACGCAA"	"DCT_1"
"TGGCCAGCATTGAGCT"	"PEC-like_2"
"TGGCCAGGTAGCTCCG"	"PT-like_1"
"TGGCCAGGTCAATACC"	"PT-like_2"
"TGGCCAGGTCCGAAGA"	"PT-like_1"
"TGGCCAGGTCGAATCT"	"TPC"
"TGGCCAGGTGACTCAT"	"TPC"
"TGGCCAGTCACTTACT"	"DCT_1"
"TGGCCAGTCGGCTTGG"	"DCT_1"
"TGGCCAGTCGGTGTCG"	"Exclude_highmito"
"TGGCCAGTCTCGCTTG"	"DCT_1"
"TGGCGCAAGCCACCTG"	"TPC"
"TGGCGCAAGCGATCCC"	"PT-like_2"
"TGGCGCAAGCTTATCG"	"Proliferating_PT-like"
"TGGCGCAAGTGTACTC"	"DCT_1"
"TGGCGCACACAAGTAA"	"PT-like_1"
"TGGCGCAGTAAGAGGA"	"TPC"
"TGGCGCATCGGGAGTA"	"Exclude_highribosomal"
"TGGCTGGAGTGCGATG"	"PT-like_1"
"TGGCTGGAGTTAGGTA"	"Exclude_highmito"
"TGGCTGGCATGGATGG"	"PT-like_1"
"TGGCTGGGTAGGCTGA"	"Exclude_highmito"
"TGGCTGGGTCAAAGAT"	"PEC-like_1"
"TGGCTGGGTTAGATGA"	"DCT_2"
"TGGCTGGTCACATAGC"	"Exclude_highmito"
"TGGCTGGTCGCTTAGA"	"DCT_1"
"TGGCTGGTCTTGAGAC"	"PEC-like_2"
"TGGGAAGAGTGCTGCC"	"PT-like_1"
"TGGGAAGCACCCATGG"	"PT-like_2"
"TGGGAAGGTAGGGTAC"	"DCT_2"
"TGGGAAGGTGAGTATA"	"DCT_1"
"TGGGAAGTCCTTCAAT"	"TPC"
"TGGGAAGTCGAGAGCA"	"PT-like_1"
"TGGGAAGTCGCTTAGA"	"PT-like_1"
"TGGGCGTAGCTAAGAT"	"DCT_1"
"TGGGCGTCAAACTGCT"	"DCT_2"
"TGGGCGTGTACCGAGA"	"Exclude_highmito"
"TGGGCGTGTCGGATCC"	"PT-like_1"
"TGGGCGTGTGGTCCGT"	"PEC-like_2"
"TGGGCGTTCCTAAGTG"	"PEC-like_1"
"TGGGCGTTCTCATTCA"	"Exclude_highmito"
"TGGTTAGAGAGTCGGT"	"DCT_2"
"TGGTTAGAGGTGCAAC"	"Exclude_highribosomal"
"TGGTTAGCAGATTGCT"	"Proliferating_PT-like"
"TGGTTAGCATTGCGGC"	"DCT_1"
"TGGTTAGGTTATCACG"	"Proliferating_PT-like"
"TGGTTCCAGCTCCTCT"	"TPC"
"TGGTTCCAGTCGATAA"	"Exclude_highmito"
"TGGTTCCCAGGGTATG"	"DCT_1"
"TGGTTCCGTCGGCACT"	"Exclude_highribosomal"
"TGGTTCCTCTCACATT"	"Proliferating_PT-like"
"TGTATTCAGGTAGCCA"	"PT-like_1"
"TGTATTCTCCTGCCAT"	"PEC-like_2"
"TGTCCCACAAGAAGAG"	"TPC"
"TGTCCCACACAGTCGC"	"DCT_1"
"TGTCCCACACCCATGG"	"DCT_1"
"TGTCCCACACGCATCG"	"Exclude_highmito"
"TGTCCCACAGCTGCTG"	"DCT_2"
"TGTCCCAGTTGATTGC"	"Proliferating_PT-like"
"TGTGGTACATAAAGGT"	"TPC"
"TGTGGTAGTCTCTCGT"	"Proliferating_PT-like"
"TGTGGTATCTCCTATA"	"DCT_2"
"TGTGGTATCTGGAGCC"	"DCT_1"
"TGTGTTTAGCTATGCT"	"DCT_1"
"TGTGTTTAGGACAGCT"	"DCT_2"
"TGTGTTTAGTTCGATC"	"DCT_2"
"TGTGTTTCACAAGTAA"	"TPC"
"TGTGTTTCACTTACGA"	"DCT_2"
"TGTGTTTCAGCGTCCA"	"Proliferating_PT-like"
"TGTGTTTCATCCTTGC"	"Exclude_highmito"
"TGTGTTTGTAGGACAC"	"Proliferating_PT-like"
"TGTGTTTGTGAGGGAG"	"PT-like_2"
"TGTGTTTTCCCATTAT"	"Exclude_highribosomal"
"TGTTCCGAGATGCCTT"	"Proliferating_PT-like"
"TGTTCCGAGGCCGAAT"	"DCT_1"
"TGTTCCGCAGCTGCTG"	"Proliferating_PT-like"
"TGTTCCGGTTCAACCA"	"Exclude_highribosomal"
"TGTTCCGGTTGATTCG"	"TPC"
"TGTTCCGTCGTTGCCT"	"Exclude_highmito"
"TTAACTCAGGCAGTCA"	"Proliferating_PT-like"
"TTAGGACAGTGAATTG"	"PT-like_1"
"TTAGGACGTCTAAACC"	"TPC"
"TTAGGACTCACCCGAG"	"PEC-like_1"
"TTAGGACTCCTCAACC"	"PT-like_2"
"TTAGGCAAGACAAGCC"	"PT-like_2"
"TTAGGCACAAGCTGTT"	"PT-like_2"
"TTAGGCAGTCCAACTA"	"DCT_2"
"TTAGGCATCAAAGACA"	"PT-like_1"
"TTAGGCATCATGTAGC"	"PT-like_1"
"TTAGTTCAGAGACTTA"	"Proliferating_PT-like"
"TTAGTTCAGCACAGGT"	"Exclude_highmito"
"TTAGTTCCAGTGAGTG"	"DCT_2"
"TTAGTTCGTCTGCAAT"	"DCT_2"
"TTAGTTCGTGTAAGTA"	"TPC"
"TTAGTTCTCCGTCAAA"	"PT-like_2"
"TTAGTTCTCGGAAACG"	"PT-like_1"
"TTATGCTAGGCATTGG"	"DCT_1"
"TTATGCTCACCATGTA"	"TPC"
"TTATGCTGTACAGTTC"	"DCT_1"
"TTATGCTGTCTCTTTA"	"PT-like_2"
"TTATGCTGTTGATTCG"	"PT-like_2"
"TTATGCTTCTGGCGTG"	"PT-like_2"
"TTCCCAGAGTATTGGA"	"Exclude_highmito"
"TTCCCAGCAAACCTAC"	"DCT_2"
"TTCCCAGGTACAGCAG"	"DCT_1"
"TTCCCAGGTGCAGACA"	"PT-like_1"
"TTCCCAGTCAATACCG"	"TPC"
"TTCCCAGTCTGAGTGT"	"DCT_2"
"TTCGAAGAGCGCCTCA"	"Proliferating_PT-like"
"TTCGAAGAGTGTTGAA"	"DCT_1"
"TTCGAAGCAATAACGA"	"DCT_2"
"TTCGAAGCACGAAGCA"	"PT-like_1"
"TTCGGTCAGAAGATTC"	"PT-like_2"
"TTCGGTCAGGAGTAGA"	"Exclude_highmito"
"TTCGGTCCAGCTGTTA"	"DCT_2"
"TTCGGTCGTAAGGATT"	"PT-like_1"
"TTCGGTCGTAGCCTAT"	"Exclude_highmito"
"TTCGGTCTCATTTGGG"	"Proliferating_PT-like"
"TTCGGTCTCGAGAACG"	"PT-like_1"
"TTCTACAAGCGAAGGG"	"PT-like_2"
"TTCTACAAGGGTCTCC"	"PEC-like_1"
"TTCTACACAAGTCTGT"	"DCT_2"
"TTCTACACACAGGCCT"	"PT-like_2"
"TTCTACACAGCCAATT"	"DCT_1"
"TTCTACAGTGCTAGCC"	"DCT_1"
"TTCTACAGTTCAGTAC"	"Proliferating_PT-like"
"TTCTACATCCAATGGT"	"DCT_1"
"TTCTACATCGCAGGCT"	"DCT_2"
"TTCTACATCTCTGAGA"	"PT-like_1"
"TTCTACATCTTACCTA"	"TPC"
"TTCTCAAAGAATGTTG"	"DCT_2"
"TTCTCAAAGATCGGGT"	"Exclude_highmito"
"TTCTCAAGTAGCCTCG"	"TPC"
"TTCTCAAGTTTGACAC"	"DCT_1"
"TTCTCAATCCACGTGG"	"Proliferating_PT-like"
"TTCTCAATCTAGCACA"	"TPC"
"TTCTCCTAGCTAGCCC"	"PT-like_1"
"TTCTCCTCAATTCCTT"	"DCT_1"
"TTCTCCTCATGTTCCC"	"Exclude_highmito"
"TTCTCCTGTTCATGGT"	"TPC"
"TTCTCCTGTTGTTTGG"	"DCT_2"
"TTCTCCTTCTCGGACG"	"PT-like_2"
"TTCTCCTTCTTGAGAC"	"DCT_1"
"TTCTTAGAGGCCCGTT"	"TPC"
"TTCTTAGCAAGCTGGA"	"Exclude_highribosomal"
"TTCTTAGGTCTTCGTC"	"PT-like_2"
"TTGAACGAGAGTTGGC"	"PT-like_1"
"TTGAACGAGCACCGTC"	"Exclude_highmito"
"TTGAACGAGGATTCGG"	"DCT_1"
"TTGAACGTCCACTCCA"	"DCT_1"
"TTGACTTAGCTAAGAT"	"PT-like_1"
"TTGACTTAGGAGTTGC"	"TPC"
"TTGCCGTAGCAAATCA"	"TPC"
"TTGCCGTCACAGACTT"	"Proliferating_PT-like"
"TTGCCGTCACTTGGAT"	"PT-like_1"
"TTGCCGTCAGAAGCAC"	"Exclude_highmito"
"TTGCCGTGTAGCTAAA"	"TPC"
"TTGCCGTTCACATGCA"	"Exclude_highribosomal"
"TTGCCGTTCAGATAAG"	"PT-like_1"
"TTGCCGTTCCTCAACC"	"PT-like_1"
"TTGCGTCAGCGACGTA"	"PT-like_1"
"TTGCGTCAGTGACATA"	"PT-like_2"
"TTGCGTCCAAGTCATC"	"PEC-like_2"
"TTGCGTCCACGACGAA"	"TPC"
"TTGCGTCCAGGGTACA"	"Proliferating_PT-like"
"TTGCGTCCAGTCACTA"	"TPC"
"TTGCGTCGTCATTAGC"	"DCT_2"
"TTGCGTCGTGAAATCA"	"DCT_2"
"TTGCGTCTCACGACTA"	"Exclude_highmito"
"TTGGAACAGAAGATTC"	"TPC"
"TTGGAACAGACGCTTT"	"PT-like_2"
"TTGGAACCAATCCGAT"	"PEC-like_1"
"TTGGAACGTAAGTTCC"	"DCT_2"
"TTGGAACGTACCGTTA"	"PT-like_1"
"TTGGAACGTCTGCCAG"	"DCT_2"
"TTGGAACGTCTTCTCG"	"PT-like_2"
"TTGGAACTCCCAAGAT"	"DCT_2"
"TTGGCAAAGGCAAAGA"	"PT-like_2"
"TTGGCAACATCGGACC"	"DCT_2"
"TTGGCAAGTACATCCA"	"TPC"
"TTGGCAAGTACGCTGC"	"Proliferating_PT-like"
"TTGGCAAGTCAAAGAT"	"Exclude_highmito"
"TTGTAGGAGCGGCTTC"	"PT-like_2"
"TTGTAGGAGTCGTTTG"	"PT-like_2"
"TTGTAGGCAATGCCAT"	"DCT_2"
"TTGTAGGCAGCTGTGC"	"Exclude_highmito"
"TTGTAGGCATACCATG"	"DCT_1"
"TTGTAGGGTCAGAATA"	"Exclude_highribosomal"
"TTGTAGGTCTGTACGA"	"PT-like_2"
"TTGTAGGTCTTAGAGC"	"PT-like_2"
"TTTACTGAGACAAAGG"	"PT-like_1"
"TTTACTGAGAGGTTGC"	"DCT_1"
"TTTACTGAGCTATGCT"	"PT-like_1"
"TTTACTGCAGCCTTGG"	"DCT_1"
"TTTACTGCAGTGAGTG"	"PT-like_1"
"TTTACTGCATTCACTT"	"Exclude_highmito"
"TTTACTGGTACCATCA"	"DCT_1"
"TTTACTGTCTTGCAAG"	"PT-like_2"
"TTTATGCAGAATAGGG"	"TPC"
"TTTATGCGTAAACCTC"	"DCT_1"
"TTTATGCTCTTGAGAC"	"PEC-like_1"
"TTTCCTCGTGCCTGCA"	"TPC"
"TTTCCTCTCATCGGAT"	"DCT_1"
"TTTGCGCAGCTACCGC"	"PT-like_1"
"TTTGCGCAGTACCGGA"	"Proliferating_PT-like"
"TTTGCGCAGTGTCTCA"	"DCT_2"
"TTTGCGCGTCTCTCTG"	"DCT_2"
"TTTGCGCTCACGATGT"	"DCT_2"
"TTTGGTTAGCAGGCTA"	"PT-like_1"
"TTTGGTTAGCTGTCTA"	"DCT_1"
"TTTGGTTCATACTCTT"	"Exclude_highmito"
"TTTGGTTCATGGATGG"	"PEC-like_2"
"TTTGGTTCATTCTTAC"	"DCT_1"
"TTTGTCAAGTTCGATC"	"Exclude_highmito"
"TTTGTCAGTAACGTTC"	"PT-like_1"
