""	"Ident"
"AAACCCAAGGAAGTCC"	"DCT_1"
"AAACCCAGTATCGATC"	"PT_2"
"AAACCCAGTTGCCAAT"	"TAL"
"AAACCCATCTCATTGT"	"PT_2"
"AAACCCATCTGGTGGC"	"iPT"
"AAACGAAAGAGCAGCT"	"EC-PTC"
"AAACGAAAGGTCTACT"	"PT_1"
"AAACGAAAGTTGGAGC"	"GC-EC"
"AAACGAACACGCAGTC"	"IC-A1_1"
"AAACGAACATACATCG"	"DCT_1"
"AAACGAAGTAGTTACC"	"PT_1"
"AAACGAATCCAAACCA"	"DCT_1"
"AAACGAATCTTGATTC"	"EC-PTC"
"AAACGCTAGCATCCTA"	"CNT"
"AAACGCTAGGCCCGTT"	"CNT"
"AAACGCTCAGAATTCC"	"TAL"
"AAACGCTGTCACGTGC"	"PT_2"
"AAACGCTTCGGTCGAC"	"PT_1"
"AAACGCTTCTCTTCAA"	"T-cell"
"AAAGAACCACAAGGTG"	"iPT"
"AAAGAACGTCAACACT"	"CNT"
"AAAGAACGTGCGTTTA"	"DCT_1"
"AAAGAACGTTTAGACC"	"DCT_1"
"AAAGGATAGATAGCTA"	"PT_1"
"AAAGGATAGGCACTAG"	"PT_2"
"AAAGGATCACAAACGG"	"DCT_1"
"AAAGGATGTCGGCACT"	"CNT"
"AAAGGATGTCTCAGGC"	"CNT"
"AAAGGATTCGTTCAGA"	"GC-EC"
"AAAGGGCAGTTCGCAT"	"GC-EC"
"AAAGGGCCAACTCATG"	"DCT_1"
"AAAGGGCCAATAGTGA"	"PT_2"
"AAAGGGCCAGCAGTCC"	"CNT"
"AAAGGGCCATACATCG"	"CNT"
"AAAGGGCCATATGCGT"	"CNT"
"AAAGGGCGTTGTTGAC"	"PT_2"
"AAAGGGCTCAGCACCG"	"EC-PTC"
"AAAGGTACAGTCCGTG"	"GC-EC"
"AAAGGTAGTGCTAGCC"	"CNT"
"AAAGGTATCAACTGAC"	"PT_1"
"AAAGGTATCACGGGCT"	"CNT"
"AAAGGTATCCATATGG"	"PT_2"
"AAAGTCCAGCTGGCCT"	"CNT"
"AAAGTCCAGTCTAACC"	"DCT_1"
"AAAGTCCCAATTGAAG"	"IC-A1_1"
"AAAGTCCCACCATATG"	"EC-PTC"
"AAAGTCCGTATCGTGT"	"PT_1"
"AAAGTCCGTCATCACA"	"GC-EC"
"AAAGTCCGTGTGAGCA"	"PT_1"
"AAAGTCCTCTTCGGTC"	"EC-PTC"
"AAAGTGACAAGGTACG"	"PT_1"
"AAAGTGACATGCTGCG"	"DCT_1"
"AAAGTGAGTATGAGCG"	"DCT_1"
"AAAGTGATCGTGGAAG"	"TAL"
"AAATGGAAGCATCCTA"	"PT_1"
"AAATGGAAGGATCATA"	"DCT_1"
"AAATGGAAGTCACACT"	"PT_2"
"AAATGGACAAGCGAGT"	"DCT_1"
"AAATGGACAATCTCTT"	"CNT"
"AAATGGACAGCTATTG"	"DCT_1"
"AAATGGAGTCGATTTG"	"PT_1"
"AAATGGAGTGCACGCT"	"PT_1"
"AAATGGAGTGGCATCC"	"EC-PTC"
"AAATGGATCCAGGACC"	"GC-EC"
"AACAAAGAGACGCATG"	"CNT"
"AACAAAGAGGGAGAAT"	"TAL"
"AACAAAGCACTTCAAG"	"PT_1"
"AACAAAGCAGAGTCTT"	"EC-PTC"
"AACAAAGGTAGCGTAG"	"DCT_1"
"AACAAAGGTTGGGACA"	"CNT"
"AACAAAGTCGGAAGGT"	"PT_1"
"AACAAAGTCTATCGCC"	"CNT"
"AACAACCAGTTCCGTA"	"PT_1"
"AACAACCCACTACTTT"	"PT_1"
"AACAACCCAGCTACAT"	"PT_1"
"AACAACCCATCTGTTT"	"PT_1"
"AACAACCGTATCAGGG"	"PEC"
"AACAACCGTGTGACCC"	"PT_1"
"AACAACCGTTCATCTT"	"IC-A1_1"
"AACAACCGTTTACTGG"	"EC-PTC"
"AACAACCTCTTTGCGC"	"IC-A1_1"
"AACAAGAAGATCGCCC"	"CNT"
"AACAAGAAGCCAACCC"	"iPT"
"AACAAGAAGCCGGAAT"	"iPT"
"AACAAGAGTGGCTGCT"	"PT_1"
"AACAAGATCGGCTATA"	"PT_2"
"AACAAGATCTCCAATT"	"GC-EC"
"AACACACAGCATCAAA"	"PT_1"
"AACACACAGGCTTCCG"	"TAL"
"AACACACCACAATGTC"	"PT_1"
"AACACACGTAGGCTCC"	"PT_1"
"AACACACGTGCGACAA"	"IC-A1_1"
"AACACACTCATACGAC"	"PT_1"
"AACAGGGAGACTTCGT"	"iPT"
"AACAGGGAGCATCCCG"	"DCT_1"
"AACAGGGCACAGTACT"	"PT_1"
"AACAGGGGTACGATCT"	"DCT_1"
"AACAGGGGTAGATCCT"	"CNT"
"AACAGGGTCTAGCCAA"	"PT_1"
"AACCAACAGACCGCCT"	"iPT"
"AACCAACAGACCGTTT"	"DCT_1"
"AACCAACAGAGAATCT"	"EC-PTC"
"AACCAACAGCTAGTTC"	"PT_1"
"AACCAACTCAGACTGT"	"PT_2"
"AACCAACTCCGTACGG"	"PT_1"
"AACCACAAGCGAATGC"	"PT_1"
"AACCACAAGCGGACAT"	"CNT"
"AACCACACAGAGTTCT"	"PT_1"
"AACCACACAGCATGCC"	"DCT_1"
"AACCACACATGTGGCC"	"TAL"
"AACCACAGTACCAATC"	"DCT_1"
"AACCACAGTATTCCTT"	"PT_1"
"AACCACAGTGGTCTTA"	"IC-A1_1"
"AACCACATCTTGATTC"	"DCT_1"
"AACCATGAGCCACAAG"	"iPT"
"AACCATGAGCGGGTTA"	"PT_1"
"AACCATGAGTAGTGCG"	"CNT"
"AACCATGCAGTAGGAC"	"EC-PTC"
"AACCATGGTATGAAGT"	"DCT_1"
"AACCATGTCGACCACG"	"IC-A1_1"
"AACCATGTCTAGACCA"	"PT_1"
"AACCCAAAGACATCCT"	"TAL"
"AACCCAAAGAGTCTTC"	"PT_2"
"AACCCAAAGATCGCCC"	"DCT_1"
"AACCCAAAGTTTGGCT"	"PT_2"
"AACCCAACAAGAGGCT"	"DCT_1"
"AACCCAACAATTGGTC"	"PT_1"
"AACCCAAGTATTCCGA"	"CNT"
"AACCCAAGTCCACACG"	"PT_1"
"AACCCAAGTCGCTCGA"	"DCT_1"
"AACCCAATCACCTGTC"	"EC-PTC"
"AACCCAATCCTAAGTG"	"EC-PTC"
"AACCTGAAGCGAAACC"	"CNT"
"AACCTGAGTCGACGCT"	"DCT_2"
"AACCTGAGTTGAAGTA"	"PT_2"
"AACCTGATCGACGCTG"	"PT_1"
"AACCTTTAGATGGGCT"	"DCT_1"
"AACCTTTAGGCCCAAA"	"DCT_1"
"AACCTTTCAACATCGT"	"TAL"
"AACCTTTCAGGAGACT"	"TAL"
"AACCTTTCATCGTCCT"	"GC-EC"
"AACCTTTGTAACGCGA"	"PT_2"
"AACCTTTGTTAAACCC"	"CNT"
"AACCTTTTCTACTCAT"	"PT_2"
"AACGAAAAGCTTCATG"	"PT_1"
"AACGAAAAGGGCAGAG"	"DCT_1"
"AACGAAACAAACTCGT"	"DCT_1"
"AACGAAACAGCTCATA"	"PT_2"
"AACGAAACAGCTCGGT"	"PT_1"
"AACGAAAGTTTATGCG"	"PT_1"
"AACGAAATCTCCGAGG"	"TAL"
"AACGGGAAGGCCTAGA"	"EC-PTC"
"AACGGGACAAACTGCT"	"GC-EC"
"AACGGGACAGAGTGAC"	"PT_1"
"AACGGGAGTAGTCCTA"	"DCT_1"
"AACGGGAGTATAGCTC"	"DCT_1"
"AACGGGAGTGGGCTCT"	"EC-PTC"
"AACGTCACATAACTCG"	"DCT_1"
"AACGTCACATTGAGGG"	"PT_2"
"AACGTCAGTCGGTAAG"	"PT_2"
"AACGTCATCACTCACC"	"PT_1"
"AACGTCATCTTACTGT"	"DCT_1"
"AACTTCTCAGCCGTCA"	"PT_1"
"AACTTCTGTATCACGT"	"PT_1"
"AACTTCTGTCGCTGCA"	"PT_1"
"AACTTCTGTTCGCGTG"	"PT_2"
"AACTTCTTCAAGTGTC"	"PT_1"
"AAGAACAAGGGCCTCT"	"CNT"
"AAGAACACACATCCCT"	"PT_1"
"AAGAACACAGATTAAG"	"IC-A1_1"
"AAGAACAGTGATACTC"	"MC"
"AAGAACAGTGTCATGT"	"PT_2"
"AAGAACATCCTATTTG"	"PT_1"
"AAGAACATCGACGAGA"	"PT_1"
"AAGACAAAGACGTCGA"	"PT_1"
"AAGACAAAGTTGCGAG"	"PT_2"
"AAGACAACAATCTAGC"	"iPT"
"AAGACAACACATGAAA"	"PT_1"
"AAGACAACAGGCCTGT"	"DCT_1"
"AAGACAATCATATGGC"	"PT_1"
"AAGACAATCCGAGGCT"	"DCT_1"
"AAGACAATCGAGAATA"	"DCT_1"
"AAGACAATCGCGTAGC"	"EC-PTC"
"AAGACAATCTGAGCAT"	"CNT"
"AAGACTCAGAAATGGG"	"PT_1"
"AAGACTCAGCTGTACT"	"IC-A1_1"
"AAGACTCAGCTTCTAG"	"IC-A1_1"
"AAGACTCAGGAGAGTA"	"DCT_1"
"AAGACTCAGTTCCATG"	"PT_1"
"AAGACTCCAAGACAAT"	"GC-EC"
"AAGACTCCAAGGTTGG"	"CNT"
"AAGACTCCAGTTGAAA"	"PT_1"
"AAGACTCGTAAGGTCG"	"CNT"
"AAGATAGAGAAGTATC"	"EC-PTC"
"AAGATAGAGATAACGT"	"EC-PTC"
"AAGATAGAGGATTTGA"	"PT_1"
"AAGATAGAGGTAGACC"	"PT_2"
"AAGATAGAGTCCCAGC"	"IC-A1_1"
"AAGATAGGTACTCGTA"	"CNT"
"AAGATAGGTATTTCGG"	"GC-EC"
"AAGATAGGTCCAACGC"	"PT_1"
"AAGATAGTCGTCGCTT"	"IC-A1_1"
"AAGATAGTCTCTGGTC"	"DCT_1"
"AAGCATCAGACCAACG"	"TAL"
"AAGCATCCAATCCTTT"	"DCT_1"
"AAGCATCCAGGAGACT"	"CNT"
"AAGCATCGTCTACGAT"	"PT_1"
"AAGCCATAGAAGAGCA"	"PT_2"
"AAGCCATCACATATGC"	"T-cell"
"AAGCCATTCAAAGGAT"	"EC-PTC"
"AAGCCATTCAGAGTGG"	"PT_1"
"AAGCCATTCGGTTGTA"	"PT_1"
"AAGCGAGAGGCTTTCA"	"GC-EC"
"AAGCGAGAGTGTTGTC"	"EC-PTC"
"AAGCGAGCAGGAAGTC"	"PT_1"
"AAGCGAGGTCCCAAAT"	"DCT_1"
"AAGCGAGTCCCTCGAT"	"DCT_1"
"AAGCGAGTCTCCGAAA"	"CNT"
"AAGCGAGTCTTGTTAC"	"PT_1"
"AAGCGTTAGCAGCAGT"	"GC-EC"
"AAGCGTTGTCGCATGC"	"DCT_1"
"AAGGAATAGGGAGAAT"	"DCT_1"
"AAGGAATAGTTGGCTT"	"DCT_1"
"AAGGAATCACGGAAGT"	"PT_1"
"AAGGAATGTCGGTGAA"	"PT_1"
"AAGGAATTCAGTCTTT"	"DCT_1"
"AAGGAATTCATTACGG"	"iPT"
"AAGGAATTCGCCGTGA"	"IC-A1_2"
"AAGGTAAAGAGAGGTA"	"GC-EC"
"AAGGTAAAGCGGCTCT"	"PT_1"
"AAGGTAAAGCTGTGCC"	"TAL"
"AAGGTAAGTAGCGTAG"	"iPT"
"AAGGTAAGTAGTCGGA"	"IC-A1_1"
"AAGGTAAGTTATAGAG"	"PT_1"
"AAGGTAATCAACCTCC"	"iPT"
"AAGTACCAGAAATGGG"	"CNT"
"AAGTACCAGAGTTGCG"	"CNT"
"AAGTACCTCATGCCAA"	"TAL"
"AAGTACCTCGTTCATT"	"DCT_1"
"AAGTACCTCTCTTCAA"	"PT_1"
"AAGTCGTAGTCATAGA"	"PT_2"
"AAGTCGTAGTGGTGGT"	"IC-A1_1"
"AAGTCGTAGTGTTCCA"	"CNT"
"AAGTCGTCAAGCACAG"	"PT_2"
"AAGTCGTCAAGTATCC"	"PT_1"
"AAGTCGTCAGTTCCAA"	"DCT_1"
"AAGTCGTTCGACACTA"	"PT_1"
"AAGTGAAAGGCCTTGC"	"POD"
"AAGTGAACAGATACTC"	"DCT_1"
"AAGTGAACAGTCAGTT"	"PT_2"
"AAGTGAAGTAGGACCA"	"DCT_1"
"AAGTGAAGTCCACACG"	"TAL"
"AAGTGAATCCAAAGGG"	"DCT_1"
"AAGTTCGAGAATACAC"	"PT_1"
"AAGTTCGAGATACTGA"	"PT_1"
"AAGTTCGAGGCACGAT"	"CNT"
"AAGTTCGAGTTCGCAT"	"PT_2"
"AAGTTCGCAACACACT"	"IC-A1_1"
"AAGTTCGCAGTGGTGA"	"PT_2"
"AAGTTCGCATTCAGCA"	"PT_1"
"AAGTTCGGTTCCGCTT"	"DCT_1"
"AAGTTCGTCCCTTGGT"	"PT_2"
"AAGTTCGTCGCTAAAC"	"GC-EC"
"AATAGAGCACACGCCA"	"CNT"
"AATAGAGCACCTAAAC"	"CNT"
"AATAGAGCAGAGAATT"	"PT_2"
"AATAGAGCATCCGAGC"	"CNT"
"AATAGAGCATGCAGCC"	"iPT"
"AATAGAGCATTAAGCC"	"DCT_1"
"AATAGAGGTATGAGCG"	"CNT"
"AATAGAGGTCGACTGC"	"EC-PTC"
"AATAGAGGTGAGTCAG"	"EC-PTC"
"AATCACGGTGATTCAC"	"DCT_1"
"AATCACGTCATTGCTT"	"DCT_1"
"AATCACGTCGCACGGT"	"IC-A1_1"
"AATCGACAGGTAGCAC"	"PT_1"
"AATCGACCACGAGGAT"	"PT_1"
"AATCGACGTACTCCCT"	"PT_1"
"AATCGTGCAAAGAACT"	"PT_1"
"AATCGTGCATATCTCT"	"TAL"
"AATCGTGTCCATTCGC"	"TAL"
"AATCGTGTCGCTCATC"	"DCT_1"
"AATGAAGAGAAACACT"	"PT_1"
"AATGAAGAGGGAGGTG"	"PT_1"
"AATGAAGCAATTGGTC"	"PT_1"
"AATGAAGGTTCCAGGC"	"PT_1"
"AATGAAGTCGCCTTTG"	"TAL"
"AATGACCCAGCACAAG"	"PT_1"
"AATGACCCAGTGACCC"	"DCT_1"
"AATGACCCATTGAGCT"	"PT_2"
"AATGACCGTATCGTGT"	"DCT_1"
"AATGACCTCTGGGAGA"	"DCT_1"
"AATGCCAAGGTCCCTG"	"DCT_1"
"AATGCCACAGGCTATT"	"IC-A1_1"
"AATGCCAGTTGGGATG"	"DCT_1"
"AATGCCATCTAAGGAA"	"CNT"
"AATGCCATCTCTGCCA"	"PT_2"
"AATGGAAAGCGTTCCG"	"iPT"
"AATGGAAAGGTACATA"	"PT_2"
"AATGGAAAGTACCGGA"	"TAL"
"AATGGAAAGTGCCGAA"	"PT_1"
"AATGGAACACAACATC"	"EC-PTC"
"AATGGAACAGACATCT"	"PT_1"
"AATGGAATCGCCAATA"	"CNT"
"AATGGCTAGCTCACTA"	"TAL"
"AATGGCTCACCTCTGT"	"TAL"
"AATGGCTCACTACTTT"	"PT_1"
"AATGGCTGTACCATAC"	"IC-A1_1"
"AATGGCTGTCGCCTAG"	"PT_2"
"AATGGCTGTGAGCGAT"	"IC-A1_1"
"AATGGCTGTGATAGAT"	"CNT"
"AATGGCTGTTGCCATA"	"GC-EC"
"AATGGCTTCAATCAGC"	"PT_2"
"AATGGCTTCAGGACAG"	"IC-A1_1"
"AATGGCTTCAGTCACA"	"DCT_1"
"AATTCCTAGTAGTCAA"	"DCT_1"
"AATTCCTGTCGTGGTC"	"GC-EC"
"AATTCCTGTGCTAGCC"	"PT_1"
"AATTCCTTCTCACCCA"	"PT_1"
"AATTCCTTCTGTACAG"	"PT_2"
"AATTTCCAGGTTACAA"	"EC-PTC"
"AATTTCCCACGGTGAA"	"DCT_1"
"AATTTCCGTACCATAC"	"DCT_1"
"AATTTCCGTATTCCTT"	"PT_2"
"AATTTCCGTCTTAGTG"	"PT_1"
"AATTTCCGTTCTCGTC"	"PT_1"
"AATTTCCTCAGCCTCT"	"PT_1"
"AATTTCCTCCTCTCGA"	"iPT"
"ACAAAGAAGCATGGGT"	"CNT"
"ACAAAGAGTATGAGCG"	"GC-EC"
"ACAAAGATCTGCAGCG"	"PT_1"
"ACAACCAAGGTTATAG"	"PT_1"
"ACAACCATCAACACCA"	"PT_1"
"ACAACCATCACATCAG"	"PT_2"
"ACAACCATCAGACATC"	"DCT_1"
"ACAACCATCTTGCAAG"	"CNT"
"ACAAGCTCAGGCCTGT"	"iPT"
"ACAAGCTGTACTCCGG"	"CNT"
"ACAAGCTGTGCTGCAC"	"iPT"
"ACAAGCTGTGGTATGG"	"PT_1"
"ACAAGCTGTTAGTCGT"	"CNT"
"ACAAGCTTCCGAGTGC"	"DCT_1"
"ACAAGCTTCCTCTAAT"	"EC-PTC"
"ACACAGTAGGCTGGAT"	"PT_2"
"ACACAGTCAACATCGT"	"DCT_1"
"ACACAGTGTATGCTTG"	"PT_1"
"ACACAGTGTGGTCTAT"	"iPT"
"ACACAGTGTTCCTTGC"	"PT_2"
"ACACCAAAGACTGAGC"	"IC-A1_1"
"ACACCAAGTAGCCCTG"	"IC-A1_1"
"ACACCAAGTGATCGTT"	"PT_2"
"ACACGCGAGAGTCTTC"	"DCT_1"
"ACACGCGAGTAGCCAG"	"iPT"
"ACACGCGCAAAGCGTG"	"IC-A1_1"
"ACACGCGCACATCCCT"	"PT_1"
"ACACGCGCATGGCCCA"	"TAL"
"ACACGCGGTGGCCACT"	"PEC"
"ACACGCGTCCACACCT"	"PT_2"
"ACACGCGTCCAGGACC"	"PEC"
"ACACGCGTCCTAGCTC"	"PT_2"
"ACACTGACAGGAATCG"	"PT_1"
"ACACTGACAGGTTACT"	"GC-EC"
"ACACTGATCGCATAGT"	"iPT"
"ACACTGATCGTGGGTC"	"PT_2"
"ACAGAAAAGCTAGAGC"	"iPT"
"ACAGAAAAGCTAGATA"	"T-cell"
"ACAGAAAAGCTCCGAC"	"DCT_1"
"ACAGAAACAGGGAGAG"	"DCT_1"
"ACAGAAACAGTTTCGA"	"GC-EC"
"ACAGAAATCACAATGC"	"DCT_1"
"ACAGAAATCGAGCACC"	"CNT"
"ACAGCCGAGTAACGAT"	"PT_2"
"ACAGCCGCAATTGAAG"	"DCT_1"
"ACAGCCGCACGGGCTT"	"PT_2"
"ACAGCCGCACTACAGT"	"POD"
"ACAGCCGCAGACAAAT"	"PT_1"
"ACAGCCGCAGCGGTCT"	"PT_2"
"ACAGCCGCATAAGCGG"	"PT_2"
"ACAGCCGGTTGGCTAT"	"iPT"
"ACAGCCGTCGCACTCT"	"PT_1"
"ACAGGGAAGAATCGTA"	"DCT_1"
"ACAGGGAAGGTAAGTT"	"PT_2"
"ACAGGGAGTCGTCGGT"	"TAL"
"ACAGGGATCCTGTAGA"	"CNT"
"ACAGGGATCTTAATCC"	"DCT_1"
"ACATCCCAGCATCAAA"	"iPT"
"ACATCCCAGGAGTACC"	"IC-A1_1"
"ACATCCCAGGTCACAG"	"PT_1"
"ACATCCCCAAATGGCG"	"DCT_1"
"ACATCCCGTCCAGGTC"	"PT_2"
"ACATCCCGTTGGACTT"	"TAL"
"ACATCCCTCTAACGCA"	"PT_1"
"ACATCGAAGATTGCGG"	"DCT_1"
"ACATCGAAGGTAGATT"	"PT_2"
"ACATCGAAGTTGTCGT"	"CNT"
"ACATCGACACCAAATC"	"PT_1"
"ACATCGACAGTTGTCA"	"TAL"
"ACATCGAGTCAACATC"	"DCT_1"
"ACATCGAGTCACAGTT"	"POD"
"ACATCGAGTTGTCCCT"	"PT_1"
"ACATCGATCAGAGCGA"	"PT_1"
"ACATCGATCCTTTGAT"	"PT_1"
"ACATCGATCGCCATAA"	"PT_2"
"ACATCGATCTCCCTAG"	"DCT_1"
"ACATCGATCTGGCCAG"	"GC-EC"
"ACATGCAGTCGTATGT"	"EC-PTC"
"ACATGCAGTTAAGGGC"	"TAL"
"ACATGCATCTCGTCGT"	"DCT_1"
"ACATTTCAGAATACAC"	"CNT"
"ACATTTCAGACAGTCG"	"DCT_1"
"ACATTTCAGTCAAGCG"	"PT_1"
"ACATTTCAGTGTTCAC"	"CNT"
"ACATTTCCACCCTTGT"	"PT_2"
"ACATTTCTCCACTTCG"	"PT_2"
"ACATTTCTCGACGTCG"	"PT_2"
"ACATTTCTCTATTTCG"	"DCT_2"
"ACCAAACAGGTTCAGG"	"PT_2"
"ACCAAACAGTACGAGC"	"CNT"
"ACCAAACAGTCCTACA"	"IC-A1_1"
"ACCAAACTCCTCTGCA"	"PT_1"
"ACCAAACTCTCGGTCT"	"DCT_1"
"ACCAACAAGACTAAGT"	"EC-PTC"
"ACCAACAAGGCTTAGG"	"DCT_1"
"ACCAACACACCTGCGA"	"PT_1"
"ACCAACACAGAGCTAG"	"PT_2"
"ACCAACACATACATCG"	"DCT_1"
"ACCAACACATGCCGGT"	"IC-A1_1"
"ACCAACAGTGCTTCAA"	"PT_1"
"ACCAACAGTGGGTATG"	"DCT_1"
"ACCAACAGTTCTCTAT"	"PT_2"
"ACCAACATCCACGTCT"	"CNT"
"ACCAACATCGTGGGTC"	"CNT"
"ACCAACATCTGCCTGT"	"DCT_1"
"ACCAACATCTGGCCTT"	"PT_2"
"ACCAACATCTTCCACG"	"iPT"
"ACCACAAAGCAACTCT"	"DCT_1"
"ACCACAAAGCATCAGG"	"PT_1"
"ACCACAAAGTTGGCGA"	"PT_2"
"ACCACAACACATTACG"	"POD"
"ACCACAACACGGTGAA"	"DCT_1"
"ACCACAAGTCGTTGCG"	"DCT_1"
"ACCACAAGTGTATCCA"	"DCT_1"
"ACCACAATCAACACCA"	"CNT"
"ACCACAATCTCGGCTT"	"TAL"
"ACCATTTAGGGCCAAT"	"TAL"
"ACCATTTAGTCTGGTT"	"GC-EC"
"ACCATTTAGTGCAACG"	"DCT_1"
"ACCATTTAGTTCTACG"	"PT_1"
"ACCATTTCAGAGACTG"	"PT_1"
"ACCATTTCATTGCCTC"	"PT_1"
"ACCATTTTCATTGTGG"	"iPT"
"ACCATTTTCGAGAAAT"	"GC-EC"
"ACCATTTTCTGAGGCC"	"DCT_1"
"ACCCAAACAAATGAGT"	"CNT"
"ACCCAAAGTACTTGTG"	"iPT"
"ACCCAAAGTGGACTGA"	"DCT_1"
"ACCCAAATCAGTCAGT"	"DCT_2"
"ACCCAAATCTGCCTGT"	"PT_1"
"ACCCTCAAGACTGTTC"	"CNT"
"ACCCTCAAGATCGCTT"	"DCT_1"
"ACCCTCAAGTAATTGG"	"CNT"
"ACCCTCACAAACAGGC"	"GC-EC"
"ACCCTCAGTAGCTGCC"	"TAL"
"ACCCTCATCGTCTCAC"	"EC-PTC"
"ACCCTTGCAGCATACT"	"TAL"
"ACCCTTGCAGGTCTCG"	"PT_2"
"ACCCTTGCATCTCAAG"	"CNT"
"ACCCTTGGTAAGATCA"	"PT_2"
"ACCCTTGGTAGATCCT"	"DCT_1"
"ACCCTTGGTGTTTCTT"	"GC-EC"
"ACCCTTGTCACGTCCT"	"DCT_1"
"ACCCTTGTCGCCTTTG"	"PT_1"
"ACCCTTGTCGCTCCTA"	"GC-EC"
"ACCCTTGTCTGAGAGG"	"EC-PTC"
"ACCGTTCAGCCGTCGT"	"PT_2"
"ACCGTTCAGGCTGGAT"	"EC-PTC"
"ACCGTTCCAGGACATG"	"PEC"
"ACCGTTCGTCACGTGC"	"PT_1"
"ACCGTTCGTCTCAGGC"	"GC-EC"
"ACCGTTCGTTCGGGTC"	"PT_1"
"ACCTACCAGGAGGGTG"	"IC-A1_1"
"ACCTACCAGGGAGTGG"	"DCT_1"
"ACCTACCCAGGCCTGT"	"PT_1"
"ACCTACCGTCATGCAT"	"PT_1"
"ACCTACCGTGACTCTA"	"PT_2"
"ACCTGAAAGGCTCTCG"	"PT_1"
"ACCTGAAAGGTGCAGT"	"PT_2"
"ACCTGAACAAGATCCT"	"EC-PTC"
"ACCTGAACACAGTCCG"	"CNT"
"ACCTGAAGTTGTCCCT"	"PT_1"
"ACCTGTCAGAAGGGAT"	"DCT_1"
"ACCTGTCAGAGTATAC"	"DCT_1"
"ACCTGTCAGATACAGT"	"IC-A1_1"
"ACCTGTCAGGTCTACT"	"PT_1"
"ACCTGTCCAGTAGAAT"	"DCT_1"
"ACCTGTCGTACGCGTC"	"PT_2"
"ACCTGTCGTCCTGGTG"	"PT_1"
"ACGATCAAGATGTAGT"	"EC-PTC"
"ACGATCAAGCAGAAAG"	"IC-A1_1"
"ACGATCAAGTTCCTGA"	"IC-A1_1"
"ACGATCACAACTGAAA"	"CNT"
"ACGATCACACCCAATA"	"TAL"
"ACGATCAGTCCTGAAT"	"EC-PTC"
"ACGATCAGTGCATTAC"	"IC-A1_1"
"ACGATCAGTGCGTGCT"	"DCT_1"
"ACGATCAGTTGGTGTT"	"CNT"
"ACGATCATCATTCGGA"	"DCT_1"
"ACGATCATCCGTAATG"	"DCT_1"
"ACGATCATCCTCGATC"	"PT_1"
"ACGATGTAGAAACTGT"	"DCT_1"
"ACGATGTAGGGTATAT"	"IC-A1_1"
"ACGATGTCAGGCATTT"	"PT_2"
"ACGATGTGTCACCGCA"	"PT_2"
"ACGATGTGTGCCCAGT"	"GC-EC"
"ACGATGTTCTTCACAT"	"PT_1"
"ACGCACGCACGCGCTA"	"TAL"
"ACGCACGGTCTCAAGT"	"PT_2"
"ACGCACGTCAGAATAG"	"iPT"
"ACGCACGTCTCATGCC"	"CNT"
"ACGCACGTCTCCGCAT"	"EC-PTC"
"ACGGAAGAGCTCCCTT"	"IC-A1_1"
"ACGGAAGAGGTTGACG"	"iPT"
"ACGGAAGAGTCCGCCA"	"PT_2"
"ACGGAAGCACAGTCGC"	"iPT"
"ACGGAAGGTAGGAGGG"	"TAL"
"ACGGAAGGTCGGTACC"	"PT_1"
"ACGGAAGTCTGGGCCA"	"iPT"
"ACGGGTCAGAAATGGG"	"PT_1"
"ACGGGTCCATCGGAAG"	"GC-EC"
"ACGGGTCGTAACACCT"	"PT_1"
"ACGGGTCGTCCAAGAG"	"PT_2"
"ACGGTCGAGACAGTCG"	"PT_2"
"ACGGTCGAGATCCTAC"	"TAL"
"ACGGTCGAGCTCGAAG"	"DCT_1"
"ACGGTCGAGGCCTGCT"	"iPT"
"ACGGTCGAGTCGTTAC"	"iPT"
"ACGGTCGCAATTCTCT"	"TAL"
"ACGGTCGCAGGATGAC"	"EC-PTC"
"ACGGTCGGTCCAGCAC"	"PT_2"
"ACGGTCGGTTATTCCT"	"CNT"
"ACGGTTACAATCAGCT"	"IC-A1_1"
"ACGGTTACATGAGAAT"	"DCT_1"
"ACGGTTAGTTTCCAAG"	"IC-A1_1"
"ACGGTTATCGTAACCA"	"EC-PTC"
"ACGGTTATCTTTCCAA"	"PT_2"
"ACGTAACCATATGCGT"	"PT_1"
"ACGTAACGTTCTCACC"	"EC-PTC"
"ACGTAACTCACCATAG"	"TAL"
"ACGTACAAGAAGTGTT"	"GC-EC"
"ACGTACAAGAATAACC"	"PT_1"
"ACGTACAAGCTGCCTG"	"PT_1"
"ACGTACAAGGCGTCCT"	"CNT"
"ACGTACACAGTCGCTG"	"DCT_1"
"ACGTACAGTCACTGAT"	"TAL"
"ACGTACAGTGGCAACA"	"PT_2"
"ACGTACATCGAGAGAC"	"CNT"
"ACGTAGTAGAGTCACG"	"PT_1"
"ACGTAGTAGTATGTAG"	"DCT_1"
"ACGTAGTCATTGAAGA"	"DCT_1"
"ACGTAGTTCGCGCTGA"	"CNT"
"ACGTAGTTCGTGGGAA"	"PT_1"
"ACGTCCTAGGATTTAG"	"PT_2"
"ACGTCCTGTATTGACC"	"PT_2"
"ACGTCCTGTCCGGATC"	"TAL"
"ACGTCCTGTTATGTCG"	"TAL"
"ACGTTCCCATATCGGT"	"PT_1"
"ACGTTCCTCAAGCCCG"	"PT_2"
"ACGTTCCTCCTAGCTC"	"TAL"
"ACTACGACACCTGATA"	"PT_2"
"ACTACGACAGAGAATT"	"GC-EC"
"ACTACGAGTGGAAGTC"	"DCT_1"
"ACTATCTAGACCCGCT"	"EC-PTC"
"ACTATCTAGCTGTACT"	"EC-PTC"
"ACTATCTAGGACACTG"	"DCT_1"
"ACTATCTGTACGAGTG"	"DCT_1"
"ACTATCTGTCGATTTG"	"CNT"
"ACTATCTGTGATGGCA"	"CNT"
"ACTATCTGTGTCTTGA"	"DCT_1"
"ACTATCTTCCAACCAA"	"iPT"
"ACTATGGAGTTGCTCA"	"DCT_1"
"ACTATGGCAAGAGTAT"	"PT_1"
"ACTATGGCAGAGAGGG"	"PT_2"
"ACTATGGCAGTCCGTG"	"PT_1"
"ACTATGGCATGCCATA"	"EC-PTC"
"ACTATGGTCGACCTAA"	"DCT_1"
"ACTATGGTCTGCGAGC"	"PT_2"
"ACTATTCCAACTGGTT"	"PT_1"
"ACTATTCCAGGCTATT"	"CNT"
"ACTATTCGTCTCAGAT"	"DCT_1"
"ACTATTCGTTGCCAAT"	"PT_1"
"ACTATTCTCTTGATTC"	"GC-EC"
"ACTCCCAAGAGCAGTC"	"CNT"
"ACTCCCAAGAGTTGAT"	"EC-PTC"
"ACTCCCACAAGTGGTG"	"iPT"
"ACTCCCACAGACTCTA"	"iPT"
"ACTCCCAGTTTCGTTT"	"MC"
"ACTCCCATCACGGAGA"	"CNT"
"ACTCCCATCTAGCCTC"	"PT_2"
"ACTCTCGAGTAACGAT"	"CNT"
"ACTCTCGGTTGGACTT"	"TAL"
"ACTCTCGTCGCCGAGT"	"iPT"
"ACTGATGAGCCTCCAG"	"EC-PTC"
"ACTGATGAGGTCGCCT"	"CNT"
"ACTGATGCAAGCTGCC"	"IC-A1_2"
"ACTGATGCACCAGCTG"	"DCT_1"
"ACTGATGCACGGTGTC"	"PT_1"
"ACTGATGGTTATGTCG"	"PT_1"
"ACTGATGGTTGGGAAC"	"PEC"
"ACTGATGTCTCGGTAA"	"DCT_1"
"ACTGCAAAGCATAGGC"	"DCT_1"
"ACTGCAACAACCTAAC"	"POD"
"ACTGCAACAGATACTC"	"PT_1"
"ACTGCAACAGCGCGTT"	"PT_2"
"ACTGCAAGTGACTGTT"	"POD"
"ACTGCAAGTGATAGAT"	"IC-A1_1"
"ACTGCAATCACTGCTC"	"IC-A1_1"
"ACTGCAATCATTCACT"	"PT_1"
"ACTGCAATCATTCCTA"	"CNT"
"ACTGCAATCCTATGGA"	"PT_1"
"ACTGCAATCCTGGCTT"	"DCT_1"
"ACTGTCCAGAAGCGGG"	"IC-A1_1"
"ACTGTCCCAAGTCCAT"	"PT_1"
"ACTGTCCCAATGCAAA"	"CNT"
"ACTGTCCGTCTTGCGG"	"DCT_1"
"ACTGTCCGTGCCTGAC"	"PT_2"
"ACTGTCCTCGTTGTGA"	"PT_1"
"ACTGTGAAGAATACAC"	"GC-EC"
"ACTGTGAAGTACCATC"	"PT_2"
"ACTGTGACACCGCTGA"	"PT_1"
"ACTGTGAGTAACACGG"	"PT_1"
"ACTGTGAGTGGTTTAC"	"EC-PTC"
"ACTGTGATCTCATTGT"	"PT_1"
"ACTGTGATCTCATTTG"	"EC-PTC"
"ACTTAGGCACAAATGA"	"PT_2"
"ACTTAGGCAGAATCGG"	"CNT"
"ACTTAGGTCACGGGCT"	"TAL"
"ACTTAGGTCGAACTCA"	"PT_2"
"ACTTATCCAGCGGTTC"	"DCT_1"
"ACTTCCGAGGAGAATG"	"PT_1"
"ACTTCCGCAGACACAG"	"DCT_2"
"ACTTCCGGTACTGTTG"	"CNT"
"ACTTCCGGTCCCGTGA"	"PT_2"
"ACTTCCGGTCCTGTCT"	"T-cell"
"ACTTCCGGTGCCCGTA"	"EC-PTC"
"ACTTCCGGTGCGAGTA"	"PT_2"
"ACTTCCGTCATTCCTA"	"PT_1"
"ACTTCCGTCGCAGTTA"	"DCT_1"
"ACTTCCGTCTCATAGG"	"PT_1"
"ACTTCGCAGACTCTAC"	"DCT_1"
"ACTTCGCTCATTGAGC"	"CNT"
"ACTTCGCTCATTTGTC"	"CNT"
"ACTTTCAAGAAGCGGG"	"PT_2"
"ACTTTCAAGTCGGCAA"	"CNT"
"ACTTTCACACCGGTCA"	"CNT"
"ACTTTCACACGACGAA"	"EC-PTC"
"ACTTTCACACTGCTTC"	"iPT"
"ACTTTCAGTCCATAGT"	"PT_2"
"ACTTTCAGTCGGATTT"	"CNT"
"ACTTTCAGTCTTACTT"	"GC-EC"
"ACTTTCAGTGAGCTCC"	"PT_2"
"ACTTTCAGTGATTCAC"	"EC-PTC"
"ACTTTCAGTGCAAGAC"	"PT_1"
"ACTTTCAGTGTCTTCC"	"iPT"
"ACTTTCATCAAGAGTA"	"EC-PTC"
"ACTTTCATCCCATTTA"	"DCT_1"
"ACTTTCATCTCCTGTG"	"CNT"
"ACTTTGTAGCTAGAGC"	"PT_2"
"ACTTTGTAGGACGGAG"	"PT_2"
"ACTTTGTAGGATTTCC"	"POD"
"ACTTTGTAGGGCTAAC"	"GC-EC"
"ACTTTGTCAGTCGGAA"	"DCT_1"
"ACTTTGTGTATGGGAC"	"TAL"
"ACTTTGTGTCGCCACA"	"DCT_1"
"ACTTTGTGTGTTTACG"	"CNT"
"ACTTTGTTCAGATTGC"	"PT_1"
"AGAAATGAGTAGACCG"	"PT_1"
"AGAAATGCACTAGAGG"	"TAL"
"AGAAATGGTCCGAAAG"	"PT_2"
"AGAAATGGTGTCTAAC"	"PEC"
"AGAAATGTCCCTCGTA"	"GC-EC"
"AGAACAACAATTGGTC"	"PT_1"
"AGAACAAGTCATCTAG"	"PT_1"
"AGAACAAGTGGCTGCT"	"PT_1"
"AGAACAAGTTGTGCCG"	"PT_1"
"AGAACAATCAGTGTTG"	"iPT"
"AGAACCTAGAGTCAAT"	"DCT_1"
"AGAACCTAGATCCGAG"	"PEC"
"AGAACCTAGTCGGCAA"	"PT_1"
"AGAACCTCAAGCGGAT"	"CNT"
"AGAACCTTCATCTGTT"	"TAL"
"AGAACCTTCGACGAGA"	"DCT_1"
"AGAAGCGCAAGACCGA"	"PT_2"
"AGAAGCGCAGTAGTGG"	"CNT"
"AGAAGCGGTATGGGAC"	"IC-A1_1"
"AGAAGCGGTATGTGTC"	"DCT_1"
"AGAAGCGGTGTACGCC"	"PT_2"
"AGAAGCGTCATATGGC"	"DCT_1"
"AGAAGTACAATCCTAG"	"EC-PTC"
"AGAAGTAGTCTCGGAC"	"PT_1"
"AGACAAAAGAATCGTA"	"CNT"
"AGACAAAAGACTCTTG"	"PT_2"
"AGACAAACAGAGAAAG"	"iPT"
"AGACAAACATCCTAAG"	"PT_1"
"AGACAAAGTAGGCTCC"	"PT_1"
"AGACAAAGTGAGTGAC"	"TAL"
"AGACAAATCTCTATGT"	"iPT"
"AGACACTAGACATACA"	"DCT_1"
"AGACACTAGGCAGGGA"	"PEC"
"AGACACTCACTAAACC"	"PT_2"
"AGACACTCAGTGAGCA"	"GC-EC"
"AGACACTGTCAAAGAT"	"GC-EC"
"AGACACTGTGCTGATT"	"EC-PTC"
"AGACACTGTTCGAAGG"	"DCT_1"
"AGACACTTCCAATGCA"	"DCT_1"
"AGACACTTCTCCGAAA"	"EC-PTC"
"AGACAGGAGATGCAGC"	"DCT_1"
"AGACAGGAGGTTTACC"	"PT_1"
"AGACAGGCAGGCACTC"	"DCT_1"
"AGACAGGGTATGAAGT"	"PT_1"
"AGACAGGTCATTTGTC"	"EC-PTC"
"AGACCATCAAATGAAC"	"PT_1"
"AGACCATCACCCTCTA"	"IC-A1_1"
"AGACCATCACGTCGGT"	"GC-EC"
"AGACCATCATGCCATA"	"CNT"
"AGACCATGTAGTGTGG"	"DCT_1"
"AGACCATGTCTGTCAA"	"CNT"
"AGACCATGTCTTGAAC"	"CNT"
"AGACCATGTGCCTGCA"	"PT_1"
"AGACCCGCAGAACTAA"	"TAL"
"AGACCCGGTCTCTCTG"	"PT_1"
"AGACCCGTCACTTATC"	"DCT_1"
"AGACTCACAGAGGAAA"	"PT_2"
"AGACTCACATAGGTTC"	"PT_2"
"AGACTCACATCATCCC"	"EC-PTC"
"AGACTCAGTGTACATC"	"GC-EC"
"AGACTCAGTTGTCATG"	"PT_2"
"AGACTCAGTTTGAACC"	"CNT"
"AGACTCATCCATTCAT"	"EC-PTC"
"AGAGAATCACATTACG"	"CNT"
"AGAGAATTCGAGTTGT"	"PT_2"
"AGAGAATTCGCTACAA"	"EC-PTC"
"AGAGAATTCGTGAGAG"	"PT_1"
"AGAGAATTCTGAGAGG"	"GC-EC"
"AGAGAGCAGGACAACC"	"PT_2"
"AGAGAGCCATCCTTGC"	"IC-A1_2"
"AGAGAGCGTACCTATG"	"PT_2"
"AGAGAGCGTGCGTTTA"	"PT_1"
"AGAGAGCGTTGCAAGG"	"IC-A1_1"
"AGAGAGCTCAAGAATG"	"EC-PTC"
"AGAGAGCTCGTTTACT"	"EC-PTC"
"AGAGCAGAGGAGGGTG"	"TAL"
"AGAGCAGAGGATGCGT"	"EC-PTC"
"AGAGCAGCATCTAGAC"	"PT_1"
"AGAGCAGGTCCCAAAT"	"DCT_1"
"AGAGCAGTCGGCTTGG"	"PT_1"
"AGAGCAGTCTATCGCC"	"PT_1"
"AGAGCCCAGATTAGAC"	"PT_1"
"AGAGCCCCACTACCCT"	"TAL"
"AGAGCCCGTATCGTAC"	"DCT_1"
"AGAGCCCGTCTCGCGA"	"EC-PTC"
"AGAGCCCTCACATACG"	"CNT"
"AGATAGAAGGTTACAA"	"EC-PTC"
"AGATAGACAAGTCATC"	"CNT"
"AGATAGACACGGTGAA"	"iPT"
"AGATAGACATGACGAG"	"PT_2"
"AGATCCAAGAGTCGAC"	"CNT"
"AGATCCACAACCGGAA"	"PT_1"
"AGATCCACAACGCCCA"	"PT_1"
"AGATCCACAAGCGGAT"	"GC-EC"
"AGATCCACATCGTCCT"	"GC-EC"
"AGATCCAGTAGGAAAG"	"PT_1"
"AGATCCAGTTCTCGCT"	"CNT"
"AGATCCATCACCTACC"	"TAL"
"AGATCCATCTACAGGT"	"PT_2"
"AGATCCATCTTGGAAC"	"DCT_1"
"AGATCGTAGATGCCGA"	"PT_1"
"AGATCGTGTGAAGCGT"	"POD"
"AGATCGTGTTCGAAGG"	"IC-A1_1"
"AGATCGTGTTGCTAGT"	"PT_1"
"AGATCGTTCCTTTGAT"	"GC-EC"
"AGATCGTTCTGCTTAT"	"CNT"
"AGATGAAAGACTGGGT"	"PT_1"
"AGATGAACAAACTAAG"	"TAL"
"AGATGAACACCCAAGC"	"PT_1"
"AGATGAACACGAGGAT"	"PT_1"
"AGATGAACAGGTAGTG"	"EC-PTC"
"AGATGAACAGTCACGC"	"DCT_1"
"AGATGAAGTCACGACC"	"PEC"
"AGATGAATCGGCCTTT"	"DCT_1"
"AGATGAATCTAGTCAG"	"PT_1"
"AGATGAATCTGACGCG"	"PT_2"
"AGATGAATCTGCTTTA"	"DCT_1"
"AGATGCTAGAGTATAC"	"IC-A1_1"
"AGATGCTAGGTTACAA"	"CNT"
"AGATGCTCATGAAGGC"	"EC-PTC"
"AGATGCTGTGACACAG"	"EC-PTC"
"AGCATCACACCTAAAC"	"GC-EC"
"AGCATCACAGAAGTTA"	"PT_1"
"AGCATCACATCGTCCT"	"DCT_1"
"AGCATCACATTGTGCA"	"T-cell"
"AGCATCAGTCAGTCGC"	"CNT"
"AGCATCATCTTTCCAA"	"IC-A1_2"
"AGCCAATAGCTAGATA"	"DCT_1"
"AGCCAATAGTAGGTTA"	"TAL"
"AGCCAATCAGACAAGC"	"EC-PTC"
"AGCCAATGTCCATACA"	"PT_1"
"AGCCAATGTGAGTTGG"	"PT_2"
"AGCCAATTCACTTGTT"	"PT_2"
"AGCCAATTCGTAACTG"	"EC-PTC"
"AGCCAATTCTCCATAT"	"PT_1"
"AGCCACGAGACGGTCA"	"GC-EC"
"AGCCACGAGTTTGAGA"	"iPT"
"AGCCACGGTACGATCT"	"PT_1"
"AGCCACGGTCACTTAG"	"EC-PTC"
"AGCCACGGTGCCCACA"	"TAL"
"AGCCACGGTTCTGAGT"	"POD"
"AGCCACGTCCTTATGT"	"PT_1"
"AGCCAGCAGCAGGGAG"	"PT_1"
"AGCCAGCCACGGCGTT"	"IC-A1_1"
"AGCCAGCGTGGGTTGA"	"iPT"
"AGCCAGCGTGTGGTCC"	"GC-EC"
"AGCCAGCTCCTGGGTG"	"CNT"
"AGCCAGCTCGATCCAA"	"TAL"
"AGCGATTAGAACTCCT"	"TAL"
"AGCGATTAGGAGAATG"	"IC-A1_1"
"AGCGATTCACAAGTGG"	"DCT_1"
"AGCGATTGTACGTGTT"	"PT_2"
"AGCGATTGTCGTGCCA"	"CNT"
"AGCGATTTCATACGGT"	"PT_2"
"AGCGATTTCCAACCGG"	"TAL"
"AGCGCCAAGACGACGT"	"iPT"
"AGCGCCAAGATAGGGA"	"CNT"
"AGCGCCAAGTAAGAGG"	"PT_2"
"AGCGCCACACCAGACC"	"PT_1"
"AGCGCCACACGACAGA"	"EC-PTC"
"AGCGCCACACGTAACT"	"PT_1"
"AGCGCCAGTGTTGCCG"	"IC-A1_1"
"AGCGCCAGTTAAGCAA"	"PT_1"
"AGCGCTGAGACAACAT"	"PT_1"
"AGCGCTGAGGAAAGTG"	"CNT"
"AGCGCTGAGGGAGGCA"	"iPT"
"AGCGCTGCAGCTACTA"	"PT_2"
"AGCGCTGCATCGGAAG"	"EC-PTC"
"AGCGCTGGTACTGCCG"	"PT_1"
"AGCGCTGGTCCGAAGA"	"CNT"
"AGCGCTGTCTTCCCAG"	"PT_2"
"AGCGTATAGAATTGTG"	"PT_1"
"AGCGTATAGTGCCCGT"	"CNT"
"AGCGTATCACATGAAA"	"PT_1"
"AGCGTATGTTCGGCCA"	"TAL"
"AGCGTATGTTGTTGCA"	"iPT"
"AGCGTATTCTGCGGAC"	"DCT_1"
"AGCGTATTCTTGAGCA"	"IC-A1_1"
"AGCGTCGAGCTGTGCC"	"IC-A1_1"
"AGCGTCGCACGTATAC"	"CNT"
"AGCGTCGCATTATGCG"	"DCT_1"
"AGCGTCGGTCGTACAT"	"PT_1"
"AGCTACAGTAACATGA"	"PT_2"
"AGCTACATCCGGCAAC"	"DCT_1"
"AGCTACATCTCCGTGT"	"IC-A1_1"
"AGCTCAAAGATTGAGT"	"GC-EC"
"AGCTCAAAGGCTGGAT"	"DCT_1"
"AGCTCAACACCCTGAG"	"PT_1"
"AGCTCAACATAATCGC"	"GC-EC"
"AGCTCAACATGTCGTA"	"PT_1"
"AGCTCAATCCTAGAGT"	"PT_1"
"AGCTTCCAGATGTTAG"	"DCT_1"
"AGCTTCCAGCATCAGG"	"DCT_1"
"AGCTTCCAGGCATCAG"	"CNT"
"AGCTTCCCAATGCAAA"	"TAL"
"AGCTTCCGTCCTGAAT"	"EC-PTC"
"AGCTTCCTCAGCCTTC"	"PT_1"
"AGCTTCCTCGTGTCAA"	"PT_1"
"AGGAAATCAAACTAAG"	"CNT"
"AGGAAATCAGTCAGTT"	"CNT"
"AGGAAATGTATCAGGG"	"TAL"
"AGGAAATGTGCAACGA"	"GC-EC"
"AGGAAATGTTGGAGAC"	"DCT_1"
"AGGAATAAGAGAGCAA"	"DCT_1"
"AGGAATAAGAGCTGAC"	"PT_1"
"AGGAATAAGATTGTGA"	"DCT_1"
"AGGAATACAAAGAACT"	"GC-EC"
"AGGAATACATGGGCAA"	"CNT"
"AGGAATAGTAGCTTGT"	"PT_2"
"AGGAATAGTGGCTGAA"	"iPT"
"AGGAATAGTGGTCTAT"	"IC-A1_1"
"AGGAATAGTTTCAGAC"	"iPT"
"AGGAATATCCGACAGC"	"iPT"
"AGGACGACAAGTGGTG"	"PT_1"
"AGGACGACACAAATCC"	"EC-PTC"
"AGGACGAGTACGGGAT"	"PT_1"
"AGGACGATCCGATGTA"	"TAL"
"AGGACGATCCGTAGGC"	"PT_1"
"AGGACGATCGCACGGT"	"DCT_1"
"AGGACTTCACTACACA"	"DCT_2"
"AGGACTTTCAGCAATC"	"PT_2"
"AGGACTTTCCATCAGA"	"DCT_1"
"AGGAGGTAGACTGGGT"	"PT_1"
"AGGAGGTAGCCGAACA"	"GC-EC"
"AGGAGGTCATTGTAGC"	"CNT"
"AGGAGGTGTACCCACG"	"DCT_1"
"AGGAGGTGTGAGCAGT"	"PT_2"
"AGGAGGTGTTCCTAAG"	"IC-A1_1"
"AGGAGGTGTTTCGTGA"	"CNT"
"AGGAGGTTCCATGATG"	"DCT_1"
"AGGAGGTTCGCTTGAA"	"DCT_1"
"AGGATAAAGAGGACTC"	"PT_1"
"AGGATAAAGCACACCC"	"PT_1"
"AGGATAAAGGCCTAAG"	"TAL"
"AGGATAACAGCATGCC"	"DCT_1"
"AGGATAACATCAGCGC"	"PT_1"
"AGGATAATCCATGAGT"	"GC-EC"
"AGGATAATCGCGTTTC"	"TAL"
"AGGATCTAGCTTTCCC"	"PT_2"
"AGGATCTCAGCTGAAG"	"EC-PTC"
"AGGATCTCATATACCG"	"EC-PTC"
"AGGATCTGTAGTGATA"	"TAL"
"AGGATCTGTATGGTAA"	"CNT"
"AGGATCTGTATTTCTC"	"PT_1"
"AGGATCTGTCCACGCA"	"PT_1"
"AGGCATTAGCATTGAA"	"DCT_1"
"AGGCATTAGGCTGGAT"	"PT_2"
"AGGCATTAGTAACGAT"	"IC-A1_2"
"AGGCATTAGTATTGCC"	"PT_1"
"AGGCATTGTCTACTGA"	"PT_1"
"AGGCATTTCGTTACCC"	"PT_2"
"AGGCCACGTGCCGGTT"	"PT_2"
"AGGCTGCAGCAAATCA"	"PT_1"
"AGGCTGCAGGGAGTGG"	"PT_2"
"AGGCTGCCATAATCGC"	"DCT_1"
"AGGCTGCGTACGAGCA"	"TAL"
"AGGGAGTAGTCTAGCT"	"CNT"
"AGGGAGTCACAACCGC"	"PT_1"
"AGGGAGTCACATGACT"	"PT_1"
"AGGGAGTCACGGCACT"	"PT_2"
"AGGGAGTCACTTCATT"	"IC-A1_1"
"AGGGAGTCATCAGCGC"	"iPT"
"AGGGAGTGTAATTGGA"	"TAL"
"AGGGAGTGTGGCTGAA"	"PT_1"
"AGGGAGTTCCCGTGTT"	"PT_1"
"AGGGAGTTCTGTAACG"	"iPT"
"AGGGCCTAGAGAGGTA"	"PT_1"
"AGGGCCTAGGTGCAGT"	"PT_1"
"AGGGCCTAGTCAGAGC"	"DCT_1"
"AGGGCCTCAACGTTAC"	"IC-A1_1"
"AGGGCCTCAAGTTTGC"	"CNT"
"AGGGCCTCACTGGATT"	"PT_2"
"AGGGCCTGTCTTCTAT"	"PT_1"
"AGGGCCTTCAAGCCAT"	"CNT"
"AGGGCCTTCCACAGGC"	"GC-EC"
"AGGGCTCAGAAGCCAC"	"DCT_1"
"AGGGCTCAGTAAACGT"	"PT_2"
"AGGGCTCCAACAGCCC"	"PT_1"
"AGGGCTCCAAGAGTGC"	"DCT_1"
"AGGGCTCCAATAGTCC"	"PT_1"
"AGGGCTCCACTCATAG"	"PT_2"
"AGGGCTCCATCGCTCT"	"PT_2"
"AGGGCTCGTCCGTACG"	"PT_1"
"AGGGCTCGTCTTACTT"	"DCT_1"
"AGGGCTCGTGAGACCA"	"CNT"
"AGGGCTCGTGCCTTTC"	"PT_1"
"AGGGCTCGTTGTCAGT"	"PT_1"
"AGGGTCCAGTACTCGT"	"CNT"
"AGGGTCCCAGTTAGGG"	"CNT"
"AGGGTCCGTAATGCGG"	"IC-A1_1"
"AGGGTCCGTATACGGG"	"DCT_1"
"AGGGTCCTCAGCAGAG"	"EC-PTC"
"AGGGTCCTCCACAGGC"	"PT_1"
"AGGGTGAAGAGCGACT"	"PT_1"
"AGGGTGAAGTCCCAGC"	"T-cell"
"AGGGTGACACCTGCAG"	"DCT_1"
"AGGGTGAGTGGCAACA"	"PT_2"
"AGGGTGATCAAGCTTG"	"PT_2"
"AGGGTGATCAGGTGTT"	"POD"
"AGGGTGATCCCGTAAA"	"EC-PTC"
"AGGGTGATCCGTTGGG"	"iPT"
"AGGGTGATCCTGGGTG"	"DCT_1"
"AGGGTGATCGCTAGCG"	"PT_2"
"AGGGTTTGTCCAAAGG"	"DCT_1"
"AGGGTTTGTGTTATCG"	"PT_1"
"AGGGTTTTCTTCGCTG"	"IC-A1_1"
"AGGTAGGAGGAACGAA"	"DCT_1"
"AGGTAGGCACCCTATC"	"PT_1"
"AGGTAGGCACTTACAG"	"CNT"
"AGGTAGGGTGACATCT"	"POD"
"AGGTAGGGTGCTCTCT"	"POD"
"AGGTAGGGTGGCTGAA"	"PT_1"
"AGGTAGGGTGTTCCTC"	"CNT"
"AGGTAGGGTTTCGCTC"	"PT_1"
"AGGTAGGTCCATACAG"	"CNT"
"AGGTAGGTCGACCCAG"	"PT_1"
"AGGTAGGTCTAACGGT"	"CNT"
"AGGTCATAGAGATGCC"	"POD"
"AGGTCATCAACTCGTA"	"MC"
"AGGTCATCAATAGGGC"	"PT_1"
"AGGTCATCATCGAACT"	"IC-A1_1"
"AGGTCATGTACAGCGA"	"CNT"
"AGGTCATGTGTCATCA"	"PT_2"
"AGGTCATTCACGGTCG"	"PT_1"
"AGGTCATTCCCAGGCA"	"PT_1"
"AGGTCTAGTAGAGGAA"	"IC-A1_1"
"AGGTCTATCCCGTAAA"	"PT_2"
"AGGTCTATCCTACCGT"	"PT_2"
"AGGTCTATCTCAACGA"	"PT_2"
"AGGTGTTCAATTGCAC"	"PT_1"
"AGGTGTTGTTGGTGTT"	"iPT"
"AGGTGTTTCACATCAG"	"GC-EC"
"AGGTGTTTCCGCAGTG"	"DCT_1"
"AGGTGTTTCTCATTTG"	"PT_2"
"AGGTGTTTCTGCGGGT"	"PT_2"
"AGGTTACAGGGCCTCT"	"PT_2"
"AGGTTACCACGTCTCT"	"DCT_1"
"AGGTTACGTCCGGACT"	"iPT"
"AGGTTACGTCTCCCTA"	"GC-EC"
"AGGTTACGTCTCCTGT"	"CNT"
"AGGTTACGTTGCTGAT"	"PT_1"
"AGGTTACTCCTCCACA"	"CNT"
"AGGTTACTCTCAGGCG"	"PT_1"
"AGGTTGTAGACTGAGC"	"IC-A1_1"
"AGGTTGTAGCGCCCAT"	"PT_2"
"AGGTTGTCAGTATGAA"	"MC"
"AGGTTGTCATGAAGCG"	"CNT"
"AGGTTGTGTTACCCAA"	"TAL"
"AGGTTGTTCATTTGCT"	"EC-PTC"
"AGTAACCAGATAGTGT"	"EC-PTC"
"AGTAACCCAACGGCCT"	"PT_1"
"AGTAACCCATGACAAA"	"DCT_1"
"AGTAACCGTTATGTCG"	"PT_1"
"AGTAACCGTTTGAAAG"	"PT_1"
"AGTACCAAGGTAAGAG"	"iPT"
"AGTACCACAAAGGGCT"	"IC-A1_1"
"AGTACCATCAGCAGAG"	"PT_2"
"AGTACCATCGTTCAGA"	"PT_1"
"AGTACCATCTATCCAT"	"PT_2"
"AGTACTGCACGGTGAA"	"PT_1"
"AGTACTGCAGCACCCA"	"TAL"
"AGTACTGCAGTGTACT"	"GC-EC"
"AGTACTGCATCAGCTA"	"PT_2"
"AGTACTGGTACGGATG"	"CNT"
"AGTACTGTCTGCGTCT"	"iPT"
"AGTAGCTAGGATTTGA"	"IC-A1_1"
"AGTAGCTAGTGCCGAA"	"PT_1"
"AGTAGCTCACGTCTCT"	"PT_1"
"AGTAGCTGTGGGTTGA"	"IC-A1_1"
"AGTAGCTGTTGACTGT"	"iPT"
"AGTAGCTTCAGTCACA"	"PT_2"
"AGTAGTCAGTACAGAT"	"EC-PTC"
"AGTAGTCCATTGCTGA"	"PT_1"
"AGTAGTCGTGACACGA"	"iPT"
"AGTAGTCGTGAGATCG"	"PT_1"
"AGTAGTCGTGATACAA"	"DCT_1"
"AGTAGTCTCCTCAGGG"	"PT_1"
"AGTCAACAGAGGGTAA"	"PT_1"
"AGTCAACAGCCTCTCT"	"PT_1"
"AGTCAACAGGATAATC"	"PT_2"
"AGTCAACGTCGTGATT"	"CNT"
"AGTCAACTCTAGGCCG"	"TAL"
"AGTCACACACAAGTGG"	"IC-A1_1"
"AGTCACACAGACCTGC"	"PT_1"
"AGTCACACAGAGTCAG"	"DCT_1"
"AGTCACATCTCCATAT"	"PT_2"
"AGTCATGAGGGCATGT"	"DCT_1"
"AGTCATGAGTATAACG"	"CNT"
"AGTCATGCAGCAGTGA"	"iPT"
"AGTCATGCATATGAAG"	"CNT"
"AGTCATGGTATTGACC"	"DCT_1"
"AGTCATGGTCGTGTTA"	"PT_2"
"AGTCATGTCACCTGGG"	"IC-A1_1"
"AGTCTCCAGGCCTGAA"	"PEC"
"AGTCTCCCACAAATGA"	"TAL"
"AGTCTCCCAGCGGTTC"	"PT_1"
"AGTCTCCCATGACAAA"	"iPT"
"AGTCTCCCATGGCCAC"	"GC-EC"
"AGTCTCCGTACCACGC"	"PT_2"
"AGTCTCCGTGGCCCAT"	"PT_1"
"AGTCTCCTCCGTGTGG"	"DCT_2"
"AGTCTCCTCTACCTTA"	"IC-A1_1"
"AGTCTCCTCTCTGGTC"	"EC-PTC"
"AGTGACTAGGCCTGAA"	"EC-PTC"
"AGTGACTAGGCGAAGG"	"CNT"
"AGTGACTAGGTAAGTT"	"PT_2"
"AGTGACTAGGTGAGAA"	"CNT"
"AGTGACTCAATAGGGC"	"PT_2"
"AGTGACTGTCTGTCAA"	"PT_1"
"AGTGACTGTGAATAAC"	"DCT_1"
"AGTGACTTCCAGCCTT"	"DCT_1"
"AGTGACTTCTCGCAGG"	"PT_2"
"AGTGATCGTACAAAGT"	"PT_1"
"AGTGCCGCATGGGAAC"	"iPT"
"AGTGCCGGTCCGGACT"	"iPT"
"AGTGCCGGTGACTGAG"	"DCT_1"
"AGTGCCGTCACTTCTA"	"iPT"
"AGTGCCGTCGTGGGAA"	"DCT_1"
"AGTGTTGCAGTTCACA"	"PT_2"
"AGTGTTGCATGACCCG"	"PT_1"
"AGTGTTGGTAGATCCT"	"PT_1"
"AGTGTTGTCACTTGGA"	"TAL"
"AGTTAGCAGTAGACCG"	"PT_2"
"AGTTAGCTCAGATTGC"	"PT_2"
"AGTTAGCTCATAGCAC"	"PT_1"
"AGTTAGCTCTACGCGG"	"PT_2"
"AGTTAGCTCTCGCCTA"	"PT_2"
"AGTTCCCAGACAACAT"	"TAL"
"AGTTCCCAGTTCATGC"	"iPT"
"AGTTCCCCATCGCCTT"	"DCT_2"
"AGTTCCCGTATCGGTT"	"EC-PTC"
"AGTTCCCTCGTCTACC"	"EC-PTC"
"AGTTCCCTCTACCCAC"	"PT_1"
"AGTTCGAGTATCAGCT"	"IC-A1_1"
"AGTTCGATCAGCCTTC"	"DCT_1"
"AGTTCGATCGATTCCC"	"PT_2"
"AGTTCGATCTCGGTAA"	"GC-EC"
"ATACCGAAGAAGTCCG"	"DCT_2"
"ATACCGAAGCACGATG"	"iPT"
"ATACCGAAGGAACTAT"	"PT_1"
"ATACCGAAGTACTGTC"	"DCT_1"
"ATACCGACAGACACCC"	"DCT_1"
"ATACCGACATCGTGCG"	"PT_1"
"ATACCGAGTCAACCAT"	"iPT"
"ATACCGATCGTCCTCA"	"CNT"
"ATACCTTAGGATTCCT"	"PT_2"
"ATACCTTCATACCGTA"	"PT_1"
"ATACCTTGTGTGCTTA"	"PT_2"
"ATACCTTGTTGTTGCA"	"IC-A1_1"
"ATACCTTGTTTAGAGA"	"PT_2"
"ATACCTTTCTTACGTT"	"PT_2"
"ATACTTCAGGGCAATC"	"PT_2"
"ATACTTCGTACCCGCA"	"PT_2"
"ATACTTCTCCGCTTAC"	"PT_1"
"ATACTTCTCTAAGCGT"	"CNT"
"ATAGACCAGGTCTGGA"	"CNT"
"ATAGACCAGTAGTCAA"	"IC-A1_1"
"ATAGACCCATGTGCTA"	"PT_1"
"ATAGACCGTAAGGCTG"	"DCT_1"
"ATAGACCGTACGATGG"	"PT_1"
"ATAGACCTCATCTCTA"	"PT_1"
"ATAGACCTCGGTTCAA"	"PT_2"
"ATAGACCTCTTCCGTG"	"DCT_1"
"ATAGACCTCTTTCCAA"	"PT_1"
"ATAGAGAAGGAGGGTG"	"EC-PTC"
"ATAGAGACAGCCGGTT"	"PT_1"
"ATAGAGAGTAGTCTGT"	"PT_2"
"ATAGAGAGTCTATGAC"	"CNT"
"ATAGAGAGTGTGTCGC"	"CNT"
"ATAGGCTAGGCTTCCG"	"EC-PTC"
"ATAGGCTCAATCCTTT"	"PT_1"
"ATAGGCTCAATGGCCC"	"PT_1"
"ATAGGCTCAGGCACTC"	"PT_2"
"ATAGGCTCATCCTTCG"	"PT_1"
"ATAGGCTGTGCGCTCA"	"PT_2"
"ATAGGCTTCTTGCAGA"	"PT_1"
"ATATCCTAGACATACA"	"IC-A1_1"
"ATATCCTCAACGTAAA"	"iPT"
"ATATCCTCACTCTGCT"	"IC-A1_1"
"ATATCCTCAGACCTGC"	"DCT_1"
"ATATCCTCAGAGCGTA"	"PT_1"
"ATATCCTCATGACAAA"	"DCT_1"
"ATATCCTGTGGACAGT"	"IC-A1_1"
"ATATCCTGTGTATTCG"	"EC-PTC"
"ATCACAGGTCTTCATT"	"EC-PTC"
"ATCACAGTCCCTTTGG"	"PT_1"
"ATCACGAAGCGTGTTT"	"PT_1"
"ATCACGAAGTTGGCTT"	"PEC"
"ATCACGACACGTAGAG"	"PT_1"
"ATCACGAGTAACAAGT"	"PT_1"
"ATCACGAGTTAGGGTG"	"DCT_1"
"ATCACGAGTTGTCAGT"	"CNT"
"ATCACTTAGAGTGACC"	"DCT_1"
"ATCACTTGTACAACGG"	"DCT_1"
"ATCACTTGTTTACTTC"	"PT_1"
"ATCACTTTCATAGCAC"	"IC-A1_1"
"ATCACTTTCCGGCTTT"	"EC-PTC"
"ATCACTTTCGTCAGAT"	"iPT"
"ATCAGGTAGACCAGAC"	"DCT_1"
"ATCAGGTCATCCGTTC"	"DCT_1"
"ATCAGGTGTGATACTC"	"TAL"
"ATCATTCCAACCTAAC"	"IC-A1_1"
"ATCATTCCAACGCATT"	"IC-A1_2"
"ATCATTCTCCTTGGAA"	"PT_1"
"ATCATTCTCGCTTGCT"	"PT_1"
"ATCATTCTCTACGGGC"	"PT_2"
"ATCCACCCACGTACTA"	"DCT_1"
"ATCCACCCACTTACAG"	"DCT_1"
"ATCCACCTCATATGGC"	"DCT_1"
"ATCCACCTCCAACTAG"	"PT_2"
"ATCCATTTCCTTCACG"	"PT_1"
"ATCCATTTCGCTTGAA"	"DCT_1"
"ATCCCTGAGCTGGTGA"	"PT_1"
"ATCCCTGAGGAAGTCC"	"CNT"
"ATCCCTGAGGGTATAT"	"PT_2"
"ATCCCTGCACATGTTG"	"DCT_1"
"ATCCCTGTCCAACACA"	"MC"
"ATCCGTCCAAGGGCAT"	"GC-EC"
"ATCCGTCCACCAGCCA"	"PT_2"
"ATCCGTCCAGCGACAA"	"IC-A1_1"
"ATCCGTCCATCTGCGG"	"GC-EC"
"ATCCGTCGTATACCTG"	"DCT_1"
"ATCCGTCGTTCCTAGA"	"PT_2"
"ATCCTATCATTGTACG"	"GC-EC"
"ATCCTATTCTGTAAGC"	"CNT"
"ATCGATGAGAGGACTC"	"PT_1"
"ATCGATGCAGCATCTA"	"PT_1"
"ATCGATGCAGCTGTTA"	"CNT"
"ATCGATGGTGATAGAT"	"PT_2"
"ATCGATGTCAACCGAT"	"iPT"
"ATCGCCTAGCTATCCA"	"PT_1"
"ATCGCCTAGTCATCCA"	"PT_1"
"ATCGCCTCAACGGTAG"	"PT_2"
"ATCGCCTGTGGTTTGT"	"iPT"
"ATCGCCTTCGCTGACG"	"DCT_1"
"ATCGGATAGTATGAAC"	"DCT_1"
"ATCGGATAGTGGTGAC"	"TAL"
"ATCGGATCAAGTCGTT"	"PT_1"
"ATCGGATCACGGATCC"	"PT_1"
"ATCGGCGCAAGTACCT"	"iPT"
"ATCGGCGGTCGGCTAC"	"CNT"
"ATCGTAGCATGACCCG"	"TAL"
"ATCGTAGGTCGAGCTC"	"DCT_1"
"ATCGTAGTCCGCTGTT"	"PT_2"
"ATCGTAGTCGAATGCT"	"DCT_1"
"ATCGTAGTCTGAGAGG"	"GC-EC"
"ATCGTCCAGCAACTCT"	"DCT_1"
"ATCGTCCAGCACTCAT"	"PT_1"
"ATCGTCCCAATACGCT"	"DCT_1"
"ATCGTCCCAGTGCGCT"	"GC-EC"
"ATCGTCCTCAGATTGC"	"CNT"
"ATCGTCCTCGTGGGAA"	"iPT"
"ATCGTCCTCTCTGAGA"	"GC-EC"
"ATCGTGAAGCGACCCT"	"CNT"
"ATCGTGACACACGGAA"	"IC-A1_1"
"ATCGTGAGTGAGACGT"	"PT_1"
"ATCGTGATCACCATCC"	"DCT_1"
"ATCGTGATCCTACCAC"	"PT_1"
"ATCGTGATCTCAAAGC"	"PT_1"
"ATCGTGATCTGGAGAG"	"PT_2"
"ATCGTGATCTGTCGTC"	"DCT_1"
"ATCTCTAAGTATGACA"	"PT_2"
"ATCTCTACAACACGTT"	"EC-PTC"
"ATCTCTACAAGCACAG"	"DCT_1"
"ATCTCTACAAGGAGTC"	"TAL"
"ATCTCTAGTCAAAGAT"	"TAL"
"ATCTCTAGTGACCGAA"	"DCT_1"
"ATCTCTAGTTACGATC"	"IC-A1_1"
"ATCTCTATCAAACCTG"	"CNT"
"ATCTCTATCCGATAAC"	"DCT_1"
"ATCTCTATCGAGTACT"	"PT_2"
"ATCTCTATCGTGCACG"	"TAL"
"ATCTTCAAGCCATTCA"	"PT_1"
"ATCTTCAAGTAGCATA"	"CNT"
"ATCTTCAAGTGAGTGC"	"EC-PTC"
"ATCTTCAGTATGGGAC"	"EC-PTC"
"ATCTTCATCCCGTTCA"	"PT_1"
"ATGAAAGAGGCTGTAG"	"DCT_1"
"ATGAAAGCATGCGTGC"	"PT_1"
"ATGAAAGGTTGGGTAG"	"PT_1"
"ATGAAAGTCCGCCTAT"	"PT_1"
"ATGACCAAGTAGGGTC"	"PT_1"
"ATGACCAGTAGACACG"	"TAL"
"ATGACCAGTAGAGATT"	"EC-PTC"
"ATGACCAGTGGAACAC"	"iPT"
"ATGACCATCTGGCTGG"	"PT_1"
"ATGAGGGAGCGTTCCG"	"CNT"
"ATGAGGGAGTTGTAGA"	"EC-PTC"
"ATGAGGGCAACCCGCA"	"PT_2"
"ATGAGGGCAATTTCTC"	"DCT_1"
"ATGAGGGGTCTTACTT"	"TAL"
"ATGAGGGGTGTGTCGC"	"DCT_1"
"ATGAGGGGTTGCCAAT"	"CNT"
"ATGAGGGTCGGTTGTA"	"DCT_1"
"ATGAGGGTCGTGTCAA"	"CNT"
"ATGAGTCCAGATCCTA"	"DCT_1"
"ATGAGTCTCCCGAAAT"	"IC-A1_1"
"ATGAGTCTCTCAACGA"	"PT_1"
"ATGATCGCACATCATG"	"PT_2"
"ATGATCGCACCCTTGT"	"CNT"
"ATGATCGCATCCGGCA"	"PT_2"
"ATGATCGGTAGTTACC"	"PT_2"
"ATGATCGGTCGCAGTC"	"PT_2"
"ATGATCGTCAGGACGA"	"IC-A1_2"
"ATGATCGTCCACACAA"	"TAL"
"ATGATCGTCTCTAAGG"	"TAL"
"ATGATCGTCTGAGGCC"	"PT_2"
"ATGATCGTCTGGGAGA"	"DCT_1"
"ATGATCGTCTTTGCGC"	"CNT"
"ATGCATGCACAAAGTA"	"TAL"
"ATGCATGGTCCCTGTT"	"PT_1"
"ATGCATGGTTTCCAAG"	"CNT"
"ATGCATGTCAACCGAT"	"PT_2"
"ATGCATGTCTCATGCC"	"PT_1"
"ATGCCTCAGCTCGAAG"	"IC-A1_1"
"ATGCCTCAGTTAACGA"	"PT_2"
"ATGCCTCCACAGACGA"	"CNT"
"ATGCCTCCACGGTGCT"	"PT_2"
"ATGCCTCTCAGACCTA"	"iPT"
"ATGCCTCTCGCCGAGT"	"DCT_1"
"ATGCCTCTCGGCCAAC"	"DCT_1"
"ATGCGATGTACGACTT"	"POD"
"ATGCGATGTAGCGCCT"	"DCT_1"
"ATGCGATTCAAGGTGG"	"iPT"
"ATGCGATTCACAATGC"	"CNT"
"ATGGAGGAGCCTCAGC"	"DCT_1"
"ATGGAGGAGGTACAAT"	"GC-EC"
"ATGGAGGGTAGTCTGT"	"PT_2"
"ATGGAGGTCACGGACC"	"GC-EC"
"ATGGATCAGGTTAGTA"	"GC-EC"
"ATGGATCCAGACCATT"	"PT_1"
"ATGGATCCAGGAATAT"	"iPT"
"ATGGATCGTAACGTTC"	"IC-A1_1"
"ATGGATCTCAACTGAC"	"PT_1"
"ATGGGAGAGTTGTACC"	"EC-PTC"
"ATGGGAGCAACGACAG"	"TAL"
"ATGGGAGCAATCCAGT"	"EC-PTC"
"ATGGGAGCACAGACGA"	"MC"
"ATGGGAGCACCAGTAT"	"PT_1"
"ATGGGAGCAGTCAGTT"	"GC-EC"
"ATGGGAGGTCATAGTC"	"PT_1"
"ATGGGAGGTCGTGATT"	"PT_2"
"ATGGGAGTCGACCACG"	"PT_2"
"ATGGGTTAGCGATGGT"	"IC-A1_1"
"ATGGGTTCAAATACGA"	"GC-EC"
"ATGGGTTCACTCGATA"	"PT_1"
"ATGGGTTGTACCGGAA"	"PT_1"
"ATGGGTTGTAGGAGTC"	"EC-PTC"
"ATGGGTTGTGAATAAC"	"EC-PTC"
"ATGGGTTTCAATCCGA"	"CNT"
"ATGGGTTTCGGTGTTA"	"DCT_1"
"ATGGTTGAGTGATTCC"	"PT_1"
"ATGGTTGCAAACACGG"	"DCT_1"
"ATGGTTGCAACAAGTA"	"DCT_1"
"ATGGTTGCAAGCTGTT"	"PT_2"
"ATGGTTGCAAGGTCGA"	"PT_1"
"ATGGTTGCAGGCATGA"	"GC-EC"
"ATGGTTGCATATGGCT"	"PT_1"
"ATGGTTGCATTGTCGA"	"CNT"
"ATGGTTGGTCTGTGAT"	"TAL"
"ATGGTTGGTGCCTATA"	"PT_1"
"ATGGTTGTCATGAAAG"	"PT_1"
"ATGGTTGTCGCAATTG"	"PT_2"
"ATGGTTGTCGTAGTGT"	"PT_2"
"ATGTCCCCAGACCATT"	"TAL"
"ATGTCCCCAGCCTTCT"	"GC-EC"
"ATGTCCCGTCGCATGC"	"PT_2"
"ATGTCCCGTTGTTGAC"	"PT_1"
"ATGTCCCGTTTGTGGT"	"PT_1"
"ATGTCCCTCCATACAG"	"PT_1"
"ATGTCTTGTAATGTGA"	"T-cell"
"ATGTCTTGTATTCTCT"	"T-cell"
"ATGTCTTTCCCTATTA"	"GC-EC"
"ATTACCTAGCACGGAT"	"EC-PTC"
"ATTACCTAGGTAGGCT"	"PEC"
"ATTACCTAGTACAACA"	"PT_1"
"ATTACCTCATGCTGCG"	"iPT"
"ATTACCTGTCCGGTCA"	"DCT_1"
"ATTACCTGTGCCGTAC"	"DCT_1"
"ATTACCTTCTGCCTCA"	"PT_1"
"ATTACTCCACCTCTAC"	"CNT"
"ATTACTCGTAAGCTCT"	"DCT_1"
"ATTACTCGTAGGTCAG"	"PT_1"
"ATTACTCGTGGTCAAG"	"DCT_1"
"ATTACTCTCGAGCTGC"	"iPT"
"ATTACTCTCGGTTAGT"	"TAL"
"ATTACTCTCTCGCCTA"	"PT_1"
"ATTACTCTCTTAGCTT"	"PT_2"
"ATTATCCAGCACCAGA"	"IC-A1_1"
"ATTATCCAGGATGCGT"	"TAL"
"ATTATCCCAACCACAT"	"DCT_1"
"ATTATCCCAGAAATCA"	"GC-EC"
"ATTATCCCAGAAGTTA"	"CNT"
"ATTATCCCATAGATCC"	"PT_1"
"ATTATCCGTACAGTCT"	"DCT_1"
"ATTATCCTCAACTGAC"	"PT_1"
"ATTCACTAGTAGGCCA"	"IC-A1_2"
"ATTCACTCACAATGTC"	"EC-PTC"
"ATTCACTCACAGAAGC"	"PT_1"
"ATTCACTTCCTACAAG"	"DCT_1"
"ATTCAGGAGCAAGTGC"	"DCT_1"
"ATTCAGGAGCGAACTG"	"EC-PTC"
"ATTCAGGAGTGCAAAT"	"CNT"
"ATTCAGGCAAACTCTG"	"CNT"
"ATTCAGGCAAGTGCTT"	"PT_2"
"ATTCAGGCACTGTGAT"	"IC-A1_1"
"ATTCAGGGTGGAGGTT"	"iPT"
"ATTCATCAGATAACGT"	"PT_1"
"ATTCATCAGCGAGTAC"	"EC-PTC"
"ATTCATCCAAGGACAC"	"DCT_1"
"ATTCATCGTAGCCAGA"	"DCT_1"
"ATTCATCTCTTTCGAT"	"EC-PTC"
"ATTCCATCAAGCGAGT"	"TAL"
"ATTCCATCATGGCGCT"	"PT_1"
"ATTCCATTCTCCTGAC"	"CNT"
"ATTCCATTCTGGACCG"	"CNT"
"ATTCCCGCACAGTCCG"	"DCT_1"
"ATTCCCGCACATGTTG"	"DCT_1"
"ATTCCCGCACGAGGTA"	"CNT"
"ATTCCCGCACTAGAGG"	"CNT"
"ATTCCCGCAGAAGCGT"	"DCT_1"
"ATTCCCGGTGGCCACT"	"CNT"
"ATTCCCGGTGGCGCTT"	"GC-EC"
"ATTCCCGTCATTCACT"	"DCT_1"
"ATTCCTAAGATCCCAT"	"EC-PTC"
"ATTCCTAAGCAACCAG"	"EC-PTC"
"ATTCCTAAGTAAGACT"	"IC-A1_1"
"ATTCCTACAAGTCCAT"	"CNT"
"ATTCCTACAGCGTGCT"	"PT_2"
"ATTCCTAGTATGAAGT"	"PT_1"
"ATTCCTAGTCTTGTCC"	"EC-PTC"
"ATTCCTAGTGTCGATT"	"PT_1"
"ATTCGTTAGGCTGTAG"	"PT_1"
"ATTCGTTCAATGTCAC"	"PT_2"
"ATTCGTTCAGCTGTTA"	"TAL"
"ATTCGTTCAGTCTGGC"	"PT_1"
"ATTCGTTGTCTCTCCA"	"PT_1"
"ATTCGTTTCATTCTTG"	"DCT_1"
"ATTCTACAGGCACTAG"	"GC-EC"
"ATTCTACCACAAAGCG"	"PT_1"
"ATTCTACCACTCCTGT"	"TAL"
"ATTCTACGTGGTAATA"	"TAL"
"ATTCTTGAGACATACA"	"PT_1"
"ATTCTTGCAGGTGGAT"	"PT_2"
"ATTCTTGGTGCTCCGA"	"PT_2"
"ATTCTTGGTGGCCCAT"	"PT_2"
"ATTCTTGGTGGTTTGT"	"EC-PTC"
"ATTCTTGGTTTCCCAC"	"PEC"
"ATTCTTGTCATCGCCT"	"POD"
"ATTCTTGTCCTCAGGG"	"DCT_2"
"ATTGGGTCAATCGTCA"	"PEC"
"ATTGGGTCATAACGGG"	"DCT_1"
"ATTGGGTGTATGAGCG"	"PT_1"
"ATTGGGTTCCAGCTCT"	"PT_2"
"ATTGGGTTCTATCGCC"	"TAL"
"ATTGTTCCACTCCACT"	"DCT_1"
"ATTGTTCGTCGCTCGA"	"DCT_1"
"ATTGTTCGTGATAGTA"	"PT_2"
"ATTGTTCTCAAGGACG"	"PT_1"
"ATTGTTCTCGATCCCT"	"PT_1"
"ATTTACCGTAAGAACT"	"PT_1"
"ATTTACCGTCTTGTCC"	"TAL"
"ATTTACCGTGTAAATG"	"PT_2"
"ATTTACCTCATCACCC"	"TAL"
"ATTTACCTCCGGTTCT"	"PT_1"
"ATTTACCTCGATCCAA"	"PT_1"
"ATTTCACCAAGGGCAT"	"CNT"
"ATTTCACGTAACAAGT"	"GC-EC"
"ATTTCACGTTGTGCCG"	"PT_2"
"ATTTCACTCGGTGTAT"	"GC-EC"
"ATTTCTGCAAATGGTA"	"TAL"
"ATTTCTGGTTGTGGCC"	"DCT_1"
"ATTTCTGTCCACGTCT"	"CNT"
"ATTTCTGTCTCGCGTT"	"PT_2"
"CAAAGAAAGGATTCCT"	"PT_2"
"CAAAGAAAGGTTAGTA"	"PT_1"
"CAAAGAAAGTCGCCCA"	"PT_2"
"CAAAGAACACTCTAGA"	"CNT"
"CAAAGAAGTAGAATAC"	"CNT"
"CAAAGAAGTAGCTGAG"	"DCT_1"
"CAAAGAAGTCTCCTGT"	"PT_1"
"CAAAGAATCAATCCGA"	"IC-A1_1"
"CAAAGAATCACTACGA"	"PT_2"
"CAAAGAATCGTGGCGT"	"TAL"
"CAAAGAATCTTCTGTA"	"CNT"
"CAAAGAATCTTGGTGA"	"EC-PTC"
"CAACAACAGCTAATGA"	"EC-PTC"
"CAACAACGTGAAGCGT"	"PT_1"
"CAACAACGTGCCTATA"	"PT_2"
"CAACAACGTGTGTTTG"	"CNT"
"CAACAACTCTCCCATG"	"PT_2"
"CAACAGTAGCAACCAG"	"IC-A1_1"
"CAACAGTAGCATGTTC"	"PT_2"
"CAACAGTAGTTACGTC"	"IC-A1_1"
"CAACAGTCAAATGCGG"	"PT_1"
"CAACAGTCAACAAGAT"	"PT_1"
"CAACAGTGTCTTACAG"	"PT_2"
"CAACAGTGTGACAGGT"	"TAL"
"CAACAGTGTGCGACAA"	"PT_1"
"CAACAGTTCAATCCAG"	"PT_2"
"CAACAGTTCCCAAGTA"	"PT_2"
"CAACAGTTCCTGGCTT"	"DCT_1"
"CAACAGTTCGTAGGGA"	"PT_2"
"CAACCAAAGACGGTCA"	"GC-EC"
"CAACCAAAGTAAGGGA"	"CNT"
"CAACCAACAAGACGAC"	"DCT_1"
"CAACCAACAAGCCTGC"	"PT_1"
"CAACCAAGTCATAACC"	"PT_2"
"CAACCAAGTTATGACC"	"DCT_1"
"CAACCAATCCGTAATG"	"TAL"
"CAACCAATCGAGTTGT"	"CNT"
"CAACCTCAGAGTCAAT"	"PT_1"
"CAACCTCAGCTACAAA"	"GC-EC"
"CAACCTCAGGACTAAT"	"PT_2"
"CAACCTCAGTATAGAC"	"PT_1"
"CAACCTCGTGGCATCC"	"CNT"
"CAACCTCTCACAAGGG"	"CNT"
"CAACCTCTCGGACTTA"	"PT_1"
"CAACGATCAAGTGTCT"	"PT_1"
"CAACGATGTGTCATGT"	"PT_2"
"CAACGATTCCAGGACC"	"PT_1"
"CAACGATTCGCGATCG"	"iPT"
"CAACGGCAGACTACCT"	"DCT_1"
"CAACGGCAGGAGCAAA"	"PT_1"
"CAACGGCAGGGTCACA"	"iPT"
"CAACGGCCACGACCTG"	"DCT_1"
"CAACGGCCACTCTAGA"	"TAL"
"CAACGGCCAGAGCGTA"	"PT_1"
"CAACGGCCATCGGAAG"	"PT_1"
"CAACGGCTCCGATTAG"	"TAL"
"CAAGACTAGTGATAAC"	"PT_2"
"CAAGACTCAGCTTCGG"	"iPT"
"CAAGACTGTACAACGG"	"IC-A1_1"
"CAAGACTGTACCATAC"	"CNT"
"CAAGACTGTCCAACGC"	"DCT_1"
"CAAGACTGTCTAATCG"	"DCT_1"
"CAAGACTGTCTCAGGC"	"iPT"
"CAAGAGGAGAGCATAT"	"IC-A1_1"
"CAAGAGGAGATCCCGC"	"EC-PTC"
"CAAGAGGAGTAATACG"	"CNT"
"CAAGAGGGTCACCGAC"	"iPT"
"CAAGAGGGTGGACCTC"	"IC-A1_1"
"CAAGAGGTCAGAATAG"	"DCT_1"
"CAAGAGGTCCGGACGT"	"IC-A1_2"
"CAAGAGGTCGAGTCCG"	"PT_2"
"CAAGAGGTCGGATTAC"	"CNT"
"CAAGAGGTCTTACCAT"	"EC-PTC"
"CAAGCTAAGATAGTGT"	"PT_1"
"CAAGCTACACTGGCCA"	"PT_1"
"CAAGCTAGTACGGTTT"	"PT_2"
"CAAGCTAGTTCGTTCC"	"PT_1"
"CAAGCTATCATCCTGC"	"IC-A1_1"
"CAAGGGACAGGACGAT"	"TAL"
"CAAGGGACAGTGACCC"	"PT_2"
"CAAGGGATCGGTTGTA"	"PT_1"
"CAAGGGATCTTGTTAC"	"POD"
"CAATACGAGAAATTCG"	"PT_1"
"CAATACGAGAATACAC"	"TAL"
"CAATACGCAAGCGCTC"	"PT_1"
"CAATACGTCATTGAGC"	"PT_1"
"CAATCGAAGCACCCAC"	"PT_2"
"CAATCGACATGGAAGC"	"DCT_1"
"CAATCGAGTCTGATAC"	"DCT_1"
"CAATCGAGTTGGATCT"	"TAL"
"CAATCGATCAACACCA"	"EC-PTC"
"CAATCGATCATCACAG"	"DCT_1"
"CAATCGATCATGGGAG"	"DCT_1"
"CAATGACAGACTACGG"	"DCT_1"
"CAATGACAGATCCCAT"	"DCT_1"
"CAATGACAGCTATCTG"	"iPT"
"CAATGACAGCTGACCC"	"PT_2"
"CAATGACGTAACGGTG"	"CNT"
"CAATGACGTACTGTTG"	"PT_2"
"CAATGACGTCTCTCCA"	"DCT_2"
"CAATGACGTGATACAA"	"IC-A1_1"
"CAATTTCGTCTTACTT"	"PT_1"
"CAATTTCGTTACGCCG"	"PT_1"
"CAATTTCTCCATTGGA"	"CNT"
"CAATTTCTCTCGGCTT"	"PT_1"
"CACAACAAGACTTAAG"	"GC-EC"
"CACAACAAGCCTGTCG"	"IC-A1_1"
"CACAACAAGCTCCACG"	"PT_2"
"CACAACACACATGGTT"	"DCT_1"
"CACAACACATTGAGCT"	"PT_1"
"CACAACAGTACAGAGC"	"CNT"
"CACAACAGTTTCCAAG"	"PT_1"
"CACAACATCACCCTCA"	"PT_1"
"CACAACATCAGCACCG"	"DCT_1"
"CACAACATCTCTGCTG"	"DCT_1"
"CACACAAAGTCAGCCC"	"DCT_1"
"CACACAAAGTCGAAGC"	"CNT"
"CACACAAGTAACTTCG"	"PT_1"
"CACACAAGTAGCCCTG"	"TAL"
"CACACAAGTATGCTAC"	"PT_2"
"CACACAAGTCTCACAA"	"PT_1"
"CACAGATAGGAACTCG"	"DCT_1"
"CACAGATAGGGTGAAA"	"iPT"
"CACAGATAGGTCCCGT"	"PT_1"
"CACAGATCAATCCTTT"	"PT_2"
"CACAGATGTCACCACG"	"GC-EC"
"CACAGATGTTAGAAGT"	"IC-A1_1"
"CACAGATGTTTCAGAC"	"TAL"
"CACAGGCAGGGCCAAT"	"DCT_1"
"CACAGGCCACTGCATA"	"DCT_1"
"CACAGGCCATGCAGGA"	"PT_1"
"CACAGGCGTACAAAGT"	"PT_1"
"CACAGGCGTAGTGATA"	"PT_1"
"CACAGGCGTATGGAGC"	"CNT"
"CACATGAAGGTACAGC"	"DCT_1"
"CACATGAAGTGGCCTC"	"CNT"
"CACATGACAATAACCC"	"CNT"
"CACATGACAGACACCC"	"PT_1"
"CACATGACAGCTTCGG"	"PT_1"
"CACATGAGTTATAGAG"	"PT_1"
"CACATGATCAAGCCGC"	"POD"
"CACATGATCAGTGGGA"	"PT_1"
"CACATGATCATGCCGG"	"PT_1"
"CACATGATCATTTCCA"	"DCT_1"
"CACCAAACAAGAGTAT"	"POD"
"CACCAAACACAAGTTC"	"PT_2"
"CACCAAAGTTGTAGCT"	"PT_1"
"CACCAAATCAGACCCG"	"PT_1"
"CACCAAATCAGTCACA"	"PT_2"
"CACCGTTAGTTGTAGA"	"PT_2"
"CACCGTTCAGATTTCG"	"IC-A1_1"
"CACCGTTTCATGCTAG"	"IC-A1_1"
"CACCGTTTCCTGTAGA"	"iPT"
"CACCGTTTCGCTAATG"	"iPT"
"CACCGTTTCGGCTGAC"	"PT_1"
"CACGAATAGACATAAC"	"CNT"
"CACGAATAGCAATTAG"	"CNT"
"CACGAATAGCTGAGTG"	"IC-A1_1"
"CACGAATCAGCTCCTT"	"CNT"
"CACGAATGTCCATACA"	"EC-PTC"
"CACGAATGTTATAGAG"	"EC-PTC"
"CACGAATGTTCCACAA"	"iPT"
"CACGAATTCTATGTGG"	"IC-A1_1"
"CACGGGTAGACATGCG"	"EC-PTC"
"CACGGGTCAGCCCAGT"	"TAL"
"CACGGGTGTGAGGCAT"	"GC-EC"
"CACGGGTGTTTATGCG"	"GC-EC"
"CACGGGTTCAAACGTC"	"PT_1"
"CACGGGTTCACTACTT"	"DCT_1"
"CACGGGTTCCTCGCAT"	"CNT"
"CACGGGTTCTGTGCGG"	"CNT"
"CACGTGGAGCCACAAG"	"PT_2"
"CACGTGGAGCGTCTCG"	"DCT_1"
"CACGTGGCAAAGGGTC"	"IC-A1_1"
"CACGTGGCACGCGGTT"	"DCT_1"
"CACGTGGCATGGTACT"	"IC-A1_1"
"CACGTGGGTCCAATCA"	"DCT_1"
"CACGTGGGTGCACATT"	"EC-PTC"
"CACGTGGTCAATCCGA"	"PT_1"
"CACGTGGTCCATCTAT"	"GC-EC"
"CACGTTCAGCAACTCT"	"DCT_1"
"CACGTTCCATAATCCG"	"EC-PTC"
"CACGTTCGTTGTCCCT"	"DCT_1"
"CACGTTCTCGCGGACT"	"iPT"
"CACTAAGCAGGCTACC"	"DCT_1"
"CACTAAGGTGTTTGCA"	"TAL"
"CACTAAGGTTCCTTGC"	"T-cell"
"CACTAAGTCGGTGAAG"	"CNT"
"CACTAAGTCTGGGCAC"	"IC-A1_1"
"CACTGAACATCGTGCG"	"PT_1"
"CACTGAAGTTGCTCAA"	"TAL"
"CACTGAATCCCGATCT"	"iPT"
"CACTGGGAGCCATTCA"	"PT_1"
"CACTGGGCACACCTAA"	"PT_1"
"CACTGGGCAGAGAGGG"	"GC-EC"
"CACTGGGCATTCATCT"	"PT_2"
"CACTGGGGTAACAGTA"	"GC-EC"
"CACTGGGGTAACTGCT"	"POD"
"CACTGGGGTATCTTCT"	"EC-PTC"
"CACTGGGTCATAAGGA"	"TAL"
"CACTGTCGTAATCAGA"	"GC-EC"
"CACTGTCGTCTCCCTA"	"GC-EC"
"CACTGTCTCAAGCTTG"	"TAL"
"CACTGTCTCCACTTTA"	"CNT"
"CACTGTCTCGAACCTA"	"TAL"
"CACTGTCTCGACGACC"	"PT_2"
"CACTGTCTCTATCGTT"	"DCT_1"
"CACTTCGAGTGCAAAT"	"TAL"
"CACTTCGCATATCTGG"	"CNT"
"CACTTCGGTCATCACA"	"PT_2"
"CACTTCGGTCGCGTTG"	"CNT"
"CACTTCGTCAGTCCGG"	"iPT"
"CACTTCGTCGGATTAC"	"PT_1"
"CAGAGCCAGCTGACAG"	"TAL"
"CAGAGCCAGGAGCAAA"	"DCT_1"
"CAGAGCCAGGCAGTCA"	"TAL"
"CAGAGCCCAACAGCTT"	"DCT_1"
"CAGAGCCCATACTGTG"	"PT_2"
"CAGAGCCCATTCCTCG"	"TAL"
"CAGAGCCTCATCTGTT"	"CNT"
"CAGATACAGACAACTA"	"iPT"
"CAGATACAGGACAGCT"	"CNT"
"CAGATACAGTTGCGAG"	"PT_1"
"CAGATACCAACTAGAA"	"PT_2"
"CAGATACCAAGTGCTT"	"DCT_1"
"CAGATACCAGATAAAC"	"PT_1"
"CAGATACCAGATTCGT"	"EC-PTC"
"CAGATACGTAGGTACG"	"PT_1"
"CAGATACGTGATCGTT"	"DCT_1"
"CAGATACGTGGCTTAT"	"IC-A1_1"
"CAGATACTCATCGGGC"	"PT_2"
"CAGATACTCGGACAAG"	"DCT_1"
"CAGATCAAGCACGATG"	"EC-PTC"
"CAGATCAAGTTCCATG"	"PT_1"
"CAGATCACATTCACCC"	"DCT_1"
"CAGATCAGTGTTCGAT"	"PT_1"
"CAGATCAGTGTTTACG"	"DCT_1"
"CAGATCATCACGGTCG"	"PT_1"
"CAGATCATCTTTGCGC"	"DCT_1"
"CAGATTGGTGGAATGC"	"PT_1"
"CAGATTGTCAGCACCG"	"IC-A1_1"
"CAGCAATAGGCTGAAC"	"PT_1"
"CAGCAATCAAGGGTCA"	"GC-EC"
"CAGCAATCACCAACAT"	"PT_2"
"CAGCAATCAGACGGAT"	"CNT"
"CAGCAATGTATCGAAA"	"POD"
"CAGCAATTCGTCGATA"	"iPT"
"CAGCAATTCTCTCTAA"	"EC-PTC"
"CAGCAATTCTTTGGAG"	"DCT_1"
"CAGCACGAGGACAAGA"	"DCT_1"
"CAGCACGAGGAGACCT"	"PT_1"
"CAGCACGGTCAGGTAG"	"CNT"
"CAGCACGGTTGGTACT"	"EC-PTC"
"CAGCACGTCCCGAAAT"	"IC-A1_1"
"CAGCACGTCGGACCAC"	"EC-PTC"
"CAGCAGCCACTGAGTT"	"PT_1"
"CAGCAGCCATTACTCT"	"TAL"
"CAGCAGCGTCACTTAG"	"TAL"
"CAGCAGCTCTAAGCGT"	"DCT_1"
"CAGCAGCTCTCTAAGG"	"PT_1"
"CAGCCAGCAACGATCT"	"DCT_1"
"CAGCCAGCACTATCCC"	"PT_1"
"CAGCCAGCATCAGCAT"	"TAL"
"CAGCCAGGTAGCTTTG"	"PT_1"
"CAGCCAGGTATGCGTT"	"iPT"
"CAGCCAGGTCGGAAAC"	"CNT"
"CAGCCAGGTGTTACTG"	"PT_2"
"CAGCCAGGTTTGAACC"	"EC-PTC"
"CAGCCAGGTTTGGAGG"	"IC-A1_1"
"CAGCCAGTCGGCTCTT"	"GC-EC"
"CAGCCAGTCTCCTACG"	"EC-PTC"
"CAGCGTGCAACTTCTT"	"DCT_1"
"CAGCGTGCATCTGCGG"	"PT_1"
"CAGCGTGGTACTGGGA"	"GC-EC"
"CAGCGTGGTAGCGTTT"	"PT_1"
"CAGCGTGTCGTAACTG"	"CNT"
"CAGCGTGTCTAGACAC"	"CNT"
"CAGGCCACAGCGTTGC"	"PT_2"
"CAGGCCACAGTAACGG"	"DCT_1"
"CAGGCCAGTCCAGCGT"	"CNT"
"CAGGGCTAGGGACCAT"	"PT_1"
"CAGGGCTAGGGTCTTT"	"PT_2"
"CAGGGCTCACTCCGGA"	"GC-EC"
"CAGGGCTGTATAGGGC"	"DCT_1"
"CAGGGCTGTTTGGAGG"	"PT_1"
"CAGGTATAGTGAGTTA"	"DCT_1"
"CAGGTATCAAGCCCAC"	"DCT_1"
"CAGGTATCAGAGCTAG"	"EC-PTC"
"CAGGTATTCCCGTTCA"	"PT_2"
"CAGGTATTCGTCCTTG"	"IC-A1_1"
"CAGTGCGAGAGTAACT"	"DCT_1"
"CAGTGCGAGGCTAGCA"	"PT_1"
"CAGTGCGGTCCGGATC"	"CNT"
"CAGTGCGTCCCGAACG"	"iPT"
"CAGTTAGCAACGACAG"	"DCT_1"
"CAGTTAGCAGGCTATT"	"POD"
"CAGTTAGGTAACATAG"	"EC-PTC"
"CAGTTAGGTACGATGG"	"EC-PTC"
"CAGTTAGGTGTACAGG"	"PT_2"
"CAGTTAGGTGTAGCAG"	"PT_1"
"CAGTTAGGTTCGAACT"	"DCT_1"
"CAGTTAGTCAGCGCAC"	"DCT_1"
"CAGTTCCGTTACTCAG"	"CNT"
"CATAAGCCAATTGCCA"	"PT_2"
"CATAAGCCACTTTATC"	"iPT"
"CATAAGCGTATCACGT"	"CNT"
"CATAAGCTCGACGACC"	"DCT_1"
"CATAAGCTCGACGAGA"	"DCT_1"
"CATAAGCTCGCTATTT"	"PT_2"
"CATAAGCTCTGCAGCG"	"TAL"
"CATACAGAGGTACTGG"	"PT_2"
"CATACAGAGTGCGTCC"	"PT_2"
"CATACAGGTCTGATAC"	"PT_1"
"CATACAGGTTCGGGTC"	"PT_1"
"CATACAGGTTTCCATT"	"EC-PTC"
"CATACAGTCCGCGAGT"	"PT_1"
"CATACAGTCCTCACTG"	"IC-A1_1"
"CATACCCCAATTTCCT"	"DCT_1"
"CATACCCCACGACGAA"	"PT_2"
"CATACCCCACGCACCA"	"PT_1"
"CATACCCGTGCACAAG"	"CNT"
"CATACCCTCCGTACGG"	"EC-PTC"
"CATACCCTCTTGCGCT"	"PT_1"
"CATACTTAGCTGACAG"	"PT_2"
"CATACTTAGGTTGGTG"	"CNT"
"CATACTTCATTCTTCA"	"PT_1"
"CATACTTGTGCACGCT"	"CNT"
"CATACTTTCCGTCAAA"	"PT_2"
"CATAGACAGTCAAGCG"	"IC-A1_1"
"CATAGACGTAGCACGA"	"DCT_1"
"CATAGACGTGCTCCGA"	"DCT_1"
"CATAGACGTGTACATC"	"CNT"
"CATAGACTCCGCGAGT"	"EC-PTC"
"CATAGACTCTATCGTT"	"PT_1"
"CATCAAGGTCTCGGAC"	"CNT"
"CATCAAGTCATAGACC"	"POD"
"CATCAAGTCCGATGCG"	"DCT_1"
"CATCAAGTCTACAGGT"	"PT_1"
"CATCAAGTCTGGAGAG"	"EC-PTC"
"CATCCACCACCTCTGT"	"EC-PTC"
"CATCCACCAGACGGAT"	"DCT_1"
"CATCCACCAGTAGTGG"	"POD"
"CATCCACGTAACAGTA"	"DCT_1"
"CATCCACTCAAACGTC"	"DCT_1"
"CATCCACTCACAAGAA"	"DCT_1"
"CATCCACTCAGCTTGA"	"TAL"
"CATCCACTCGGCCCAA"	"EC-PTC"
"CATCCACTCTGTCTCG"	"PT_1"
"CATCCCACACACCAGC"	"CNT"
"CATCCCACATGTTTGG"	"EC-PTC"
"CATCCCAGTACCTGTA"	"iPT"
"CATCCCAGTATCTCTT"	"PT_1"
"CATCCGTAGTGATAAC"	"CNT"
"CATCCGTGTCTACAAC"	"CNT"
"CATCCGTGTGAGCGAT"	"DCT_1"
"CATCCGTGTGGATCGA"	"PT_2"
"CATCCGTGTTACGCCG"	"GC-EC"
"CATCCGTTCAGAACCT"	"DCT_1"
"CATCCGTTCTGGCCTT"	"PT_1"
"CATCGCTCAAAGGCTG"	"DCT_1"
"CATCGCTCACACCAGC"	"PT_2"
"CATCGCTCATCACCAA"	"EC-PTC"
"CATCGCTCATCTAACG"	"DCT_1"
"CATCGCTGTATCACGT"	"CNT"
"CATCGCTGTTCCGCAG"	"PT_1"
"CATCGCTGTTCTCACC"	"PT_2"
"CATCGCTTCCATCTAT"	"GC-EC"
"CATCGCTTCTGTCAGA"	"DCT_1"
"CATCGGGAGTTGCCTA"	"PT_1"
"CATCGGGCACAGAAGC"	"PT_1"
"CATCGGGCATAACGGG"	"PT_2"
"CATCGGGCATGGGATG"	"PT_2"
"CATCGGGGTCTCGCGA"	"CNT"
"CATCGGGGTTGCTCGG"	"DCT_1"
"CATCGGGTCCGGCAAC"	"PT_1"
"CATCGGGTCTGCTCTG"	"DCT_1"
"CATCGTCAGTGTAGTA"	"PT_1"
"CATCGTCCAAGTATCC"	"PT_1"
"CATCGTCGTCCACACG"	"IC-A1_1"
"CATCGTCGTCGTATGT"	"CNT"
"CATCGTCGTGAGATTA"	"PT_2"
"CATCGTCGTTCCAGGC"	"IC-A1_1"
"CATCGTCGTTCGGTTA"	"MC"
"CATGAGTAGTATAGGT"	"EC-PTC"
"CATGAGTCACACGGAA"	"PT_2"
"CATGAGTGTCTCTCTG"	"DCT_1"
"CATGAGTTCCCTCTTT"	"PT_2"
"CATGCAAAGTACAACA"	"PT_1"
"CATGCAACACGCGGTT"	"GC-EC"
"CATGCAAGTATACCTG"	"GC-EC"
"CATGCAAGTTCCGCAG"	"PT_1"
"CATGCAATCCTCTAAT"	"IC-A1_2"
"CATGCAATCCTTCACG"	"CNT"
"CATGCCTAGAGAGTGA"	"IC-A1_1"
"CATGCCTAGAGTTGTA"	"PT_1"
"CATGCCTAGTTTGGCT"	"GC-EC"
"CATGCCTGTTGCATCA"	"CNT"
"CATGCCTTCAAGAGTA"	"PT_1"
"CATGCCTTCGGTCGGT"	"DCT_1"
"CATGCGGAGCCAAGTG"	"DCT_1"
"CATGCGGAGCGGCTCT"	"PT_2"
"CATGCGGCACATTCGA"	"EC-PTC"
"CATGCGGCAGCTCGGT"	"PT_2"
"CATGCGGCAGTGACCC"	"IC-A1_1"
"CATGCGGTCGCGCTGA"	"IC-A1_1"
"CATGCTCAGATGACCG"	"PT_1"
"CATGCTCGTAGATCCT"	"EC-PTC"
"CATGCTCGTAGATCGG"	"PT_1"
"CATGGATAGGTAATCA"	"CNT"
"CATGGATAGTGATCGG"	"CNT"
"CATGGATGTCGTTGGC"	"DCT_1"
"CATGGATGTCTTGAGT"	"EC-PTC"
"CATGGATGTGGGTCAA"	"TAL"
"CATGGATGTTCCGGTG"	"PT_2"
"CATGGATTCCGATTAG"	"PT_1"
"CATGGATTCTCTGAGA"	"T-cell"
"CATGGTAAGCTTTCCC"	"IC-A1_1"
"CATGGTACAACGCATT"	"DCT_1"
"CATGGTACAAGTACCT"	"PT_1"
"CATGGTACACCTGTCT"	"IC-A1_1"
"CATGGTAGTACAAACA"	"CNT"
"CATGGTAGTCCGGACT"	"DCT_1"
"CATGGTAGTGGTCTTA"	"PT_1"
"CATGGTATCATTGCCC"	"PT_2"
"CATTCATCAGCACCCA"	"EC-PTC"
"CATTCATGTCCAATCA"	"PT_1"
"CATTCATGTGATGGCA"	"IC-A1_1"
"CATTCATGTGTGTCGC"	"iPT"
"CATTCATGTTAAACCC"	"TAL"
"CATTCATGTTCATCTT"	"DCT_1"
"CATTCCGCAGTCGGAA"	"PT_1"
"CATTCCGGTATGGGAC"	"DCT_1"
"CATTCCGGTCACTTCC"	"DCT_1"
"CATTCCGGTTATTCCT"	"PT_1"
"CATTCCGTCTCATTTG"	"IC-A1_1"
"CATTCTACAACCTATG"	"EC-PTC"
"CATTCTACAAGCAGGT"	"iPT"
"CATTCTAGTCGAAACG"	"PT_2"
"CATTCTAGTGAGCAGT"	"DCT_1"
"CATTCTAGTGCCCAGT"	"iPT"
"CATTCTATCTAGTCAG"	"PT_1"
"CATTGAGAGAAGCCTG"	"PT_1"
"CATTGAGAGAGAGTGA"	"IC-A1_1"
"CATTGAGAGTCATTGC"	"IC-A1_1"
"CATTGAGAGTTGTACC"	"PT_2"
"CATTGAGCAAGAATGT"	"DCT_1"
"CATTGAGCACCGCTGA"	"PT_2"
"CATTGAGCAGGATGAC"	"POD"
"CATTGAGGTATATGGA"	"PT_2"
"CATTGAGGTCGTACTA"	"PT_1"
"CATTGAGGTTCTCGCT"	"DCT_1"
"CATTGAGGTTGGGCCT"	"DCT_1"
"CATTGAGGTTTAGTCG"	"GC-EC"
"CATTGAGTCAAGATAG"	"iPT"
"CATTGAGTCATCACTT"	"PT_2"
"CATTGAGTCTAGAACC"	"TAL"
"CATTGAGTCTCGCAGG"	"CNT"
"CATTGCCAGAATCTAG"	"DCT_1"
"CATTGCCAGATAGTGT"	"PT_2"
"CATTGCCAGCGTTCCG"	"PT_2"
"CATTGCCAGGAGGCAG"	"CNT"
"CATTGCCCAATAGTCC"	"PT_1"
"CATTGCCCAATCGCAT"	"IC-A1_1"
"CATTGCCCAGCCCACA"	"IC-A1_1"
"CATTGCCGTAGTGTGG"	"CNT"
"CATTGCCTCGTGAGAG"	"TAL"
"CATTGTTAGACTGAGC"	"IC-A1_1"
"CATTGTTAGCTCCATA"	"PT_2"
"CATTGTTCAGTACTAC"	"PT_2"
"CATTGTTGTCTGTAGT"	"PT_1"
"CATTGTTTCTATTCGT"	"CNT"
"CATTTCAAGACAACTA"	"DCT_1"
"CATTTCAAGCGGGTTA"	"PT_1"
"CATTTCACAAACACCT"	"PT_2"
"CATTTCACACCCTGAG"	"CNT"
"CATTTCACACGCAGTC"	"PT_2"
"CATTTCACAGGCTACC"	"CNT"
"CATTTCAGTTTACCAG"	"PT_1"
"CATTTCATCGCGTGCA"	"CNT"
"CATTTCATCTCGCCTA"	"EC-PTC"
"CCAAGCGAGATGTAGT"	"IC-A1_1"
"CCAAGCGCAAGAGTTA"	"PT_2"
"CCAAGCGCAGAGGTAC"	"CNT"
"CCAAGCGGTTCCAAAC"	"PT_1"
"CCAAGCGTCACCGGTG"	"PT_2"
"CCAAGCGTCGACATAC"	"PT_1"
"CCAAGCGTCGTAACTG"	"DCT_1"
"CCAATGAAGAATGTTG"	"DCT_2"
"CCAATGACACAGGATG"	"PT_2"
"CCAATGACACAGTATC"	"CNT"
"CCAATGACATACCGTA"	"PT_1"
"CCAATGACATGCTGCG"	"PT_1"
"CCAATGAGTAGGCTGA"	"IC-A1_1"
"CCAATGAGTCTTAGTG"	"CNT"
"CCAATGAGTGACAGCA"	"DCT_1"
"CCAATGAGTGGGACAT"	"TAL"
"CCAATGAGTTAGGCCC"	"PT_2"
"CCAATGATCACCCATC"	"IC-A1_1"
"CCAATGATCCGATTAG"	"DCT_1"
"CCAATGATCGCTTACC"	"IC-A1_1"
"CCAATTTAGACGGTCA"	"PT_1"
"CCAATTTAGCAGCGAT"	"PT_1"
"CCAATTTAGCGCTGCT"	"PT_2"
"CCAATTTCACTTGAAC"	"PT_1"
"CCAATTTGTTCTCCCA"	"PT_1"
"CCAATTTTCTACGGGC"	"PT_1"
"CCACAAAAGTAACGTA"	"EC-PTC"
"CCACAAACAAACTAGA"	"PT_2"
"CCACAAAGTAGACACG"	"PT_2"
"CCACACTAGGTGCTTT"	"PT_2"
"CCACACTAGTACCCTA"	"IC-A1_1"
"CCACACTCATGACGGA"	"PT_1"
"CCACACTGTTACACTG"	"IC-A1_1"
"CCACACTGTTCGGCCA"	"IC-A1_1"
"CCACCATAGATGCAGC"	"PT_2"
"CCACCATAGCTTCGTA"	"CNT"
"CCACCATCAGAACATA"	"T-cell"
"CCACCATCATCTGGGC"	"CNT"
"CCACCATTCATAGACC"	"PT_1"
"CCACGAGCAAGGCAAC"	"iPT"
"CCACGAGTCGCTGATA"	"DCT_1"
"CCACGAGTCGTCCATC"	"PT_2"
"CCACGTTCACCAAAGG"	"IC-A1_1"
"CCACGTTCACCCTGAG"	"DCT_1"
"CCACGTTCACGTACTA"	"PT_1"
"CCACGTTGTGCGAACA"	"TAL"
"CCACTTGAGAGGCGTT"	"T-cell"
"CCACTTGCACCTATCC"	"iPT"
"CCACTTGCACTCTCGT"	"CNT"
"CCACTTGCAGGCACAA"	"DCT_1"
"CCACTTGCATAATCCG"	"CNT"
"CCACTTGGTATCCTCC"	"EC-PTC"
"CCACTTGGTATGGTTC"	"PT_2"
"CCATAAGTCCGCTTAC"	"POD"
"CCATAAGTCTTACGTT"	"PT_1"
"CCATCACAGGAGTATT"	"TAL"
"CCATCACGTGGGACAT"	"CNT"
"CCATCACTCACCCTGT"	"DCT_1"
"CCCAACTAGCATTGAA"	"iPT"
"CCCAACTAGCCGAACA"	"PT_2"
"CCCAACTGTAAGTCAA"	"PT_1"
"CCCAACTGTCACCACG"	"iPT"
"CCCAACTGTCAGGTGA"	"PT_2"
"CCCATTGAGCTTTGTG"	"DCT_1"
"CCCATTGCAGAGATTA"	"TAL"
"CCCATTGTCTTGGATG"	"GC-EC"
"CCCGAAGCATGCACTA"	"IC-A1_1"
"CCCGAAGCATGGCACC"	"PT_1"
"CCCGAAGGTTGTTTGG"	"CNT"
"CCCGAAGTCGCACGGT"	"TAL"
"CCCGGAAAGGCCATAG"	"TAL"
"CCCGGAAAGGGTAATT"	"iPT"
"CCCGGAAAGTGACCTT"	"EC-PTC"
"CCCGGAACAGGTCTCG"	"iPT"
"CCCGGAACATCATCTT"	"PT_1"
"CCCGGAACATGCAGCC"	"PT_2"
"CCCGGAAGTCTTCCGT"	"DCT_1"
"CCCGGAAGTTTCGATG"	"DCT_1"
"CCCGGAATCGCTATTT"	"PT_1"
"CCCGGAATCTCATTTG"	"DCT_1"
"CCCTAACAGGTTGCCC"	"DCT_1"
"CCCTAACCAAATCCCA"	"PT_1"
"CCCTAACCAACTCGAT"	"CNT"
"CCCTAACCAAGTATAG"	"T-cell"
"CCCTAACTCGTTCATT"	"IC-A1_1"
"CCCTAACTCTGTCGCT"	"PT_2"
"CCCTCAAAGACGCATG"	"PT_1"
"CCCTCAAAGTCTGGTT"	"PT_1"
"CCCTCAACACATGGTT"	"PT_2"
"CCCTCAACACCTGATA"	"DCT_1"
"CCCTCAACAGAGGCAT"	"POD"
"CCCTCTCCAGGCTTGC"	"PT_1"
"CCCTCTCGTTGCATCA"	"GC-EC"
"CCCTCTCGTTGGTACT"	"GC-EC"
"CCCTGATAGACCGCCT"	"IC-A1_1"
"CCCTGATAGACGGATC"	"PT_1"
"CCCTGATAGCAATTAG"	"TAL"
"CCCTGATCAGCTCATA"	"TAL"
"CCCTGATGTAAGGTCG"	"EC-PTC"
"CCCTGATGTCGACGCT"	"DCT_1"
"CCCTGATGTCTGTAGT"	"EC-PTC"
"CCCTGATTCTCATTGT"	"PT_1"
"CCCTTAGAGACTCAAA"	"DCT_1"
"CCCTTAGAGGTAGTCG"	"GC-EC"
"CCCTTAGAGTTATGGA"	"CNT"
"CCCTTAGCAATAACCC"	"PT_1"
"CCCTTAGGTAGACAGC"	"CNT"
"CCGAACGAGAGAGCAA"	"PT_1"
"CCGAACGCAAAGGCGT"	"POD"
"CCGAACGCAAATGGCG"	"iPT"
"CCGAACGGTAGTCCTA"	"PT_1"
"CCGAACGGTCTCACGG"	"CNT"
"CCGAACGGTGGCACTC"	"PT_2"
"CCGAACGTCTCCCAAC"	"PT_2"
"CCGAACGTCTGGTGGC"	"POD"
"CCGATCTAGCAACCAG"	"CNT"
"CCGATCTCATGAGGGT"	"TAL"
"CCGATCTGTATCGAAA"	"EC-PTC"
"CCGATCTGTCCAGCAC"	"DCT_1"
"CCGATCTGTGCCTTCT"	"DCT_1"
"CCGATCTTCAAGGAGC"	"DCT_1"
"CCGATCTTCATCACAG"	"PT_1"
"CCGATGGAGGTAAACT"	"PT_1"
"CCGATGGCAACCGCTG"	"PT_1"
"CCGATGGCAGCCTTCT"	"PT_1"
"CCGATGGGTAGGACCA"	"DCT_1"
"CCGATGGGTTGCCATA"	"IC-A1_2"
"CCGCAAGCAAACTAAG"	"PT_1"
"CCGCAAGCATGTTTGG"	"PT_2"
"CCGCAAGGTAGTATAG"	"CNT"
"CCGCAAGGTCTTGAAC"	"DCT_1"
"CCGCAAGGTGTCCCTT"	"CNT"
"CCGCAAGTCAAAGACA"	"EC-PTC"
"CCGCAAGTCGTTCCCA"	"GC-EC"
"CCGGACAAGCGTTGTT"	"DCT_1"
"CCGGACAAGTCTAGCT"	"PT_2"
"CCGGACACACTGGAAG"	"IC-A1_1"
"CCGGACAGTCGCATTA"	"T-cell"
"CCGGACATCCTTCTAA"	"CNT"
"CCGGGTACAATTTCGG"	"PT_1"
"CCGGGTACATGGGAAC"	"CNT"
"CCGGGTATCCACGTAA"	"PT_1"
"CCGGTAGAGAAATCCA"	"DCT_1"
"CCGGTAGAGACCCGCT"	"PT_2"
"CCGGTAGAGTACCGGA"	"CNT"
"CCGGTAGCAATGTCTG"	"POD"
"CCGGTAGCACAGTGAG"	"DCT_1"
"CCGGTAGCACTACAGT"	"PT_1"
"CCGGTAGGTGGTCTAT"	"GC-EC"
"CCGGTAGTCACTTCTA"	"PT_1"
"CCGGTGAAGCACTCGC"	"PT_1"
"CCGGTGAAGTCAAGCG"	"iPT"
"CCGGTGACAGCTACCG"	"EC-PTC"
"CCGGTGACAGGCCCTA"	"GC-EC"
"CCGGTGACATGAAGGC"	"PT_2"
"CCGGTGAGTCGAAGCA"	"PT_2"
"CCGGTGAGTGGGTCAA"	"CNT"
"CCGGTGATCCGAAGGA"	"IC-A1_2"
"CCGTAGGCAGACCAAG"	"CNT"
"CCGTAGGCATAGCTGT"	"IC-A1_1"
"CCGTAGGGTGAGAACC"	"PT_1"
"CCGTAGGGTTGTGGCC"	"CNT"
"CCGTAGGTCTCATAGG"	"PT_1"
"CCGTGAGAGACAACAT"	"PT_1"
"CCGTGAGAGCCTAGGA"	"DCT_1"
"CCGTGAGAGGCAGCTA"	"EC-PTC"
"CCGTGAGCAAGACGAC"	"DCT_1"
"CCGTGAGCAGGCTATT"	"PT_1"
"CCGTGAGCATCACAGT"	"CNT"
"CCGTGAGTCAGTCCGG"	"PT_2"
"CCGTGAGTCTCGAGTA"	"CNT"
"CCGTTCAGTCAAAGCG"	"MC"
"CCGTTCAGTCTAATCG"	"PT_1"
"CCGTTCAGTGATCGTT"	"CNT"
"CCGTTCATCCACGTCT"	"PT_1"
"CCGTTCATCGGCATTA"	"CNT"
"CCGTTCATCGGTCATA"	"DCT_1"
"CCTAACCAGGCTTAGG"	"POD"
"CCTAACCCAAAGGGCT"	"PT_1"
"CCTAACCCAATCCTAG"	"GC-EC"
"CCTAACCGTTACCTTT"	"GC-EC"
"CCTAACCGTTGCACGC"	"T-cell"
"CCTAACCTCTCCTGTG"	"TAL"
"CCTAAGAAGATACGAT"	"CNT"
"CCTAAGAAGCTGCGAA"	"GC-EC"
"CCTAAGACAAGCTACT"	"DCT_1"
"CCTAAGACACAACGAG"	"CNT"
"CCTAAGACACACTTAG"	"PT_1"
"CCTAAGAGTATCTCGA"	"PT_1"
"CCTAAGAGTCCTATAG"	"PT_1"
"CCTAAGATCATTGCTT"	"PT_1"
"CCTACGTAGGGAACAA"	"DCT_1"
"CCTACGTCAACTGTGT"	"TAL"
"CCTACGTCACGAAGAC"	"TAL"
"CCTACGTCAGGTAGTG"	"DCT_1"
"CCTACGTCATCGCTAA"	"DCT_1"
"CCTACGTTCTTCCTAA"	"PT_1"
"CCTATCGCACTTACAG"	"iPT"
"CCTATCGGTTTCGACA"	"PT_1"
"CCTATCGTCTCCAATT"	"iPT"
"CCTCAACCAACAGATA"	"EC-PTC"
"CCTCAACCAATTAGGA"	"EC-PTC"
"CCTCAACGTAGGCAGT"	"DCT_1"
"CCTCAACGTGAGGAAA"	"CNT"
"CCTCAACTCATTTGTC"	"PT_1"
"CCTCACAAGCGTCGAA"	"GC-EC"
"CCTCACACACCAGCCA"	"TAL"
"CCTCACACACTTCATT"	"PT_1"
"CCTCACAGTATGCGTT"	"IC-A1_1"
"CCTCACAGTGCTCTTC"	"TAL"
"CCTCAGTTCGATTCCC"	"GC-EC"
"CCTCATGAGAGGATCC"	"GC-EC"
"CCTCATGAGCCTTTCC"	"CNT"
"CCTCATGAGGTTGTTC"	"EC-PTC"
"CCTCATGTCAACCCGG"	"TAL"
"CCTCATGTCACATTGG"	"PT_1"
"CCTCCAAAGATTAGAC"	"CNT"
"CCTCCAAGTTGCTCGG"	"PT_1"
"CCTCCTCAGGGTGGGA"	"PT_1"
"CCTCCTCCAATCGAAA"	"PT_1"
"CCTCCTCCAGACCATT"	"DCT_1"
"CCTCCTCGTCTTGGTA"	"TAL"
"CCTCCTCGTGGAATGC"	"IC-A1_1"
"CCTCCTCGTGTGACCC"	"PT_1"
"CCTCCTCTCCGGTAGC"	"PT_1"
"CCTCTAGAGATGAATC"	"PT_1"
"CCTCTAGAGGCGAACT"	"POD"
"CCTCTAGAGTCATCCA"	"DCT_1"
"CCTCTAGCAAGAGAGA"	"iPT"
"CCTCTAGCAATTGCCA"	"DCT_1"
"CCTCTAGTCACCTCGT"	"PT_1"
"CCTCTAGTCGAGTGGA"	"PT_2"
"CCTCTCCCACTCCGAG"	"GC-EC"
"CCTCTCCCAGGTGTTT"	"EC-PTC"
"CCTCTCCGTCTACATG"	"PT_1"
"CCTCTCCGTTCCACGG"	"PT_1"
"CCTCTCCTCGGATACT"	"PT_1"
"CCTCTCCTCGGTGTTA"	"IC-A1_1"
"CCTCTCCTCTGTGTGA"	"iPT"
"CCTCTCCTCTTCCGTG"	"PT_1"
"CCTGCATAGATGAAGG"	"DCT_1"
"CCTGCATAGGCGCTTC"	"EC-PTC"
"CCTGCATAGGTGCTGA"	"CNT"
"CCTGCATAGTCGCCAC"	"EC-PTC"
"CCTGCATCAATGGCAG"	"GC-EC"
"CCTGCATCACCATAAC"	"DCT_1"
"CCTGCATCATGAGAAT"	"PT_2"
"CCTGCATGTCTAGGCC"	"PT_1"
"CCTGCATTCACGGAGA"	"TAL"
"CCTGCATTCTCTTGCG"	"GC-EC"
"CCTGTTGAGGGTCAAC"	"IC-A1_1"
"CCTGTTGAGTCACGCC"	"iPT"
"CCTGTTGCAAGCGAAC"	"PT_2"
"CCTGTTGCAGGCAATG"	"PT_2"
"CCTGTTGGTGGACCTC"	"iPT"
"CCTGTTGGTGGCAACA"	"DCT_1"
"CCTGTTGTCCAAATGC"	"EC-PTC"
"CCTGTTGTCCTGGGAC"	"IC-A1_1"
"CCTGTTGTCGAGAATA"	"PT_1"
"CCTTCAGAGACCAAAT"	"PT_2"
"CCTTCAGAGCGGACAT"	"CNT"
"CCTTCAGCAGGGAATC"	"TAL"
"CCTTCAGCATCGGATT"	"TAL"
"CCTTGTGGTAGAATGT"	"EC-PTC"
"CCTTGTGGTCCACTCT"	"CNT"
"CCTTGTGGTCGGAACA"	"GC-EC"
"CCTTGTGGTCTTCAAG"	"PT_1"
"CCTTGTGGTTAGAAGT"	"PT_2"
"CCTTGTGTCTCGCTCA"	"CNT"
"CCTTTGGTCGGCGATC"	"EC-PTC"
"CGAAGGAAGAGAAGGT"	"DCT_1"
"CGAAGGAAGATTGCGG"	"GC-EC"
"CGAAGGACAGAGGTTG"	"EC-PTC"
"CGAAGGACATAGCACT"	"PT_2"
"CGAAGGAGTCAATCTG"	"CNT"
"CGAAGGAGTGTCTTGA"	"PT_2"
"CGAAGGATCGGCATCG"	"PEC"
"CGAAGGATCTCATAGG"	"DCT_1"
"CGAAGGATCTCTTGCG"	"iPT"
"CGAAGTTAGTCAGCCC"	"TAL"
"CGAAGTTCAGTCGGAA"	"TAL"
"CGAAGTTGTCGGTAAG"	"CNT"
"CGAAGTTTCTTCGATT"	"CNT"
"CGAATTGAGGGCCTCT"	"DCT_1"
"CGAATTGCAATTCGTG"	"TAL"
"CGAATTGCAGTCAACT"	"PT_1"
"CGAATTGGTAACGTTC"	"PT_2"
"CGAATTGGTGGGCTTC"	"TAL"
"CGAATTGTCCGTCCTA"	"TAL"
"CGACAGCAGAGTTGTA"	"PT_1"
"CGACAGCAGCTCGAAG"	"DCT_1"
"CGACAGCAGTGAGCCA"	"PT_2"
"CGACAGCAGTTCTACG"	"EC-PTC"
"CGACAGCCATGTGTCA"	"IC-A1_1"
"CGACAGCCATTCAGGT"	"PT_1"
"CGACAGCGTATTGCCA"	"EC-PTC"
"CGACAGCGTGCAACAG"	"IC-A1_1"
"CGACAGCGTTAGTCGT"	"DCT_1"
"CGACAGCTCTGGCTGG"	"PT_2"
"CGAGAAGAGACCGTTT"	"PT_1"
"CGAGAAGAGCTCGGCT"	"PT_1"
"CGAGAAGCACAACGTT"	"GC-EC"
"CGAGAAGGTAGCTTTG"	"CNT"
"CGAGAAGGTATGCTAC"	"TAL"
"CGAGAAGGTCCGAAGA"	"GC-EC"
"CGAGAAGGTTCTCCCA"	"DCT_1"
"CGAGAAGTCACTGCTC"	"PT_1"
"CGAGAAGTCAGTGGGA"	"PT_2"
"CGAGAAGTCATCACCC"	"MC"
"CGAGAAGTCATCGGGC"	"PT_2"
"CGAGGAAAGATCCGAG"	"iPT"
"CGAGGAAAGCACTCAT"	"TAL"
"CGAGGAAGTCTCAGAT"	"CNT"
"CGAGGAATCGAGATAA"	"DCT_1"
"CGAGGCTAGCTAGTTC"	"PT_1"
"CGAGGCTCAAAGAGTT"	"PT_1"
"CGAGGCTCAATTAGGA"	"CNT"
"CGAGGCTTCGTCCTTG"	"PT_1"
"CGAGGCTTCGTCTCAC"	"IC-A1_1"
"CGAGGCTTCGTGGCGT"	"GC-EC"
"CGAGGCTTCTAGTTCT"	"PT_1"
"CGAGTGCCACTTCTCG"	"PT_1"
"CGAGTGCGTGCGGATA"	"DCT_1"
"CGAGTGCTCAAGAGTA"	"CNT"
"CGAGTGCTCCTGGGTG"	"IC-A1_1"
"CGAGTTAAGACAGTCG"	"CNT"
"CGAGTTAAGAGGATCC"	"CNT"
"CGAGTTAAGATAGCTA"	"T-cell"
"CGAGTTAAGGGTTAGC"	"PT_2"
"CGAGTTAAGTATAGGT"	"CNT"
"CGAGTTACAACGATCT"	"DCT_1"
"CGAGTTACAATGAAAC"	"iPT"
"CGAGTTACACACCAGC"	"DCT_1"
"CGAGTTACAGCTGCCA"	"EC-PTC"
"CGAGTTACAGGTGTTT"	"iPT"
"CGAGTTAGTAAGCTCT"	"TAL"
"CGAGTTAGTATGCAAA"	"TAL"
"CGAGTTATCTACGGTA"	"CNT"
"CGATCGGCAGAAGCGT"	"DCT_1"
"CGATCGGGTAGCTTAC"	"PT_1"
"CGATCGGTCAAGGAGC"	"EC-PTC"
"CGATGCGAGCCAAGCA"	"IC-A1_1"
"CGATGCGAGCTGAGTG"	"TAL"
"CGATGCGAGGTTCATC"	"IC-A1_1"
"CGATGGCAGATGTAGT"	"PT_2"
"CGATGGCAGCTCCACG"	"GC-EC"
"CGATGGCAGCTCTGTA"	"PT_2"
"CGCAGGTAGTATTCCG"	"PT_1"
"CGCAGGTCAGACAAGC"	"IC-A1_1"
"CGCAGGTGTATCAGGG"	"PT_1"
"CGCAGGTGTGAGTAAT"	"CNT"
"CGCAGGTTCGCCTATC"	"PT_1"
"CGCATAACATCCGTGG"	"GC-EC"
"CGCATAATCCGACGGT"	"iPT"
"CGCATGGAGTACCGGA"	"PT_2"
"CGCATGGAGTAGACAT"	"PT_2"
"CGCATGGCAATACGCT"	"PT_1"
"CGCATGGCAGTGCCTG"	"TAL"
"CGCATGGCATGACTGT"	"PT_1"
"CGCCAGAAGAGCTGAC"	"EC-PTC"
"CGCCAGACAGACAAGC"	"PT_2"
"CGCCAGAGTGGTTTAC"	"TAL"
"CGCCAGATCACATCAG"	"TAL"
"CGCCATTAGAATAGTC"	"CNT"
"CGCCATTAGTTCTCTT"	"EC-PTC"
"CGCCATTCATAGATGA"	"iPT"
"CGCCATTGTTAAGGAT"	"EC-PTC"
"CGCGTGAAGACGCATG"	"DCT_1"
"CGCGTGAAGCGCTGAA"	"PT_1"
"CGCGTGAAGCGGGTAT"	"IC-A1_1"
"CGCGTGACAACACGTT"	"PT_1"
"CGCGTGACACCTCTGT"	"EC-PTC"
"CGCGTGAGTCCACTTC"	"TAL"
"CGCGTGAGTTATAGCC"	"IC-A1_1"
"CGCGTGATCACGAACT"	"TAL"
"CGCGTGATCATTTCGT"	"IC-A1_1"
"CGCGTGATCCCAGCGA"	"GC-EC"
"CGCGTGATCCGTGTGG"	"IC-A1_1"
"CGCGTGATCTGTTCAT"	"PT_1"
"CGGAACCAGAAGTCTA"	"PT_1"
"CGGAACCAGCGTCTGC"	"PT_1"
"CGGAACCAGGGAGATA"	"PT_2"
"CGGAACCAGTATGCAA"	"PT_1"
"CGGAACCAGTGGACGT"	"CNT"
"CGGAACCCACCAGCGT"	"PT_2"
"CGGAACCCACCTGCGA"	"IC-A1_1"
"CGGAACCGTCCCTCAT"	"EC-PTC"
"CGGAACCGTCCTCAGG"	"CNT"
"CGGAACCGTGCATTAC"	"IC-A1_2"
"CGGAACCTCATTGCCC"	"IC-A1_1"
"CGGAATTAGAAGTCCG"	"CNT"
"CGGAATTCACTTTATC"	"PT_1"
"CGGAATTCAGTTTCGA"	"PT_1"
"CGGAATTGTACAAGTA"	"TAL"
"CGGAATTGTTGGACCC"	"PT_2"
"CGGAATTTCATTGCGA"	"PT_1"
"CGGAATTTCGCACGAC"	"PT_2"
"CGGAATTTCGCTAATG"	"PT_2"
"CGGAATTTCTGCTTAT"	"DCT_1"
"CGGACACAGAGGGTAA"	"IC-A1_1"
"CGGACACAGCAACAAT"	"PT_1"
"CGGACACCACGGTAGA"	"DCT_1"
"CGGACACGTGTCATTG"	"CNT"
"CGGAGAAAGACACACG"	"PT_2"
"CGGAGAAAGCTTTCCC"	"PT_1"
"CGGAGAACAACTACGT"	"DCT_1"
"CGGAGAACACAGTCGC"	"PT_2"
"CGGAGAACACCAGTTA"	"PT_2"
"CGGAGAACATGGGTTT"	"PT_2"
"CGGAGAAGTACCGGAA"	"EC-PTC"
"CGGAGAATCAGCGTCG"	"TAL"
"CGGAGAATCATGAGGG"	"DCT_1"
"CGGAGAATCCTCACCA"	"TAL"
"CGGAGAATCTAGTGTG"	"PT_2"
"CGGAGAATCTATACGG"	"PT_1"
"CGGAGAATCTCTTAAC"	"PT_1"
"CGGCAGTCAAACTGCT"	"MC"
"CGGCAGTCAATGGCCC"	"GC-EC"
"CGGCAGTCACAAGGTG"	"CNT"
"CGGCAGTGTAAGACCG"	"DCT_1"
"CGGCAGTGTCAACACT"	"DCT_1"
"CGGCAGTGTTCTCCCA"	"iPT"
"CGGCAGTGTTGTTTGG"	"PT_2"
"CGGGACTAGAGAGCAA"	"TAL"
"CGGGACTAGTATGTAG"	"EC-PTC"
"CGGGACTAGTCATGCT"	"iPT"
"CGGGACTAGTCCCAGC"	"PT_2"
"CGGGACTGTATTCCTT"	"GC-EC"
"CGGGACTGTTAAGAAC"	"DCT_1"
"CGGGACTGTTTAGTCG"	"PT_1"
"CGGGCATAGGCAGCTA"	"EC-PTC"
"CGGGCATCAAGCTGTT"	"CNT"
"CGGGCATGTAAGTAGT"	"DCT_1"
"CGGGCATTCGGTTCAA"	"CNT"
"CGGGTCACACACTTAG"	"PT_2"
"CGGGTCAGTCGGTGTC"	"DCT_1"
"CGGGTGTAGGTATTGA"	"PT_2"
"CGGGTGTAGGTTCTTG"	"PT_2"
"CGGGTGTAGTTACGGG"	"CNT"
"CGGGTGTCAACCGATT"	"DCT_1"
"CGGGTGTCACCGTGCA"	"PT_1"
"CGGGTGTGTCTTTCAT"	"DCT_1"
"CGGGTGTTCCCGTTCA"	"IC-A1_1"
"CGGTCAGAGAGCAGAA"	"CNT"
"CGGTCAGAGTCACTCA"	"IC-A1_1"
"CGGTCAGCACTACCGG"	"PT_2"
"CGGTCAGGTTAACCTG"	"TAL"
"CGGTCAGTCGTTACCC"	"PT_1"
"CGTAAGTCACAAATCC"	"PT_1"
"CGTAAGTCAGTAACCT"	"DCT_1"
"CGTAAGTGTGTCATGT"	"IC-A1_1"
"CGTAAGTGTTGCTCGG"	"PT_1"
"CGTAAGTTCATGTCAG"	"PT_2"
"CGTAAGTTCGTGGGAA"	"PT_1"
"CGTAAGTTCTCATGCC"	"PT_1"
"CGTAATGCACCCTAAA"	"DCT_2"
"CGTAATGCACCTGCTT"	"DCT_1"
"CGTAATGTCTGGCCTT"	"EC-PTC"
"CGTAATGTCTTCGCTG"	"PT_1"
"CGTAGTAAGACTACCT"	"EC-PTC"
"CGTAGTACAAGTAGTA"	"PT_1"
"CGTAGTAGTCGGCACT"	"POD"
"CGTAGTAGTCGGCCTA"	"TAL"
"CGTAGTATCGTGGCGT"	"PT_1"
"CGTAGTATCTTCGTGC"	"DCT_1"
"CGTCAAAAGGGATCGT"	"EC-PTC"
"CGTCAAACAAGGGTCA"	"EC-PTC"
"CGTCAAACAGAGAAAG"	"PT_2"
"CGTCAAACATACTGAC"	"PT_2"
"CGTCAAAGTGCAGTGA"	"DCT_1"
"CGTCAAAGTTGAGAGC"	"PT_2"
"CGTCAAATCTACTTCA"	"PT_1"
"CGTCCATCAGCTACCG"	"PT_1"
"CGTCCATTCCCACAGG"	"DCT_1"
"CGTGAATAGTGCACAG"	"PT_1"
"CGTGAATCACAAATCC"	"TAL"
"CGTGAATGTAACATCC"	"TAL"
"CGTGAATGTAGCTGCC"	"DCT_1"
"CGTGAATTCAAAGGAT"	"DCT_2"
"CGTGAATTCACGGTCG"	"PT_1"
"CGTGATAAGAGTGGCT"	"CNT"
"CGTGATAGTGTAAACA"	"PT_2"
"CGTGCTTCATAGGTAA"	"CNT"
"CGTGCTTGTACTCAAC"	"PT_2"
"CGTGCTTTCATCCTAT"	"DCT_1"
"CGTGCTTTCCTGTTGC"	"IC-A1_1"
"CGTGCTTTCTACAGGT"	"GC-EC"
"CGTGCTTTCTCTTAAC"	"PT_1"
"CGTGTCTAGGTCCCTG"	"PT_1"
"CGTGTCTCACCTGCTT"	"iPT"
"CGTGTCTCAGACACCC"	"DCT_1"
"CGTGTCTGTACCTAAC"	"PT_1"
"CGTGTCTGTGCATGAG"	"PT_2"
"CGTGTCTTCAGGAAGC"	"PT_2"
"CGTGTCTTCTCTCTTC"	"DCT_1"
"CGTTAGAAGATAGGGA"	"DCT_1"
"CGTTAGAAGTTGCTGT"	"PT_1"
"CGTTAGACAAACTGCT"	"TAL"
"CGTTAGACATACAGGG"	"PT_1"
"CGTTAGAGTATGGTAA"	"DCT_1"
"CGTTAGAGTGTTCCAA"	"DCT_1"
"CGTTAGATCCCTGTTG"	"DCT_1"
"CGTTAGATCGAAGCCC"	"GC-EC"
"CGTTAGATCGACCATA"	"PT_2"
"CGTTCTGAGGAGGCAG"	"DCT_1"
"CGTTCTGAGGTACCTT"	"GC-EC"
"CGTTCTGTCGACGCGT"	"IC-A1_2"
"CGTTCTGTCTCGGTCT"	"PT_1"
"CGTTCTGTCTCTTCAA"	"PT_1"
"CGTTGGGCACTGTGTA"	"PT_2"
"CGTTGGGCAGCGTTTA"	"CNT"
"CGTTGGGCAGGAGGTT"	"DCT_1"
"CGTTGGGTCGATTGGT"	"CNT"
"CGTTGGGTCGTAGGGA"	"PT_2"
"CTAACCCAGCGTTACT"	"PT_2"
"CTAACCCCAAGATCCT"	"PT_1"
"CTAACCCCATGACGTT"	"CNT"
"CTAACCCGTCCAGCCA"	"PT_1"
"CTAACCCGTCCTATAG"	"PT_1"
"CTAACCCTCTGCTTTA"	"PT_2"
"CTAACTTAGGGTCAAC"	"PT_1"
"CTAACTTCAAAGCAAT"	"EC-PTC"
"CTAACTTCAGTTGTCA"	"PT_1"
"CTAACTTCATACCGTA"	"TAL"
"CTAACTTGTGCTGTCG"	"PT_1"
"CTAACTTGTTTGTTCT"	"iPT"
"CTAACTTTCGGAACTT"	"TAL"
"CTAAGTGCAATCGCGC"	"PT_1"
"CTAAGTGCATTGAAGA"	"PT_2"
"CTAAGTGGTTCGATTG"	"iPT"
"CTAAGTGTCGCCTCTA"	"PT_1"
"CTACAGAAGCAACTCT"	"PT_2"
"CTACAGACACCCTCTA"	"GC-EC"
"CTACAGACATTGGATC"	"PT_1"
"CTACAGAGTCACTTAG"	"DCT_1"
"CTACAGATCATCGGGC"	"CNT"
"CTACAGATCCACTTTA"	"CNT"
"CTACATTAGGTAAGTT"	"DCT_1"
"CTACATTAGTAGGCCA"	"EC-PTC"
"CTACATTAGTATAACG"	"PT_1"
"CTACATTGTTGATGTC"	"TAL"
"CTACATTTCACTTATC"	"EC-PTC"
"CTACATTTCCGACATA"	"PT_1"
"CTACATTTCCTCTGCA"	"iPT"
"CTACATTTCTAACGGT"	"IC-A1_1"
"CTACCCACAGACAATA"	"PT_1"
"CTACCCACAGGTACGA"	"PT_1"
"CTACCCAGTATGGTAA"	"POD"
"CTACCCATCATCACAG"	"GC-EC"
"CTACCCATCCCAAGTA"	"PT_1"
"CTACCTGAGCTTAGTC"	"EC-PTC"
"CTACCTGCACGATAGG"	"PT_2"
"CTACCTGTCAGCCCAG"	"PT_1"
"CTACCTGTCATCCTAT"	"CNT"
"CTACCTGTCGCCTATC"	"DCT_1"
"CTACGGGAGTGGCGAT"	"DCT_1"
"CTACGGGAGTTCCAGT"	"PT_1"
"CTACGGGCAAAGGAGA"	"PT_2"
"CTACGGGCAGAGTCTT"	"CNT"
"CTACGGGCAGGATTCT"	"PT_1"
"CTACGGGGTACAAGCG"	"PT_1"
"CTACGGGGTAGTATAG"	"IC-A1_1"
"CTACGGGGTGTGAGCA"	"DCT_1"
"CTACGGGTCGCAGTCG"	"PT_1"
"CTACTATAGAACGTGC"	"IC-A1_2"
"CTACTATCAAGTGGCA"	"EC-PTC"
"CTACTATCAGGTACGA"	"PT_1"
"CTACTATGTATGAGGC"	"PT_1"
"CTACTATGTCCACAGC"	"PT_1"
"CTACTATGTGGACAGT"	"MC"
"CTACTATGTGGGACAT"	"IC-A1_1"
"CTACTATTCGACACTA"	"iPT"
"CTACTATTCGTTCCCA"	"EC-PTC"
"CTAGACAAGAGGTCAC"	"CNT"
"CTAGACAAGGAGTATT"	"PT_2"
"CTAGACAAGGCCCAAA"	"iPT"
"CTAGACAAGTGGAATT"	"CNT"
"CTAGACACACGCAAAG"	"DCT_1"
"CTAGACACAGTTCACA"	"PT_2"
"CTAGACAGTACGCTTA"	"IC-A1_1"
"CTAGACAGTCCTCAGG"	"POD"
"CTAGACAGTCGTGATT"	"PT_1"
"CTAGACAGTGTCTTGA"	"PT_2"
"CTAGACAGTTCTAACG"	"TAL"
"CTAGGTAGTCGCATTA"	"iPT"
"CTAGGTAGTTCAAACC"	"PT_1"
"CTATAGGAGGCACGAT"	"PT_2"
"CTATAGGCAAGGTCAG"	"DCT_1"
"CTATAGGCACACTTAG"	"DCT_1"
"CTATAGGGTAAGGCTG"	"DCT_1"
"CTATAGGGTCTGCGCA"	"DCT_1"
"CTATAGGTCTAGGCAT"	"PT_1"
"CTATAGGTCTGATGGT"	"PT_1"
"CTATCCGCAAGGGTCA"	"CNT"
"CTATCCGGTGCCGTTG"	"PT_2"
"CTATCCGTCTCGGCTT"	"iPT"
"CTATCTAAGATTTGCC"	"PT_2"
"CTATCTAAGCCGGAAT"	"PT_1"
"CTATCTACAAGCCATT"	"PT_1"
"CTATCTACAGCAGAAC"	"PT_1"
"CTATCTACAGGTAGTG"	"DCT_1"
"CTATCTACAGTAGGAC"	"TAL"
"CTATCTAGTACTCGCG"	"CNT"
"CTATCTAGTCACTGAT"	"EC-PTC"
"CTCAACCCAGTCGCTG"	"CNT"
"CTCAACCCAGTGTATC"	"MC"
"CTCAACCGTAACGGTG"	"DCT_2"
"CTCAACCGTGACGCCT"	"EC-PTC"
"CTCAACCGTGCTTCAA"	"IC-A1_1"
"CTCAACCTCACAGAGG"	"TAL"
"CTCAACCTCATTGCGA"	"EC-PTC"
"CTCAACCTCCTATTGT"	"POD"
"CTCAACCTCTAAGCGT"	"DCT_1"
"CTCAAGAAGGGTTTCT"	"PT_2"
"CTCAAGACAATTCACG"	"EC-PTC"
"CTCAAGACACAAAGCG"	"CNT"
"CTCAAGAGTTCTAACG"	"DCT_1"
"CTCAATTAGGCTTCCG"	"CNT"
"CTCAATTAGTGGCGAT"	"PT_2"
"CTCAATTCATCCTATT"	"IC-A1_1"
"CTCAATTGTATCGAGG"	"IC-A1_1"
"CTCAATTGTATGAAGT"	"TAL"
"CTCAATTGTATGAGCG"	"DCT_1"
"CTCAATTGTTCGTACA"	"DCT_1"
"CTCAATTTCTTCGACC"	"PT_1"
"CTCACTGAGCACCAGA"	"iPT"
"CTCACTGAGCGTCAGA"	"PT_1"
"CTCACTGAGGTTGGAC"	"PT_1"
"CTCACTGAGTTTGAGA"	"GC-EC"
"CTCACTGCACCCAAGC"	"EC-PTC"
"CTCACTGCAGGTGAGT"	"PT_1"
"CTCACTGCAGTGACCC"	"IC-A1_1"
"CTCACTGGTGAATTGA"	"EC-PTC"
"CTCACTGGTGTTGATC"	"IC-A1_1"
"CTCACTGTCGCCAGAC"	"CNT"
"CTCAGAAAGGTGCATG"	"POD"
"CTCAGAACAAATGGAT"	"PT_2"
"CTCAGAACATAGTCAC"	"GC-EC"
"CTCAGAACATGTGACT"	"GC-EC"
"CTCAGAAGTCCAGCCA"	"DCT_1"
"CTCAGAAGTGGATCAG"	"TAL"
"CTCAGAATCACATTGG"	"CNT"
"CTCAGAATCCACAGCG"	"EC-PTC"
"CTCAGGGAGCTTTCCC"	"PT_1"
"CTCAGGGAGTCATCCA"	"PT_2"
"CTCAGGGCATGAGATA"	"PT_1"
"CTCAGGGGTCCGGACT"	"PT_1"
"CTCAGGGTCCTGGGTG"	"IC-A1_1"
"CTCAGGGTCGTAACTG"	"DCT_1"
"CTCAGTCAGCCAAGCA"	"DCT_1"
"CTCAGTCCACCGGTCA"	"EC-PTC"
"CTCAGTCCAGCGCTTG"	"PT_1"
"CTCAGTCCATATTCGG"	"PT_1"
"CTCAGTCGTTGCTCAA"	"TAL"
"CTCAGTCTCAGTGTTG"	"PT_2"
"CTCAGTCTCTCCGAGG"	"EC-PTC"
"CTCAGTCTCTCGAGTA"	"DCT_1"
"CTCATCGAGATGTTGA"	"PT_1"
"CTCATCGAGTGCACTT"	"PT_1"
"CTCATCGCAAGTGGAC"	"PT_1"
"CTCATCGCACAGTCCG"	"PT_2"
"CTCATCGCACGGCGTT"	"GC-EC"
"CTCATCGCAGCATACT"	"DCT_1"
"CTCATCGCAGCTTTCC"	"IC-A1_1"
"CTCATCGGTCGTTATG"	"PT_1"
"CTCATCGGTGGGTCAA"	"PT_2"
"CTCATCGTCGCAGAGA"	"CNT"
"CTCATGCGTCAGTCCG"	"CNT"
"CTCATGCGTGATACCT"	"CNT"
"CTCATGCTCTTAATCC"	"CNT"
"CTCATTAAGGACTATA"	"PT_2"
"CTCATTAAGGCAGGGA"	"PT_1"
"CTCATTACAATCTAGC"	"CNT"
"CTCATTACAGCTGTAT"	"CNT"
"CTCATTAGTCGAATGG"	"PT_1"
"CTCATTATCCATTGTT"	"DCT_1"
"CTCATTATCGTGAGAG"	"DCT_1"
"CTCCAACAGCTCTGTA"	"EC-PTC"
"CTCCAACAGGACAGCT"	"PT_1"
"CTCCAACCAATAAGGT"	"GC-EC"
"CTCCAACGTATGAAGT"	"PT_1"
"CTCCAACGTCAAGCCC"	"PT_2"
"CTCCAACGTCACTACA"	"DCT_1"
"CTCCAACGTCCAGCCA"	"EC-PTC"
"CTCCAACTCCCAGGAC"	"TAL"
"CTCCAACTCGATAACC"	"iPT"
"CTCCAACTCGTGGAAG"	"EC-PTC"
"CTCCACAAGCTGGAGT"	"CNT"
"CTCCACACAGCTGTTA"	"EC-PTC"
"CTCCACACAGGTGAGT"	"PT_1"
"CTCCACAGTGAATAAC"	"GC-EC"
"CTCCACATCGTTCGCT"	"PT_1"
"CTCCACATCTCATTGT"	"TAL"
"CTCCATGAGAAATGGG"	"PT_2"
"CTCCATGAGTTCCGTA"	"GC-EC"
"CTCCATGCACGCTATA"	"EC-PTC"
"CTCCATGCAGCTGAAG"	"DCT_1"
"CTCCATGCATCTAGAC"	"PT_1"
"CTCCATGGTAACTAAG"	"CNT"
"CTCCATGTCACTTCTA"	"CNT"
"CTCCATGTCGGCTCTT"	"POD"
"CTCCCAAAGGTTGAGC"	"PT_1"
"CTCCCAATCACAGAGG"	"PT_2"
"CTCCCTCAGCACTGGA"	"PT_1"
"CTCCCTCAGCATAGGC"	"PT_1"
"CTCCCTCAGGTCACAG"	"POD"
"CTCCCTCCAAGAGGCT"	"PT_1"
"CTCCCTCCACAGTGAG"	"PT_1"
"CTCCCTCCACGGGTAA"	"IC-A1_1"
"CTCCCTCCAGATCACT"	"PT_2"
"CTCCCTCCATCCGTGG"	"DCT_1"
"CTCCCTCGTAAGTTGA"	"DCT_1"
"CTCCCTCTCAGACATC"	"CNT"
"CTCCCTCTCATCTGTT"	"CNT"
"CTCCCTCTCGAGTCCG"	"EC-PTC"
"CTCCCTCTCTGATTCT"	"PT_1"
"CTCCCTCTCTGGACTA"	"GC-EC"
"CTCCGATCAAACTCGT"	"GC-EC"
"CTCCGATCAACCAATC"	"TAL"
"CTCCGATCAGAGTTGG"	"iPT"
"CTCCGATGTAACAAGT"	"PEC"
"CTCCGATGTAGTCACT"	"PT_1"
"CTCCGATGTTGCGAAG"	"TAL"
"CTCCGATGTTTGCAGT"	"IC-A1_1"
"CTCCTCCAGAAGGCTC"	"CNT"
"CTCCTCCAGCGACAGT"	"DCT_2"
"CTCCTCCAGGGTCAAC"	"EC-PTC"
"CTCCTCCCAACTGTGT"	"DCT_1"
"CTCCTCCCAGGCCCTA"	"DCT_1"
"CTCCTCCCATACTGTG"	"PT_1"
"CTCCTCCCATGTGGTT"	"GC-EC"
"CTCCTCCGTCAAGCCC"	"CNT"
"CTCCTCCGTGTTGAGG"	"CNT"
"CTCCTTTAGCTGACCC"	"DCT_1"
"CTCCTTTAGGCCTTGC"	"CNT"
"CTCCTTTCAATGTTGC"	"DCT_1"
"CTCCTTTGTAACAAGT"	"IC-A1_2"
"CTCCTTTGTACCAGAG"	"PT_1"
"CTCCTTTGTCTTACTT"	"DCT_1"
"CTCCTTTGTTATCTTC"	"IC-A1_1"
"CTCCTTTTCCTCGCAT"	"DCT_1"
"CTCGAGGAGAGATGCC"	"DCT_1"
"CTCGAGGAGCGCCGTT"	"CNT"
"CTCGAGGAGCTTAAGA"	"TAL"
"CTCGAGGAGTAGCCAG"	"DCT_1"
"CTCGAGGCAAGTAGTA"	"PT_1"
"CTCGAGGGTACAAGTA"	"PT_2"
"CTCGAGGTCCGATAGT"	"PT_2"
"CTCGAGGTCTGACGCG"	"DCT_1"
"CTCTCAGAGTATAGGT"	"TAL"
"CTCTCAGAGTGGTTGG"	"DCT_2"
"CTCTCAGCAAGCCATT"	"DCT_1"
"CTCTCAGCACCGTCGA"	"DCT_1"
"CTCTCAGCATCGATCA"	"IC-A1_1"
"CTCTCAGGTTGCCTAA"	"EC-PTC"
"CTCTCAGTCAGCCTTC"	"TAL"
"CTCTCAGTCCAGCACG"	"DCT_1"
"CTCTCAGTCCATGATG"	"PT_2"
"CTCTCAGTCCCATGGG"	"PT_1"
"CTCTCAGTCTTTCCAA"	"PT_1"
"CTCTCGAAGATTAGTG"	"PT_2"
"CTCTCGAAGCCTCCAG"	"PT_1"
"CTCTCGACATCGCTCT"	"PT_1"
"CTCTGGTAGGACTATA"	"IC-A1_1"
"CTCTGGTAGGTGAGAA"	"CNT"
"CTCTGGTCACGAGGTA"	"POD"
"CTCTGGTCACTGATTG"	"PT_1"
"CTCTGGTCAGCGCTTG"	"PT_1"
"CTCTGGTGTCTAGGTT"	"CNT"
"CTCTGGTTCGGATACT"	"PT_2"
"CTGAATGAGCATGTTC"	"iPT"
"CTGAATGCAGGCATGA"	"CNT"
"CTGAATGGTAGAGTTA"	"TAL"
"CTGAATGGTCATCTAG"	"EC-PTC"
"CTGAATGGTGGGATTG"	"PT_2"
"CTGAGCGAGCTACGTT"	"PT_2"
"CTGAGCGCAGAAGCTG"	"TAL"
"CTGAGCGCAGGCCTGT"	"PT_2"
"CTGAGCGCATCAACCA"	"DCT_1"
"CTGAGCGGTTTCACAG"	"IC-A1_1"
"CTGAGGCAGAGTATAC"	"CNT"
"CTGAGGCAGTCCTGCG"	"PT_2"
"CTGAGGCCAAAGCAAT"	"CNT"
"CTGAGGCCATAGGTAA"	"PT_1"
"CTGAGGCGTTCTTGCC"	"TAL"
"CTGAGGCTCATACGAC"	"POD"
"CTGATCCAGCATGGGT"	"IC-A1_1"
"CTGATCCAGCGCCTCA"	"PT_2"
"CTGATCCCAAATACAG"	"PT_1"
"CTGATCCCAACTGTGT"	"EC-PTC"
"CTGATCCCAGAACGCA"	"DCT_1"
"CTGATCCCAGGAACCA"	"PT_2"
"CTGATCCCATACACCA"	"IC-A1_1"
"CTGATCCGTTCGTAAC"	"iPT"
"CTGATCCTCACTTGTT"	"DCT_1"
"CTGATCCTCCCAGGCA"	"IC-A1_2"
"CTGCAGGAGCTGACCC"	"PT_1"
"CTGCAGGGTACGGCAA"	"TAL"
"CTGCAGGGTCGAACGA"	"PT_1"
"CTGCAGGGTGTACATC"	"IC-A1_1"
"CTGCAGGTCACTCCGT"	"EC-PTC"
"CTGCAGGTCGATCCCT"	"DCT_1"
"CTGCATCCATAGGAGC"	"iPT"
"CTGCATCGTCATCCGG"	"PT_2"
"CTGCATCGTTTACCTT"	"GC-EC"
"CTGCATCTCCTGCCAT"	"CNT"
"CTGCATCTCGCCTTTG"	"PT_1"
"CTGCATCTCGTGGGTC"	"DCT_1"
"CTGCCATCATTGCTTT"	"EC-PTC"
"CTGCCATGTGAGGAAA"	"PT_1"
"CTGCCATGTTAAGGGC"	"DCT_1"
"CTGCCTACAATTCTTC"	"GC-EC"
"CTGCCTAGTATGCTTG"	"IC-A1_1"
"CTGCCTATCCACTTCG"	"PT_2"
"CTGCCTATCCCGTTGT"	"TAL"
"CTGCGAGAGCTCTATG"	"PT_1"
"CTGCGAGCACATAGCT"	"CNT"
"CTGCGAGGTAAGGCCA"	"IC-A1_1"
"CTGCGAGGTACGGTTT"	"PT_1"
"CTGCGAGGTGGATACG"	"CNT"
"CTGCGAGTCAGACCCG"	"CNT"
"CTGCGAGTCATCGCCT"	"DCT_1"
"CTGCTCATCGCACTCT"	"CNT"
"CTGGACGAGACCGCCT"	"GC-EC"
"CTGGACGCACTTGACA"	"PT_1"
"CTGGACGCAGGATGAC"	"GC-EC"
"CTGGACGCATCAGCAT"	"PT_1"
"CTGGACGTCAGACAAA"	"DCT_1"
"CTGGACGTCTGTAAGC"	"PT_2"
"CTGGCAGCAAATTAGG"	"PT_2"
"CTGGCAGCACAGCTGC"	"PT_1"
"CTGGCAGCACCTGATA"	"TAL"
"CTGGCAGCATGAATCC"	"PT_2"
"CTGGCAGGTGCGCTCA"	"PT_1"
"CTGGCAGTCGAACACT"	"PT_1"
"CTGGCAGTCTACCTTA"	"DCT_1"
"CTGGCAGTCTTAGGAC"	"TAL"
"CTGGTCTCACTTGGCG"	"PT_2"
"CTGGTCTCAGGGTCTC"	"iPT"
"CTGGTCTGTCCAGGTC"	"iPT"
"CTGGTCTTCCATTGGA"	"PT_1"
"CTGGTCTTCGGAGTAG"	"PT_2"
"CTGTACCAGAGGCGTT"	"TAL"
"CTGTACCAGGACAACC"	"iPT"
"CTGTACCCAATCCTTT"	"GC-EC"
"CTGTACCCAGCTCTGG"	"PT_1"
"CTGTACCGTCATCCCT"	"GC-EC"
"CTGTACCGTGAGCAGT"	"DCT_1"
"CTGTACCTCCTCACTG"	"TAL"
"CTGTACCTCTTCCGTG"	"PT_2"
"CTGTAGAAGCTGGCTC"	"IC-A1_2"
"CTGTAGACAAGTGATA"	"DCT_1"
"CTGTAGAGTATGCGGA"	"DCT_1"
"CTGTAGAGTTGCGGAA"	"PT_1"
"CTGTAGAGTTTGGAAA"	"DCT_1"
"CTGTATTAGGTGCTAG"	"PT_2"
"CTGTATTCAAGTCATC"	"EC-PTC"
"CTGTATTCACTTACAG"	"PT_2"
"CTGTATTCATCGAAGG"	"EC-PTC"
"CTGTATTGTCAGGTGA"	"PEC"
"CTGTATTGTGCGCTCA"	"EC-PTC"
"CTGTATTGTGGCGTAA"	"DCT_1"
"CTGTATTTCCCAGCGA"	"DCT_1"
"CTGTATTTCTCTGGTC"	"DCT_1"
"CTGTATTTCTGGACCG"	"PT_2"
"CTGTCGTAGCACCGTC"	"IC-A1_1"
"CTGTCGTAGCATAGGC"	"TAL"
"CTGTCGTCAACTTGCA"	"EC-PTC"
"CTGTCGTCAGTCAGTT"	"PT_2"
"CTGTCGTGTCGCGTTG"	"IC-A1_1"
"CTGTCGTTCATTGGTG"	"POD"
"CTGTCGTTCCAGCAAT"	"PT_1"
"CTGTCGTTCCCGTAAA"	"GC-EC"
"CTGTGAAAGCAGCGAT"	"iPT"
"CTGTGAACAGCACCCA"	"IC-A1_1"
"CTGTGAACATTCCTCG"	"CNT"
"CTGTGAATCGATTGGT"	"DCT_1"
"CTGTGGGAGTCAGAGC"	"PT_1"
"CTGTGGGCAGTGTACT"	"GC-EC"
"CTGTGGGCATGACAAA"	"PT_1"
"CTTACCGAGCAACAGC"	"PT_2"
"CTTACCGAGCAAGCCA"	"GC-EC"
"CTTACCGAGGACATCG"	"PT_1"
"CTTACCGCAACCCTCT"	"PT_1"
"CTTAGGAAGGTAGTCG"	"CNT"
"CTTAGGACACAGCTTA"	"PT_1"
"CTTAGGACAGTCGAGA"	"PT_2"
"CTTAGGAGTCAGGAGT"	"TAL"
"CTTAGGAGTCATAGTC"	"iPT"
"CTTAGGATCCTGCTAC"	"DCT_1"
"CTTAGGATCGCTAAAC"	"DCT_1"
"CTTCAATAGGAGAGGC"	"PT_1"
"CTTCAATAGTACCATC"	"IC-A1_2"
"CTTCAATAGTTGGCTT"	"PT_1"
"CTTCAATCACTCATAG"	"TAL"
"CTTCAATCATCCGGCA"	"DCT_1"
"CTTCAATTCTCTGAGA"	"CNT"
"CTTCCGAAGTCCCAAT"	"CNT"
"CTTCCGAAGTGAGGCT"	"EC-PTC"
"CTTCCGACAACCCTAA"	"PT_1"
"CTTCCGAGTGGCTCTG"	"DCT_1"
"CTTCCGATCAGTCAGT"	"PT_1"
"CTTCCTTAGGTCATCT"	"PT_2"
"CTTCCTTAGTATGCAA"	"CNT"
"CTTCCTTCACTGATTG"	"PT_2"
"CTTCCTTGTCGTTGGC"	"EC-PTC"
"CTTCCTTGTTGTTGCA"	"PT_2"
"CTTCCTTTCATAGCAC"	"PT_1"
"CTTCCTTTCTGAGAAA"	"CNT"
"CTTCGGTAGAAGTGTT"	"PT_1"
"CTTCGGTAGGCTGAAC"	"CNT"
"CTTCGGTCATGACTGT"	"EC-PTC"
"CTTCGGTGTTGGGTTT"	"TAL"
"CTTCGGTTCACCGCTT"	"PT_2"
"CTTCGGTTCCGCGATG"	"MC"
"CTTCGGTTCGAAATCC"	"CNT"
"CTTCTAAAGGCACCAA"	"DCT_1"
"CTTCTAACATAATCGC"	"PT_2"
"CTTCTAAGTATTCCGA"	"GC-EC"
"CTTCTAAGTCCCAAAT"	"PT_1"
"CTTCTAAGTCGTCTCT"	"CNT"
"CTTCTAAGTTCTATCT"	"DCT_1"
"CTTCTAATCCTACCGT"	"PT_2"
"CTTCTAATCTTAGCAG"	"TAL"
"CTTCTCTAGGTCCCTG"	"PT_1"
"CTTCTCTCATAGTCGT"	"PT_1"
"CTTCTCTCATCCGCGA"	"iPT"
"CTTCTCTCATTAAGCC"	"CNT"
"CTTCTCTGTCCTCAGG"	"PT_1"
"CTTCTCTTCAACGCTA"	"DCT_1"
"CTTCTCTTCACCTTGC"	"CNT"
"CTTCTCTTCGTAGTGT"	"GC-EC"
"CTTGAGACAAACGAGC"	"TAL"
"CTTGAGACACCGGTCA"	"DCT_1"
"CTTGAGAGTACAGGTG"	"CNT"
"CTTGAGAGTGATGGCA"	"PT_2"
"CTTGATTAGGCCCACT"	"CNT"
"CTTGATTCAAATGATG"	"EC-PTC"
"CTTGATTCACTGCATA"	"PT_2"
"CTTGATTGTAGTGTGG"	"iPT"
"CTTGATTGTTGTCTAG"	"CNT"
"CTTGATTTCCCAATAG"	"DCT_1"
"CTTTCAAAGGGTTGCA"	"PT_1"
"CTTTCAACACCCAAGC"	"PT_2"
"CTTTCAACAGGCGATA"	"CNT"
"CTTTCAACAGTGTATC"	"PT_1"
"CTTTCAAGTACTCGTA"	"PT_2"
"CTTTCAAGTTAGGAGC"	"DCT_1"
"CTTTCAATCCATGATG"	"TAL"
"CTTTCAATCGAGGCAA"	"DCT_1"
"CTTTCGGAGACTCCGC"	"PT_1"
"CTTTCGGAGTAGACCG"	"PT_2"
"CTTTCGGCACCTTCGT"	"PT_2"
"CTTTCGGCACGACTAT"	"T-cell"
"CTTTCGGTCCCTATTA"	"PT_2"
"GAAACCTAGAGCAGAA"	"PT_2"
"GAAACCTAGATAGGGA"	"PT_2"
"GAAACCTCATCGATGT"	"PT_2"
"GAAACCTCATTCATCT"	"DCT_2"
"GAAATGACACTCCTGT"	"IC-A1_1"
"GAAATGAGTAGTGTGG"	"PT_1"
"GAAATGAGTTAGCGGA"	"CNT"
"GAAATGAGTTCTCCTG"	"PT_2"
"GAAATGATCGACATCA"	"IC-A1_1"
"GAAATGATCTGAGATC"	"GC-EC"
"GAACACTAGTAGGAAG"	"PT_2"
"GAACACTCAATACCCA"	"PT_2"
"GAACACTTCCAAGCAT"	"PT_1"
"GAACACTTCCACGTGG"	"TAL"
"GAACGTTAGCTATCCA"	"PT_1"
"GAACGTTCAAGTATCC"	"GC-EC"
"GAACGTTCACGAGAAC"	"CNT"
"GAACGTTCATAGGTAA"	"DCT_1"
"GAACGTTGTGCAAGAC"	"PT_1"
"GAACGTTGTGGATTTC"	"PT_2"
"GAACGTTGTTGCGAAG"	"PT_2"
"GAACGTTTCCATAGAC"	"PT_1"
"GAACGTTTCCTCACTG"	"PT_2"
"GAACTGTAGACTCGAG"	"GC-EC"
"GAACTGTAGCGTGCCT"	"IC-A1_1"
"GAACTGTAGGTTCACT"	"PT_2"
"GAACTGTAGTCACGAG"	"PT_2"
"GAACTGTCAGGCTCTG"	"CNT"
"GAACTGTCAGGTCTCG"	"IC-A1_1"
"GAACTGTCATTGTCGA"	"IC-A1_1"
"GAACTGTTCAAGGTGG"	"PT_1"
"GAACTGTTCCGTGGTG"	"EC-PTC"
"GAAGAATAGGACAAGA"	"TAL"
"GAAGAATAGGTTGTTC"	"PT_2"
"GAAGAATCAGACGATG"	"CNT"
"GAAGAATCAGGGTCTC"	"IC-A1_1"
"GAAGAATTCACGGAGA"	"PT_2"
"GAAGAATTCCTAAGTG"	"PT_1"
"GAAGAATTCTCAGGCG"	"CNT"
"GAAGCCCAGACAGCTG"	"DCT_1"
"GAAGCCCCAAGATGGC"	"PT_1"
"GAAGCCCCAAGATTGA"	"PT_2"
"GAAGCCCGTGATGGCA"	"PT_1"
"GAAGCGAAGATTGACA"	"IC-A1_1"
"GAAGCGAAGGGCAGGA"	"GC-EC"
"GAAGCGACATATGGCT"	"EC-PTC"
"GAAGCGAGTGCCTTCT"	"DCT_1"
"GAAGCGAGTGCCTTTC"	"EC-PTC"
"GAAGCGATCCTCTCGA"	"DCT_1"
"GAAGCGATCGAACCTA"	"TAL"
"GAAGGACAGTTCATGC"	"PT_2"
"GAAGGACGTAATTAGG"	"PT_1"
"GAAGGACGTCAACACT"	"CNT"
"GAAGGACGTGCGTTTA"	"PT_2"
"GAAGGACGTTCTCCAC"	"EC-PTC"
"GAAGGACTCCTACGGG"	"PT_1"
"GAAGGGTAGCCATTTG"	"DCT_1"
"GAAGGGTCAACGTTAC"	"PT_2"
"GAAGGGTCACTGAATC"	"PT_1"
"GAAGGGTCATGGCTAT"	"PT_2"
"GAAGGGTGTATGCTTG"	"DCT_1"
"GAAGGGTTCAGTCTTT"	"CNT"
"GAAGGGTTCCAAAGGG"	"TAL"
"GAAGGGTTCGTTAGTG"	"PT_1"
"GAAGTAAGTCATTGCA"	"IC-A1_1"
"GAAGTAATCCGTAATG"	"IC-A1_1"
"GAAGTAATCGGACTTA"	"PT_1"
"GAATAGAAGATGAAGG"	"DCT_1"
"GAATAGAGTAGCGTAG"	"CNT"
"GAATAGAGTGGAGAAA"	"DCT_1"
"GAATAGATCGGTCTAA"	"PT_2"
"GAATAGATCTAGATCG"	"PT_1"
"GAATCACCATGTGTCA"	"PT_2"
"GAATCACGTGAGCGAT"	"PT_1"
"GAATCACTCAATCCGA"	"PT_1"
"GAATCACTCAGCTAGT"	"CNT"
"GAATCACTCTTCACGC"	"POD"
"GAATCGTCAGCTGTGC"	"PT_1"
"GAATCGTCATAATCCG"	"CNT"
"GAATCGTGTCTTACTT"	"PT_1"
"GAATCGTTCAAGCCTA"	"GC-EC"
"GAATCGTTCTGAGAGG"	"PT_2"
"GACACGCCACAACGAG"	"IC-A1_1"
"GACACGCCACTACGGC"	"DCT_1"
"GACACGCGTAATCAAG"	"iPT"
"GACACGCTCGAGCTGC"	"IC-A1_1"
"GACACGCTCTGGCCGA"	"CNT"
"GACAGCCAGAAACTCA"	"TAL"
"GACAGCCAGCAAATCA"	"CNT"
"GACAGCCCACAAGCCC"	"iPT"
"GACAGCCCACCACTGG"	"DCT_1"
"GACAGCCCACGAAGAC"	"CNT"
"GACAGCCTCCTCTAAT"	"TAL"
"GACAGCCTCGCGCTGA"	"CNT"
"GACAGCCTCGGCTATA"	"PT_1"
"GACAGCCTCTTTGCGC"	"DCT_1"
"GACATCAAGAAATTGC"	"PT_1"
"GACATCAAGTGTTGTC"	"PT_2"
"GACATCATCAACCTCC"	"CNT"
"GACATCATCCTGTTGC"	"DCT_1"
"GACCAATAGACGGATC"	"TAL"
"GACCAATAGCGGACAT"	"DCT_1"
"GACCAATCAACAAGAT"	"DCT_1"
"GACCAATCAGCACAGA"	"PT_1"
"GACCAATCATTGCCTC"	"PT_1"
"GACCAATGTCTCAAGT"	"CNT"
"GACCAATTCACCACAA"	"iPT"
"GACCAATTCCACTTCG"	"DCT_1"
"GACCAATTCTGTGCTC"	"iPT"
"GACCCAGAGCATGTTC"	"GC-EC"
"GACCCAGAGCGAATGC"	"CNT"
"GACCCAGCAGGTCCCA"	"DCT_1"
"GACCCAGCATCAGCTA"	"iPT"
"GACCCAGGTCCCGTGA"	"IC-A1_1"
"GACCCAGGTCCTACAA"	"DCT_1"
"GACCCAGGTCTTTCTA"	"CNT"
"GACCCAGTCATCTACT"	"DCT_1"
"GACCCTTAGCACACCC"	"PT_1"
"GACCCTTAGCCTCATA"	"PT_2"
"GACCCTTAGGTTGCCC"	"EC-PTC"
"GACCCTTCATACTGTG"	"CNT"
"GACCCTTTCCGACGGT"	"CNT"
"GACCCTTTCGTTCCCA"	"iPT"
"GACCGTGCAACCGGAA"	"DCT_1"
"GACCGTGCAGCTATAC"	"PT_1"
"GACCGTGGTAAGAACT"	"iPT"
"GACCGTGGTGAATTAG"	"TAL"
"GACCGTGGTGTGGACA"	"TAL"
"GACCGTGGTTCTCTAT"	"GC-EC"
"GACCGTGTCCATTTGT"	"CNT"
"GACCTTCAGTATGTAG"	"GC-EC"
"GACCTTCCAAGAGTTA"	"PT_2"
"GACCTTCGTAGGGAGG"	"TAL"
"GACGCTGAGGTCTGGA"	"DCT_1"
"GACGCTGCACCAGTAT"	"DCT_1"
"GACGCTGGTAATCAAG"	"PT_1"
"GACGCTGGTAGTCACT"	"CNT"
"GACGCTGTCGAAGCAG"	"PT_1"
"GACGCTGTCTGGCTGG"	"IC-A1_1"
"GACGTTAAGCAGGCAT"	"PT_1"
"GACGTTAAGCGCTGCT"	"DCT_2"
"GACGTTAGTTTGTTGG"	"PT_1"
"GACGTTATCATGCCCT"	"IC-A1_2"
"GACGTTATCCTAGCCT"	"DCT_1"
"GACTATGAGGTTCCAT"	"EC-PTC"
"GACTATGAGTTACGTC"	"CNT"
"GACTATGCACTTGGGC"	"EC-PTC"
"GACTATGCATGAGTAA"	"iPT"
"GACTATGCATTGAGCT"	"PT_2"
"GACTATGGTAGAAACT"	"CNT"
"GACTATGGTCCTACGG"	"IC-A1_1"
"GACTATGTCTCTTCAA"	"IC-A1_1"
"GACTATGTCTGCCTGT"	"PT_1"
"GACTCAAAGCTCGAAG"	"PT_1"
"GACTCAAGTGCCTTCT"	"DCT_1"
"GACTCAAGTTGCTAGT"	"CNT"
"GACTCAATCCGGCAGT"	"iPT"
"GACTCTCAGCATCAAA"	"PT_1"
"GACTCTCAGGGCAGGA"	"CNT"
"GACTCTCAGGTGATAT"	"DCT_1"
"GACTCTCAGTGGTCAG"	"PT_2"
"GACTCTCAGTGGTTGG"	"iPT"
"GACTCTCCATGCCGCA"	"DCT_1"
"GACTGATCAACGGCTC"	"DCT_2"
"GACTGATCATGCCGAC"	"CNT"
"GACTGATGTAAGCAAT"	"PT_1"
"GACTGATGTATCGCTA"	"PT_1"
"GACTGATGTGATACTC"	"PT_2"
"GACTGATTCAGACCTA"	"DCT_1"
"GACTGATTCCAAGCTA"	"DCT_1"
"GACTGATTCTTCCACG"	"PT_1"
"GACTTCCAGAGGTTAT"	"EC-PTC"
"GACTTCCCACCGTGCA"	"IC-A1_1"
"GACTTCCCATGAGATA"	"PT_1"
"GACTTCCGTACAATAG"	"PT_1"
"GACTTCCGTACCGTGC"	"CNT"
"GACTTCCGTGTCATTG"	"IC-A1_1"
"GACTTCCTCTGCCTGT"	"PT_1"
"GAGAAATAGCTCTATG"	"DCT_1"
"GAGAAATAGTAACCTC"	"PT_1"
"GAGAAATCACACCAGC"	"PT_2"
"GAGAAATGTAGCGATG"	"iPT"
"GAGAAATTCAGTGTGT"	"CNT"
"GAGACCCAGAGTCAGC"	"IC-A1_1"
"GAGACCCAGATCGGTG"	"DCT_1"
"GAGACCCAGCAGGGAG"	"IC-A1_2"
"GAGACCCCAATCCAGT"	"DCT_1"
"GAGACCCCACGGGCTT"	"PT_1"
"GAGACCCCACTCCACT"	"PT_2"
"GAGACCCCAGCGTACC"	"PT_1"
"GAGACCCCATGCAGCC"	"CNT"
"GAGACCCGTCAATCTG"	"PT_1"
"GAGACCCGTGAGCCAA"	"DCT_1"
"GAGACCCGTGGCAGAT"	"PT_2"
"GAGACCCTCCTACGAA"	"DCT_1"
"GAGACCCTCTTGTGCC"	"PT_1"
"GAGACTTAGCAGGCTA"	"DCT_1"
"GAGACTTAGGTCTACT"	"PT_1"
"GAGACTTCACGATAGG"	"DCT_1"
"GAGACTTGTTGCATTG"	"PT_1"
"GAGACTTTCGTCCATC"	"PT_2"
"GAGAGGTAGAATAGTC"	"IC-A1_1"
"GAGAGGTCACATTGTG"	"GC-EC"
"GAGAGGTGTGGCGTAA"	"PT_2"
"GAGAGGTGTGTGTACT"	"TAL"
"GAGAGGTTCCTACTGC"	"CNT"
"GAGATGGAGAAAGTCT"	"GC-EC"
"GAGATGGAGACAGTCG"	"DCT_1"
"GAGATGGAGCCTGACC"	"EC-PTC"
"GAGATGGCAAGGATGC"	"PT_2"
"GAGATGGCACATATCG"	"GC-EC"
"GAGATGGGTTGGCTAT"	"EC-PTC"
"GAGATGGTCCATAGAC"	"DCT_1"
"GAGCCTGAGTTACTCG"	"CNT"
"GAGCCTGCAACTCCCT"	"PT_1"
"GAGCCTGCAATGTGGG"	"iPT"
"GAGCCTGGTTTGTGGT"	"PT_1"
"GAGCCTGTCATTCTTG"	"DCT_1"
"GAGCCTGTCATTGGTG"	"PT_2"
"GAGCCTGTCTCCGTGT"	"PT_1"
"GAGCTGCCAACACAAA"	"PT_1"
"GAGCTGCCAAGTGGTG"	"PT_2"
"GAGCTGCTCTCGACGG"	"TAL"
"GAGGCAACAAGGCAAC"	"IC-A1_2"
"GAGGCAACAATCGAAA"	"IC-A1_1"
"GAGGCAAGTAATGATG"	"IC-A1_1"
"GAGGCAAGTAGTCTGT"	"PT_1"
"GAGGCAAGTCAGTCCG"	"PT_1"
"GAGGCAATCACCCTTG"	"iPT"
"GAGGCAATCTGCGGGT"	"CNT"
"GAGGCCTCAAGAGATT"	"PT_1"
"GAGGCCTCAGTTGCGC"	"PEC"
"GAGGCCTCATCAGCGC"	"IC-A1_1"
"GAGGCCTTCCCAAGCG"	"PT_1"
"GAGGCCTTCTCACGAA"	"GC-EC"
"GAGGCCTTCTCGTCGT"	"PT_1"
"GAGGGATCAACAGCTT"	"EC-PTC"
"GAGGGATCACCATTCC"	"IC-A1_1"
"GAGGGATCATATCTCT"	"CNT"
"GAGGGATGTACAGGTG"	"PT_1"
"GAGGGATGTGCCCAGT"	"CNT"
"GAGGGATGTGTCATTG"	"PT_1"
"GAGGGATGTTCGATTG"	"GC-EC"
"GAGGGTAAGGTTCAGG"	"CNT"
"GAGGGTACATCTGTTT"	"PT_1"
"GAGGGTATCGAAATCC"	"PT_2"
"GAGTCATCAAAGGCTG"	"PT_1"
"GAGTCATCAAATACAG"	"GC-EC"
"GAGTCATCAATCCAGT"	"PT_1"
"GAGTCATGTAACGGTG"	"EC-PTC"
"GAGTCATGTCAGACGA"	"CNT"
"GAGTCATGTGAGGAAA"	"iPT"
"GAGTCATGTGGTAATA"	"IC-A1_1"
"GAGTCATGTGTCTTGA"	"DCT_1"
"GAGTCATGTTAGGGTG"	"DCT_1"
"GAGTCATTCAAGCTTG"	"PT_2"
"GAGTCATTCGTAGGGA"	"PT_2"
"GAGTCATTCTAGGAAA"	"PT_2"
"GAGTCTAAGACGTCCC"	"DCT_1"
"GAGTCTAAGAGCTGCA"	"DCT_1"
"GAGTCTAAGCTGTGCC"	"POD"
"GAGTCTAAGGACAAGA"	"PT_2"
"GAGTCTACATTCTCTA"	"DCT_1"
"GAGTCTACATTGGCAT"	"PT_1"
"GAGTCTAGTCTCGACG"	"DCT_1"
"GAGTCTAGTGACTAAA"	"PT_2"
"GAGTGAGAGAGGTCGT"	"PT_1"
"GAGTGAGCACTCCGAG"	"DCT_1"
"GAGTGAGCAGTGTGCC"	"PT_2"
"GAGTGAGCATCACAGT"	"PT_2"
"GAGTGAGCATGACTCA"	"PT_2"
"GAGTGAGGTCTTCTAT"	"DCT_1"
"GAGTGAGTCACGACTA"	"PT_2"
"GAGTGAGTCGGCTATA"	"IC-A1_1"
"GAGTGTTAGGCCTAGA"	"PT_1"
"GAGTGTTCATCTCGTC"	"PT_1"
"GAGTGTTCATTGACTG"	"CNT"
"GAGTGTTGTACTCGCG"	"PT_1"
"GAGTGTTGTATCGTTG"	"PT_2"
"GAGTGTTGTCGCCTAG"	"DCT_1"
"GAGTGTTTCCCTTGTG"	"IC-A1_1"
"GAGTGTTTCGGCTTCT"	"PT_2"
"GAGTGTTTCGTTCATT"	"EC-PTC"
"GAGTTACCACGAAGAC"	"PT_1"
"GAGTTACCATATGCGT"	"IC-A1_2"
"GAGTTACCATCCGTTC"	"TAL"
"GAGTTACCATCGTGGC"	"PT_2"
"GAGTTACGTAACTGCT"	"PT_2"
"GAGTTACGTACTAACC"	"PT_1"
"GAGTTACGTTAAGAAC"	"DCT_1"
"GAGTTACTCAGCTTCC"	"PT_1"
"GAGTTACTCCGACATA"	"PT_1"
"GAGTTGTCACAAAGCG"	"PT_2"
"GAGTTGTCAGCTGTAT"	"CNT"
"GAGTTGTCATTCTTCA"	"iPT"
"GAGTTGTGTAGCTGCC"	"IC-A1_1"
"GAGTTGTGTCGTTTCC"	"PT_1"
"GAGTTGTTCTGGGAGA"	"EC-PTC"
"GAGTTGTTCTTGTGCC"	"GC-EC"
"GAGTTTGCACTACCGG"	"DCT_1"
"GAGTTTGGTCTGTTAG"	"PT_1"
"GAGTTTGTCAGCATTG"	"EC-PTC"
"GATAGAAAGCCTGAAG"	"DCT_2"
"GATAGAAAGCTCTGTA"	"PT_2"
"GATAGAACAAGTGATA"	"PT_1"
"GATAGAACAGGCTACC"	"TAL"
"GATAGCTAGACCATAA"	"MC"
"GATAGCTAGGTCACAG"	"PT_1"
"GATCACAAGCTATCCA"	"PT_2"
"GATCACAAGGCACAAC"	"iPT"
"GATCACAAGGTTGACG"	"DCT_1"
"GATCACACATAGGTAA"	"PT_1"
"GATCACATCGAGTACT"	"DCT_1"
"GATCACATCGATCCCT"	"PT_2"
"GATCAGTCAACGGCCT"	"DCT_1"
"GATCAGTCAAGTAGTA"	"DCT_1"
"GATCAGTCACGACGCT"	"EC-PTC"
"GATCAGTGTAGAGATT"	"TAL"
"GATCAGTGTCGTTCAA"	"PT_1"
"GATCAGTTCCTGTAGA"	"CNT"
"GATCATGAGAGATCGC"	"IC-A1_2"
"GATCATGGTCTCAAGT"	"PT_1"
"GATCATGGTGGAGGTT"	"PT_1"
"GATCATGTCGAGAGCA"	"DCT_1"
"GATCATGTCGCTACGG"	"PT_2"
"GATCATGTCGTTTACT"	"iPT"
"GATCATGTCTTCGGTC"	"PT_2"
"GATCCCTCAACCAACT"	"iPT"
"GATCCCTCAGACTGCC"	"PT_1"
"GATCCCTCAGCTGAAG"	"PT_1"
"GATCCCTGTCTTTCTA"	"PT_1"
"GATCCCTGTGGCGTAA"	"GC-EC"
"GATCCCTTCATTCACT"	"IC-A1_1"
"GATCCCTTCCATGAGT"	"EC-PTC"
"GATCCCTTCTTCACGC"	"PT_2"
"GATCGTAAGTCGGGAT"	"PT_1"
"GATCGTACACATAACC"	"IC-A1_1"
"GATCGTACAGTTGAAA"	"EC-PTC"
"GATCGTACATGCGTGC"	"PT_2"
"GATCGTAGTATGGTTC"	"CNT"
"GATCGTAGTGCGGCTT"	"DCT_1"
"GATCGTATCCCTCATG"	"PT_2"
"GATCGTATCCGTTTCG"	"IC-A1_1"
"GATGACTTCGACATCA"	"CNT"
"GATGAGGAGCTGGCCT"	"PT_2"
"GATGAGGCACTCCTGT"	"CNT"
"GATGAGGCAGACCGCT"	"PT_1"
"GATGAGGGTTCGGCTG"	"PT_1"
"GATGATCAGGGCTAAC"	"PT_1"
"GATGATCCAAGCCTGC"	"PT_1"
"GATGATCCATCCGGCA"	"CNT"
"GATGATCGTCGCTTGG"	"CNT"
"GATGATCTCCCATTCG"	"PT_1"
"GATGATCTCGAAGCCC"	"EC-PTC"
"GATGATCTCTCGACGG"	"iPT"
"GATGCTAAGCACTCTA"	"PT_1"
"GATGCTAAGCGAGGAG"	"CNT"
"GATGCTACACCAGTTA"	"PEC"
"GATGCTACACCGGTCA"	"PT_1"
"GATGCTACAGGTTCGC"	"PT_2"
"GATGCTAGTGTCCATA"	"IC-A1_1"
"GATGCTATCACAAGGG"	"GC-EC"
"GATGCTATCCATAGGT"	"EC-PTC"
"GATGCTATCTCCAATT"	"EC-PTC"
"GATGCTATCTCGTCGT"	"T-cell"
"GATGCTATCTTAATCC"	"CNT"
"GATGGAGAGTCCGCCA"	"CNT"
"GATGGAGAGTGGTTGG"	"DCT_1"
"GATGGAGCACGGTGAA"	"IC-A1_1"
"GATGGAGCACTACCGG"	"PT_1"
"GATGGAGGTGATACAA"	"DCT_1"
"GATGGAGTCACCTTAT"	"GC-EC"
"GATGGAGTCCAGCACG"	"TAL"
"GATGGAGTCGCTCTCA"	"GC-EC"
"GATGTTGAGCTCATAC"	"EC-PTC"
"GATGTTGTCACGGAGA"	"CNT"
"GATGTTGTCTTCGTGC"	"DCT_1"
"GATTCGAAGGCAGGGA"	"PT_1"
"GATTCGACACTTCTCG"	"IC-A1_1"
"GATTCGACAGCGTGCT"	"PT_2"
"GATTCGAGTCCACGCA"	"GC-EC"
"GATTCGAGTGGTTCTA"	"EC-PTC"
"GATTCGAGTTATCCAG"	"EC-PTC"
"GATTCGATCGCATTGA"	"TAL"
"GATTCTTAGCTAAATG"	"MC"
"GATTCTTAGCTTCTAG"	"CNT"
"GATTCTTCAAAGAACT"	"iPT"
"GATTCTTCAGCCGGTT"	"TAL"
"GATTCTTGTATCGTAC"	"PT_2"
"GATTCTTGTATGTCCA"	"PT_2"
"GATTCTTTCAACCTCC"	"iPT"
"GATTCTTTCCGTCAAA"	"CNT"
"GATTCTTTCCTTCACG"	"IC-A1_1"
"GATTGGTCACCTCAGG"	"DCT_1"
"GATTGGTCATGATGCT"	"PT_1"
"GATTGGTGTAACAAGT"	"PT_2"
"GATTGGTGTACTCCGG"	"CNT"
"GATTGGTTCCCTTCCC"	"iPT"
"GATTGGTTCCTGGGAC"	"IC-A1_1"
"GATTGGTTCTCGACGG"	"PT_1"
"GATTTCTAGATTAGCA"	"DCT_1"
"GATTTCTAGGGTTAGC"	"PT_1"
"GATTTCTCAACCAACT"	"IC-A1_1"
"GATTTCTCAAGTAGTA"	"PT_2"
"GATTTCTGTAACGCGA"	"IC-A1_1"
"GATTTCTTCTCTTAAC"	"TAL"
"GATTTCTTCTGCGTCT"	"DCT_1"
"GCAACATAGAATCCCT"	"PT_2"
"GCAACATAGGTTGCCC"	"PT_1"
"GCAACATAGTCTAGAA"	"PT_1"
"GCAACATCACGCAGTC"	"IC-A1_1"
"GCAACATCAGCGATTT"	"CNT"
"GCAACATCATAATGCC"	"DCT_1"
"GCAACATCATAGACTC"	"PT_1"
"GCAACATCATGAAGCG"	"DCT_1"
"GCAACATGTCCGATCG"	"GC-EC"
"GCAACATGTCTTTATC"	"iPT"
"GCAACATTCGGTCTGG"	"DCT_1"
"GCAACCGAGCACGTCC"	"TAL"
"GCAACCGAGGAGCAAA"	"PT_1"
"GCAACCGAGTTTCGGT"	"TAL"
"GCAACCGCAAAGGATT"	"iPT"
"GCAACCGCAGACCCGT"	"DCT_1"
"GCAACCGCATGGCTAT"	"IC-A1_1"
"GCAACCGGTAGGTTTC"	"DCT_1"
"GCAACCGTCAACGTGT"	"iPT"
"GCAACCGTCCACTTCG"	"DCT_1"
"GCACATAAGATAGGGA"	"PT_2"
"GCACATAAGCTAGTTC"	"EC-PTC"
"GCACATAAGGGCAGGA"	"EC-PTC"
"GCACATAGTGAGTAAT"	"PT_1"
"GCACATAGTTAGTTCG"	"iPT"
"GCACATAGTTGTACGT"	"CNT"
"GCACATATCCATCGTC"	"PT_2"
"GCACATATCGGTTCAA"	"PT_1"
"GCACGGTAGGGTTTCT"	"CNT"
"GCACGGTAGTTACGTC"	"DCT_1"
"GCACGGTAGTTGGGAC"	"DCT_1"
"GCACGGTGTCCAGTTA"	"DCT_1"
"GCACGGTTCATCACAG"	"CNT"
"GCACGGTTCATCTGTT"	"PT_2"
"GCACGGTTCTCTGCCA"	"IC-A1_1"
"GCACGTGAGCGGTATG"	"PT_2"
"GCACGTGAGTCATCCA"	"PT_1"
"GCACGTGCACTAGGTT"	"EC-PTC"
"GCACGTGCATGGGATG"	"GC-EC"
"GCACTAAAGGCAGGGA"	"IC-A1_1"
"GCACTAAAGGTTACAA"	"TAL"
"GCACTAAAGTGCCAGA"	"iPT"
"GCACTAACAAGATGGC"	"DCT_1"
"GCACTAACACAGAAGC"	"CNT"
"GCACTAATCACTCGAA"	"IC-A1_1"
"GCAGCCAAGTATGACA"	"DCT_1"
"GCAGCCACACCCTGAG"	"EC-PTC"
"GCAGCCACAGGACAGT"	"IC-A1_2"
"GCAGCCACATCCTAAG"	"DCT_1"
"GCAGCCAGTGTAGTGG"	"PT_2"
"GCAGCCATCCTTATGT"	"CNT"
"GCAGCTGGTCTCGGGT"	"PT_1"
"GCAGCTGTCCGGGACT"	"PT_1"
"GCAGGCTCATCCGAAT"	"IC-A1_1"
"GCAGGCTGTAAGATCA"	"PT_1"
"GCAGGCTTCCGCAACG"	"EC-PTC"
"GCAGTTAAGATAGCAT"	"IC-A1_1"
"GCAGTTAAGTGGACGT"	"CNT"
"GCAGTTAGTTGTTGAC"	"iPT"
"GCAGTTATCCTACCGT"	"DCT_1"
"GCATCGGAGACATGCG"	"T-cell"
"GCATCGGAGATGACAT"	"CNT"
"GCATCGGAGCGACTAG"	"DCT_1"
"GCATCGGAGTTCTACG"	"DCT_1"
"GCATCTCAGCTGTTCA"	"PT_1"
"GCATCTCCAAACGGCA"	"PT_1"
"GCATCTCCAACTGTGT"	"TAL"
"GCATCTCCAAGGGCAT"	"PT_1"
"GCATCTCGTTAGGACG"	"TAL"
"GCATGATAGAAGGGAT"	"PT_2"
"GCATGATAGACTAGAT"	"DCT_1"
"GCATGATAGCCAACCC"	"CNT"
"GCATGATAGCTGGCCT"	"IC-A1_1"
"GCATGATAGGCTTTCA"	"PT_2"
"GCATGATCAAGTGGGT"	"DCT_1"
"GCATGATGTGGTCTAT"	"PT_1"
"GCATTAGAGTAAGGGA"	"EC-PTC"
"GCATTAGCAGAACTAA"	"PT_2"
"GCATTAGGTCATCGCG"	"PT_1"
"GCATTAGGTCGGTGTC"	"MC"
"GCATTAGGTGAAAGTT"	"PT_1"
"GCCAACGAGCTTTGTG"	"DCT_1"
"GCCAACGGTCGGCACT"	"EC-PTC"
"GCCAACGTCTCCTGAC"	"iPT"
"GCCAGCAAGGTTTACC"	"TAL"
"GCCAGCAAGTGCTAGG"	"PT_2"
"GCCAGCACAATCGCGC"	"iPT"
"GCCAGCATCTACTCAT"	"PT_2"
"GCCAGGTAGGTAAAGG"	"TAL"
"GCCAGGTAGGTAGCCA"	"DCT_1"
"GCCAGGTAGTTATGGA"	"PT_1"
"GCCAGGTCAGAGTTGG"	"IC-A1_2"
"GCCAGGTCAGTCAACT"	"PT_2"
"GCCAGGTCATAATCGC"	"PT_1"
"GCCAGGTGTCTTGGTA"	"EC-PTC"
"GCCAGTGAGCACACCC"	"DCT_1"
"GCCAGTGAGTACCCTA"	"PT_1"
"GCCAGTGAGTCATGCT"	"TAL"
"GCCAGTGAGTGTGTTC"	"DCT_1"
"GCCAGTGCAGTCTGGC"	"TAL"
"GCCAGTGGTGTCTTAG"	"PT_2"
"GCCAGTGTCAGAGTTC"	"PT_2"
"GCCAGTGTCAGTCACA"	"DCT_1"
"GCCAGTGTCATTCTTG"	"PT_1"
"GCCATGGAGCGAATGC"	"iPT"
"GCCATGGCACAGTATC"	"TAL"
"GCCATGGGTAACGATA"	"IC-A1_1"
"GCCATGGGTATCGAAA"	"CNT"
"GCCATGGGTCACTCTC"	"PT_1"
"GCCATGGTCATGCTAG"	"GC-EC"
"GCCATGGTCTTAAGGC"	"EC-PTC"
"GCCATTCAGAATCCCT"	"CNT"
"GCCATTCCAACTGCCG"	"iPT"
"GCCATTCCACTCCGAG"	"PT_1"
"GCCATTCCATGTGCCG"	"DCT_1"
"GCCATTCGTAGTTCCA"	"GC-EC"
"GCCATTCGTCTCGCGA"	"CNT"
"GCCATTCGTGAGTAGC"	"PT_2"
"GCCATTCTCTGGGCAC"	"CNT"
"GCCCAGACAACCAATC"	"PT_1"
"GCCCAGACAACTACGT"	"IC-A1_1"
"GCCCAGAGTGGTATGG"	"CNT"
"GCCCAGAGTGTAGGAC"	"DCT_1"
"GCCCAGATCACTGGTA"	"PT_1"
"GCCCAGATCCCAGCGA"	"CNT"
"GCCCAGATCGCCGATG"	"PEC"
"GCCCAGATCGGCCTTT"	"TAL"
"GCCCGAAAGCTCCGAC"	"PT_2"
"GCCCGAACATTGTCGA"	"PT_2"
"GCCCGAAGTAATTGGA"	"DCT_1"
"GCCCGAAGTCGATTAC"	"DCT_1"
"GCCCGAAGTGCAACAG"	"TAL"
"GCCCGAAGTGCTGCAC"	"IC-A1_1"
"GCCCGAAGTTGGCTAT"	"PT_1"
"GCCCGAATCATGGATC"	"IC-A1_2"
"GCCCGAATCCATAGAC"	"iPT"
"GCCGATGGTACGGGAT"	"DCT_1"
"GCCGATGTCGATCCCT"	"DCT_1"
"GCCGATGTCGCTGTCT"	"PT_1"
"GCCGATGTCGCTTACC"	"PT_2"
"GCCGTGAAGGTCTACT"	"DCT_1"
"GCCGTGACATTGCAAC"	"PT_1"
"GCCGTGATCTATTTCG"	"CNT"
"GCCTGTTCACTGTGTA"	"PT_1"
"GCCTGTTCATCCAATG"	"IC-A1_1"
"GCCTGTTGTAACACGG"	"iPT"
"GCCTGTTTCACATCAG"	"PT_1"
"GCGAGAAAGGAGGCAG"	"PT_1"
"GCGAGAACAGCAGTAG"	"CNT"
"GCGAGAAGTCTACAAC"	"PT_2"
"GCGAGAAGTTAAGGAT"	"PT_2"
"GCGAGAATCACCATAG"	"iPT"
"GCGAGAATCGTTCCCA"	"CNT"
"GCGAGAATCGTTGTTT"	"IC-A1_1"
"GCGATCGAGGGTTAAT"	"GC-EC"
"GCGATCGCACATATGC"	"CNT"
"GCGATCGGTAAGTCAA"	"DCT_1"
"GCGATCGGTAAGTTAG"	"CNT"
"GCGATCGGTACAAGTA"	"DCT_1"
"GCGATCGTCCAAACCA"	"PT_1"
"GCGATCGTCCAAGAGG"	"EC-PTC"
"GCGATCGTCTATACTC"	"T-cell"
"GCGGAAAGTCGATTAC"	"PT_1"
"GCGGAAAGTTGAGAGC"	"POD"
"GCGGAAATCCTATGGA"	"CNT"
"GCGGAAATCCTTATAC"	"DCT_1"
"GCGGAAATCGTCAGAT"	"GC-EC"
"GCGGATCAGTTGCGAG"	"EC-PTC"
"GCGGATCGTCACCTTC"	"GC-EC"
"GCGGATCGTCTGCAAT"	"TAL"
"GCGGATCTCCATGAGT"	"IC-A1_2"
"GCGGATCTCTACGGGC"	"DCT_1"
"GCGGATCTCTGGGCAC"	"GC-EC"
"GCGTGCAAGTTAGAAC"	"EC-PTC"
"GCGTGCACAATCCAGT"	"PT_2"
"GCGTGCACACGCGCAT"	"EC-PTC"
"GCGTGCACACTACTTT"	"CNT"
"GCGTGCACACTGATTG"	"iPT"
"GCGTGCACATCAGCAT"	"PT_2"
"GCGTGCACATCGGCCA"	"IC-A1_1"
"GCGTGCAGTACTTGTG"	"PT_1"
"GCGTGCAGTATCGGTT"	"DCT_1"
"GCGTGCAGTCGCGTTG"	"CNT"
"GCGTGCAGTGTTGCCG"	"GC-EC"
"GCGTTTCAGGTAATCA"	"EC-PTC"
"GCGTTTCGTTTCGATG"	"DCT_1"
"GCGTTTCTCGTAGGAG"	"PT_2"
"GCTACAAAGAATAGTC"	"PT_2"
"GCTACAAAGTATAACG"	"PT_2"
"GCTACAAAGTGCGCTC"	"PT_1"
"GCTACAACAGAGGCTA"	"CNT"
"GCTACAAGTAGGGTAC"	"PT_1"
"GCTACAAGTCGAACGA"	"PT_1"
"GCTACAATCTTGCGCT"	"IC-A1_2"
"GCTACCTAGAACCCGA"	"IC-A1_1"
"GCTACCTAGCTTAAGA"	"IC-A1_1"
"GCTACCTCACCCTAAA"	"PT_1"
"GCTACCTCACGACGTC"	"GC-EC"
"GCTACCTGTCAAGGCA"	"PT_1"
"GCTACCTGTTACCGTA"	"PT_1"
"GCTCAAAAGACTTGTC"	"PT_1"
"GCTCAAAAGTGTAGAT"	"CNT"
"GCTCAAACATGGATCT"	"DCT_1"
"GCTCAAATCCCAAGTA"	"PT_2"
"GCTCAAATCGACACTA"	"TAL"
"GCTCAAATCGGAATTC"	"DCT_1"
"GCTGAATAGGTGAGAA"	"PT_1"
"GCTGAATCAGCATTGT"	"PT_1"
"GCTGAATGTCGTCTCT"	"DCT_1"
"GCTGAATTCAAATAGG"	"PT_1"
"GCTGAATTCGGATAAA"	"CNT"
"GCTGCAGAGAAACCAT"	"EC-PTC"
"GCTGCAGCACACCTGG"	"DCT_1"
"GCTGCAGGTCAGGTGA"	"EC-PTC"
"GCTGCAGGTGGGACAT"	"EC-PTC"
"GCTGCAGGTTGGAGGT"	"iPT"
"GCTGCAGTCCGCTTAC"	"PT_2"
"GCTGCAGTCGAGTCCG"	"EC-PTC"
"GCTGGGTAGACTCCGC"	"PT_1"
"GCTGGGTAGCGTTGTT"	"PT_2"
"GCTGGGTCATGACCCG"	"PT_1"
"GCTGGGTGTTGGGATG"	"CNT"
"GCTGGGTTCGAAGAAT"	"TAL"
"GCTTCACAGATCGGTG"	"PT_1"
"GCTTCACAGTAGTCAA"	"PT_1"
"GCTTCACCAGTGCCTG"	"PT_1"
"GCTTCACGTCCAGCCA"	"iPT"
"GCTTCACGTGTCCCTT"	"IC-A1_1"
"GCTTCACTCAGCGGAA"	"DCT_1"
"GCTTCACTCAGGAGAC"	"EC-PTC"
"GCTTCACTCGCGCTGA"	"DCT_1"
"GCTTGGGAGCACTCCG"	"DCT_1"
"GCTTGGGAGTATAACG"	"TAL"
"GCTTGGGAGTCCGTCG"	"PT_1"
"GCTTGGGCACAGTCAT"	"TAL"
"GCTTGGGGTAACATCC"	"CNT"
"GCTTGGGGTCAACCAT"	"DCT_1"
"GCTTGGGGTGCAACAG"	"PT_1"
"GCTTGGGTCACAAGAA"	"DCT_1"
"GCTTGGGTCAGCTGTA"	"EC-PTC"
"GCTTGGGTCGCTTACC"	"EC-PTC"
"GCTTGGGTCTCCCAAC"	"iPT"
"GCTTTCGAGAGATGCC"	"DCT_1"
"GCTTTCGAGAGCTGCA"	"CNT"
"GCTTTCGAGGTCCCGT"	"PT_2"
"GCTTTCGAGTGTGTTC"	"DCT_1"
"GCTTTCGCATCGATAC"	"PT_2"
"GCTTTCGGTACGTGTT"	"PT_1"
"GCTTTCGGTCAACCTA"	"DCT_1"
"GCTTTCGGTTTCGGCG"	"EC-PTC"
"GGAACCCCAGACCTAT"	"PT_2"
"GGAACCCCAGGCTCTG"	"CNT"
"GGAACCCCAGTCTTCC"	"GC-EC"
"GGAACCCTCACGAGGA"	"PT_1"
"GGAACCCTCAGACCTA"	"GC-EC"
"GGAAGTGAGAAACCCG"	"PT_1"
"GGAAGTGAGACGACTG"	"PT_1"
"GGAAGTGCAACGGGTA"	"DCT_1"
"GGAAGTGCACGAAAGC"	"PT_2"
"GGAAGTGGTAGCTAAA"	"PT_1"
"GGAAGTGTCGAAACAA"	"PT_1"
"GGAATCTAGATGATTG"	"PT_2"
"GGAATCTAGGAGTACC"	"PT_2"
"GGAATCTCACAGCTTA"	"PT_1"
"GGAATCTGTGAAAGTT"	"PT_2"
"GGAATCTGTTATAGAG"	"PT_2"
"GGAATCTGTTGCCTAA"	"IC-A1_1"
"GGAATCTTCAGCAGAG"	"PT_2"
"GGAATGGAGTCTGGAG"	"PT_1"
"GGAATGGCACGCGTCA"	"PT_2"
"GGAATGGCATCATTTC"	"EC-PTC"
"GGAATGGGTCTCGGGT"	"GC-EC"
"GGAATGGGTTTGATCG"	"DCT_1"
"GGACGTCGTAGTCCTA"	"CNT"
"GGACGTCGTTCTAAGC"	"GC-EC"
"GGACGTCGTTTGGAGG"	"iPT"
"GGACGTCTCTATCGCC"	"DCT_1"
"GGAGAACAGGCCTTGC"	"CNT"
"GGAGAACCAATAGTGA"	"PT_1"
"GGAGAACCACTGGATT"	"DCT_1"
"GGAGAACGTAGAGTTA"	"IC-A1_1"
"GGAGAACGTTAATCGC"	"DCT_2"
"GGAGAACTCCGTATGA"	"T-cell"
"GGAGAACTCTACCTTA"	"TAL"
"GGAGATGAGTAGGAAG"	"POD"
"GGAGATGAGTGAACAT"	"CNT"
"GGAGATGCAACCCTAA"	"DCT_1"
"GGAGATGCACCCTAGG"	"PT_2"
"GGAGATGCACCTCTAC"	"PT_1"
"GGAGATGCAGAGTCTT"	"PT_1"
"GGAGATGGTTCCCAAA"	"GC-EC"
"GGAGATGTCACCTACC"	"EC-PTC"
"GGAGATGTCCGGCAAC"	"EC-PTC"
"GGAGATGTCTCCAAGA"	"CNT"
"GGAGATGTCTCGGCTT"	"PT_1"
"GGAGCAAAGATGAATC"	"PT_1"
"GGAGCAAAGATTGACA"	"PT_2"
"GGAGCAAAGCAATTCC"	"EC-PTC"
"GGAGCAAGTCGTCATA"	"iPT"
"GGAGCAAGTGCTGTCG"	"EC-PTC"
"GGAGCAAGTGTCATCA"	"IC-A1_1"
"GGAGCAAGTTTGTTCT"	"PT_1"
"GGAGCAATCCTTTAGT"	"PT_1"
"GGAGGATCAAGGCAAC"	"PT_1"
"GGAGGATCAGGCGATA"	"PT_1"
"GGAGGATGTCAAGGCA"	"CNT"
"GGAGGATTCAGCAATC"	"iPT"
"GGAGGATTCAGGCGAA"	"MC"
"GGAGGATTCATTACTC"	"PT_1"
"GGAGGTAAGGAGGTTC"	"PT_1"
"GGAGGTACATGTTACG"	"CNT"
"GGAGGTATCCGAAATC"	"CNT"
"GGATCTAAGGCTTTCA"	"DCT_1"
"GGATCTAAGTAGCCAG"	"IC-A1_1"
"GGATCTACAAGTCCCG"	"DCT_1"
"GGATCTACACCGAATT"	"PT_1"
"GGATCTACAGCTAACT"	"CNT"
"GGATCTACATTCTCTA"	"PT_2"
"GGATCTAGTACGTACT"	"DCT_1"
"GGATCTATCATGAGAA"	"CNT"
"GGATCTATCATTCACT"	"IC-A1_1"
"GGATGTTAGTCGAAAT"	"IC-A1_1"
"GGATGTTCACACGTGC"	"PT_2"
"GGATGTTGTACCTATG"	"GC-EC"
"GGCACGTAGTCGGGAT"	"IC-A1_1"
"GGCACGTAGTGGACGT"	"PT_1"
"GGCACGTAGTGGCCTC"	"DCT_1"
"GGCACGTTCGTAGGAG"	"PT_1"
"GGCACGTTCTTGCAGA"	"IC-A1_2"
"GGCAGTCAGGCACTAG"	"IC-A1_1"
"GGCAGTCAGTCACTAC"	"IC-A1_1"
"GGCAGTCGTAAGATTG"	"PT_2"
"GGCAGTCGTAGGAGGG"	"TAL"
"GGCAGTCGTCAGTCTA"	"DCT_1"
"GGCAGTCTCACTCTTA"	"PT_1"
"GGCAGTCTCCAGCAAT"	"PT_2"
"GGCGTCAAGGTCGACA"	"PT_1"
"GGCGTCAAGTTGGACG"	"DCT_1"
"GGCGTCAGTTGCGAAG"	"PT_2"
"GGCGTCATCACAATGC"	"CNT"
"GGCTGTGAGATACCAA"	"CNT"
"GGCTGTGCAACGTTAC"	"TAL"
"GGCTGTGCACCTCAGG"	"iPT"
"GGCTGTGCAGAATTCC"	"PT_1"
"GGCTGTGCATAGATGA"	"iPT"
"GGCTGTGGTGATCATC"	"CNT"
"GGCTGTGGTTCAAACC"	"DCT_1"
"GGCTGTGGTTGTAAAG"	"TAL"
"GGCTTGGCACAGTGTT"	"PT_2"
"GGCTTGGCACGTACAT"	"POD"
"GGCTTGGCATCCGATA"	"PT_2"
"GGCTTGGCATCCGTTC"	"CNT"
"GGCTTGGGTACTGACT"	"PT_1"
"GGCTTGGGTCCTTTGC"	"PT_2"
"GGCTTGGGTGAGATTA"	"IC-A1_1"
"GGCTTGGTCCATCAGA"	"GC-EC"
"GGCTTGGTCGCCTCTA"	"POD"
"GGCTTGGTCTCTCAAT"	"CNT"
"GGCTTTCAGAACAGGA"	"TAL"
"GGCTTTCAGCGCCTAC"	"GC-EC"
"GGCTTTCAGCTGTCCG"	"PT_2"
"GGCTTTCAGTCACGAG"	"PT_1"
"GGCTTTCCAACCGTAT"	"DCT_1"
"GGCTTTCGTAAGGTCG"	"PT_2"
"GGCTTTCTCATGAGAA"	"IC-A1_1"
"GGCTTTCTCCTGTAAG"	"PT_1"
"GGCTTTCTCTCTCGCA"	"PT_1"
"GGGAAGTAGAGCGACT"	"CNT"
"GGGAAGTAGCCTTTGA"	"CNT"
"GGGAAGTAGCTGCGAA"	"PT_1"
"GGGAAGTAGGAGTATT"	"iPT"
"GGGAAGTAGGTTATAG"	"GC-EC"
"GGGAAGTAGTAAGCAT"	"DCT_1"
"GGGAAGTAGTGTAGAT"	"CNT"
"GGGAAGTCAAGAGTGC"	"CNT"
"GGGAAGTCAAGCGAGT"	"PT_2"
"GGGAAGTCAATAACCC"	"PT_2"
"GGGAAGTCATCTCCCA"	"PT_1"
"GGGAAGTGTCACGACC"	"CNT"
"GGGAAGTGTCTTACTT"	"CNT"
"GGGAAGTTCATGCAGT"	"PT_2"
"GGGAAGTTCGGAGATG"	"PT_1"
"GGGAAGTTCTCATGGA"	"PT_1"
"GGGACAAGTATACCTG"	"iPT"
"GGGACAAGTATCCTCC"	"DCT_1"
"GGGACAAGTCATAAAG"	"PT_2"
"GGGACAAGTGCGAGTA"	"PT_2"
"GGGACCTCAATAGGAT"	"DCT_1"
"GGGACCTCATCATCTT"	"CNT"
"GGGACCTCATGCACTA"	"IC-A1_2"
"GGGACCTCATGTGACT"	"GC-EC"
"GGGACCTGTACGGATG"	"GC-EC"
"GGGACCTGTAGACACG"	"PT_1"
"GGGACCTGTATAGGGC"	"PT_1"
"GGGACCTGTCACTCAA"	"IC-A1_1"
"GGGACCTGTGATGTAA"	"PT_1"
"GGGACTCCAAAGGCGT"	"IC-A1_1"
"GGGACTCCAGCGAACA"	"MC"
"GGGACTCGTACGACAG"	"PT_1"
"GGGACTCGTCATCGGC"	"GC-EC"
"GGGACTCTCAAGCTTG"	"PT_2"
"GGGAGATAGAGTCAGC"	"PT_1"
"GGGAGATAGATTGTGA"	"DCT_1"
"GGGAGATCACCTGCTT"	"PT_1"
"GGGAGATCACGCTGTG"	"CNT"
"GGGAGATCAGAGTTCT"	"DCT_1"
"GGGAGATCATCCGGTG"	"GC-EC"
"GGGAGATGTATATGGA"	"PT_1"
"GGGAGATGTATTTCGG"	"DCT_1"
"GGGAGATGTGATACCT"	"PT_1"
"GGGAGATGTGCACATT"	"PT_1"
"GGGAGATTCAGCATTG"	"iPT"
"GGGAGTAAGCAATAAC"	"PT_2"
"GGGAGTAAGTGACACG"	"PT_1"
"GGGAGTACAAGTGATA"	"PT_2"
"GGGAGTACACGACGCT"	"DCT_1"
"GGGAGTACATAACGGG"	"PT_1"
"GGGAGTACATCTAACG"	"CNT"
"GGGAGTAGTCCTGGTG"	"IC-A1_1"
"GGGAGTATCAAGCCTA"	"IC-A1_1"
"GGGAGTATCTGCTTAT"	"PT_2"
"GGGATCCCAAGTTGGG"	"PT_1"
"GGGATCCCAATCGCAT"	"GC-EC"
"GGGATCCCACGCTGTG"	"DCT_1"
"GGGATCCCAGTCAGCC"	"PT_1"
"GGGATCCCATTGTAGC"	"CNT"
"GGGATCCGTAACTGCT"	"PT_1"
"GGGATCCGTACGATCT"	"IC-A1_1"
"GGGATCCGTAGTTACC"	"PT_1"
"GGGATCCGTCAGACTT"	"iPT"
"GGGATCCGTGGTGATG"	"DCT_1"
"GGGATCCTCCTGTACC"	"PT_1"
"GGGATCCTCTAGCCAA"	"CNT"
"GGGATCCTCTCCAATT"	"PT_1"
"GGGATGAAGGTCTGGA"	"DCT_1"
"GGGATGAAGTGATGGC"	"PT_1"
"GGGATGACAGCCGTTG"	"IC-A1_1"
"GGGATGATCAAACTGC"	"PT_1"
"GGGATGATCAAGAGGC"	"iPT"
"GGGCCATAGAACCCGA"	"CNT"
"GGGCCATGTCCGATCG"	"PT_2"
"GGGCGTTAGGCGAAGG"	"PT_1"
"GGGCGTTAGGTCCCGT"	"CNT"
"GGGCGTTCACGACAAG"	"PT_2"
"GGGCGTTCAGCCCACA"	"TAL"
"GGGCGTTCAGGCACTC"	"PT_1"
"GGGCGTTGTCCGAAGA"	"PT_1"
"GGGCGTTGTCTACATG"	"PT_1"
"GGGCGTTGTGCATCTA"	"PT_2"
"GGGCGTTGTTACCCTC"	"iPT"
"GGGCGTTTCCTACCAC"	"TAL"
"GGGCGTTTCCTTATAC"	"EC-PTC"
"GGGCGTTTCTCGGGAC"	"IC-A1_1"
"GGGCTACAGAAAGTCT"	"DCT_2"
"GGGCTACAGCCTATTG"	"CNT"
"GGGCTACAGGATGGCT"	"PT_1"
"GGGCTACCAACTTCTT"	"TAL"
"GGGCTACCAGGTCAGA"	"PT_1"
"GGGCTACCATAACTCG"	"PT_1"
"GGGCTACCATGTTTGG"	"TAL"
"GGGCTACGTCTTGCTC"	"CNT"
"GGGCTCAAGAAGTCCG"	"DCT_1"
"GGGCTCAAGTCGTTAC"	"EC-PTC"
"GGGCTCAGTCGTCAGC"	"IC-A1_2"
"GGGCTCATCACAAGAA"	"PT_1"
"GGGTAGAAGGAAAGTG"	"PT_1"
"GGGTAGAAGGGATCTG"	"EC-PTC"
"GGGTAGAAGGTATTGA"	"CNT"
"GGGTAGACAACCACAT"	"GC-EC"
"GGGTAGACAGCGTATT"	"PT_2"
"GGGTAGAGTCCCTGTT"	"PT_1"
"GGGTATTAGGAGAGGC"	"PT_2"
"GGGTATTCAATAGTGA"	"PT_1"
"GGGTATTCAGTCCGTG"	"CNT"
"GGGTATTCATCGCTGG"	"iPT"
"GGGTATTGTCCAGCCA"	"GC-EC"
"GGGTATTTCCCTTTGG"	"PT_1"
"GGGTATTTCCTCATAT"	"PT_2"
"GGGTATTTCTGGTTGA"	"TAL"
"GGGTCACCAACACTAC"	"DCT_1"
"GGGTCACCACGTAGTT"	"CNT"
"GGGTCACCAGTAGTGG"	"GC-EC"
"GGGTCACGTATGACAA"	"PT_2"
"GGGTCACGTCGAGATG"	"PT_2"
"GGGTCACGTCTTGTCC"	"PT_1"
"GGGTCACGTTAGGGTG"	"PT_1"
"GGGTCACGTTCAATCG"	"PT_2"
"GGGTCTGAGTACTCGT"	"PT_1"
"GGGTCTGAGTGCGCTC"	"TAL"
"GGGTCTGCAGGTACGA"	"CNT"
"GGGTCTGGTACGGTTT"	"IC-A1_1"
"GGGTCTGGTGCATACT"	"PT_1"
"GGGTCTGGTTGTCATG"	"IC-A1_1"
"GGGTGAAAGACGCATG"	"EC-PTC"
"GGGTGAAAGATGAATC"	"CNT"
"GGGTGAAAGATTGGGC"	"PT_1"
"GGGTGAAGTACGAAAT"	"DCT_1"
"GGGTGAAGTATGAAAC"	"PT_1"
"GGGTGAAGTGCGGTAA"	"GC-EC"
"GGGTGAAGTGGGACAT"	"CNT"
"GGGTGAAGTTTGTTGG"	"DCT_1"
"GGGTGAATCGGCATTA"	"iPT"
"GGGTGAATCTTTGCTA"	"PT_1"
"GGGTTATAGGGATCGT"	"PT_1"
"GGGTTATAGTCCGCCA"	"PT_2"
"GGGTTATCAAATTGCC"	"PT_1"
"GGGTTATCACTTGGCG"	"CNT"
"GGGTTTAAGACGACTG"	"DCT_1"
"GGGTTTAAGCGACTTT"	"PT_1"
"GGGTTTAAGGAGTATT"	"DCT_1"
"GGGTTTAAGTGTTCAC"	"PT_1"
"GGGTTTACAATTGCGT"	"PT_2"
"GGGTTTACACATCATG"	"GC-EC"
"GGGTTTATCCTTCTGG"	"PT_1"
"GGTAACTAGAAATTGC"	"PT_1"
"GGTAACTAGTAGTCAA"	"iPT"
"GGTAACTAGTCCTGCG"	"GC-EC"
"GGTAACTCATAATCGC"	"PT_1"
"GGTAACTGTAGCTTAC"	"CNT"
"GGTAACTGTCCAACGC"	"iPT"
"GGTAACTGTCCACGCA"	"DCT_1"
"GGTAACTGTGGTATGG"	"DCT_1"
"GGTAACTGTTGGATCT"	"GC-EC"
"GGTAACTTCATTGGTG"	"PT_2"
"GGTAACTTCCACATAG"	"DCT_1"
"GGTAACTTCGCTTACC"	"iPT"
"GGTAACTTCGTCTCAC"	"GC-EC"
"GGTAATCCAAACCACT"	"DCT_1"
"GGTAATCCAATGCAAA"	"CNT"
"GGTAATCCAGGAAGTC"	"CNT"
"GGTAATCGTCTGTCAA"	"TAL"
"GGTAATCGTGGCCCAT"	"GC-EC"
"GGTAATCTCGGTAACT"	"PT_2"
"GGTAATCTCGTAATGC"	"IC-A1_1"
"GGTAATCTCTTGGGCG"	"PT_1"
"GGTAGAGAGATAACGT"	"DCT_1"
"GGTAGAGAGATGATTG"	"PT_1"
"GGTAGAGCATATGGCT"	"PT_1"
"GGTAGAGCATGCTGCG"	"PEC"
"GGTAGAGGTAGGAGGG"	"PT_1"
"GGTCACGAGAAATTGC"	"IC-A1_1"
"GGTCACGAGACGAAGA"	"CNT"
"GGTCACGAGCCTCGTG"	"DCT_1"
"GGTCACGAGCTTAGTC"	"PT_1"
"GGTCACGCACAAGGTG"	"PT_1"
"GGTCACGCAGAGGTTG"	"PT_1"
"GGTCACGCATCATCCC"	"TAL"
"GGTCACGGTCCACACG"	"POD"
"GGTCTGGAGGTGCATG"	"PT_1"
"GGTCTGGCAAATCCCA"	"CNT"
"GGTCTGGCAATCGCCG"	"DCT_1"
"GGTCTGGCATCCCGTT"	"CNT"
"GGTCTGGCATGACTAC"	"PT_1"
"GGTCTGGGTAATGTGA"	"PT_1"
"GGTCTGGGTGTGCTTA"	"CNT"
"GGTGAAGAGGATACCG"	"PT_1"
"GGTGAAGCAAGTATAG"	"EC-PTC"
"GGTGAAGCACTTTAGG"	"PT_1"
"GGTGAAGGTAGATTAG"	"PT_2"
"GGTGAAGGTGAAAGTT"	"PT_1"
"GGTGAAGGTTCGATTG"	"PT_1"
"GGTGAAGTCAGGAACG"	"GC-EC"
"GGTGAAGTCCAACACA"	"PT_1"
"GGTGAAGTCTTTGGAG"	"PT_1"
"GGTGATTAGTTGCGAG"	"PT_1"
"GGTGATTGTACTCGCG"	"PT_1"
"GGTGATTGTCGGTACC"	"PT_2"
"GGTGATTGTCTTGCGG"	"DCT_1"
"GGTGATTGTGAGATAT"	"PT_2"
"GGTGATTGTTCCACAA"	"DCT_1"
"GGTGATTTCATTGGTG"	"GC-EC"
"GGTGATTTCTTCTCAA"	"PT_2"
"GGTGGCTAGACATCAA"	"DCT_1"
"GGTGGCTAGATGGTCG"	"PT_2"
"GGTGGCTAGCAGCCCT"	"IC-A1_1"
"GGTGGCTCAGGCATTT"	"IC-A1_1"
"GGTGGCTCATGTGACT"	"iPT"
"GGTGGCTGTCAACACT"	"CNT"
"GGTGGCTGTGCACGCT"	"EC-PTC"
"GGTGGCTGTGTCTTAG"	"GC-EC"
"GGTGGCTGTTCCACAA"	"PT_1"
"GGTGGCTTCCTCTAAT"	"PT_2"
"GGTGTCGAGATTAGTG"	"PT_1"
"GGTGTCGGTAGTTAGA"	"TAL"
"GGTGTCGGTCTTGGTA"	"EC-PTC"
"GGTGTCGGTGGGTCAA"	"EC-PTC"
"GGTGTCGTCGCGCCAA"	"PT_2"
"GGTGTCGTCTCATTAC"	"PT_2"
"GGTGTTACAGTTGAAA"	"TAL"
"GGTGTTAGTGTATTCG"	"IC-A1_1"
"GGTGTTATCACTTTGT"	"PT_2"
"GGTGTTATCCAACCAA"	"TAL"
"GGTTAACAGAGGTTAT"	"PT_1"
"GGTTAACAGGAAACGA"	"PT_1"
"GGTTAACAGTCTAGCT"	"PT_1"
"GGTTAACAGTTTGGCT"	"PT_2"
"GGTTAACCAACAGTGG"	"PT_1"
"GGTTAACCAAGGGTCA"	"DCT_1"
"GGTTAACCATCCTCAC"	"DCT_2"
"GGTTAACCATTGAGCT"	"EC-PTC"
"GGTTAACTCCGCAAAT"	"CNT"
"GGTTAACTCGTCAAAC"	"iPT"
"GGTTCTCCAAGCCTGC"	"EC-PTC"
"GGTTCTCCATCCTTGC"	"IC-A1_1"
"GGTTCTCGTCCCAAAT"	"IC-A1_2"
"GGTTCTCTCCTTGGAA"	"CNT"
"GGTTGTAAGTCTGCGC"	"PT_2"
"GGTTGTACACACGGAA"	"DCT_1"
"GGTTGTACAGACGGAT"	"DCT_1"
"GGTTGTATCACTTGGA"	"PT_2"
"GGTTGTATCGATACAC"	"PT_2"
"GGTTGTATCTATGTGG"	"PEC"
"GTAACACAGATGTTGA"	"POD"
"GTAACACAGCTCCACG"	"DCT_1"
"GTAACACCATCAGCAT"	"DCT_1"
"GTAACACGTAATGCGG"	"CNT"
"GTAACACGTACGCGTC"	"CNT"
"GTAACACGTAGACGGT"	"PT_1"
"GTAACACTCCGGACGT"	"CNT"
"GTAACACTCCTAAGTG"	"DCT_1"
"GTAACCAAGACGTCCC"	"GC-EC"
"GTAACCAAGGTATCTC"	"PT_1"
"GTAACCACAACAAGTA"	"PT_2"
"GTAACCACAGGCTCTG"	"DCT_1"
"GTAACCAGTGTTCCTC"	"CNT"
"GTAACCATCCATCACC"	"DCT_1"
"GTAACCATCGTCTACC"	"TAL"
"GTAAGTCAGAGCAGCT"	"PT_1"
"GTAAGTCCAACATCGT"	"CNT"
"GTAAGTCGTCTTGAGT"	"DCT_1"
"GTAAGTCTCCGCACGA"	"CNT"
"GTAAGTCTCTGCTAGA"	"PT_1"
"GTAATCGCACAATTCG"	"CNT"
"GTAATCGGTAAGATTG"	"DCT_1"
"GTAATCGGTGATAGTA"	"DCT_1"
"GTAATGCAGACCAAAT"	"DCT_1"
"GTAATGCAGTCATTGC"	"PT_2"
"GTAATGCCAAGTGCTT"	"TAL"
"GTAATGCCACGCGGTT"	"EC-PTC"
"GTAATGCCACTCCCTA"	"DCT_1"
"GTAATGCCATTCACCC"	"IC-A1_1"
"GTAATGCGTTAACAGA"	"PT_1"
"GTAATGCTCCTTATGT"	"PT_1"
"GTACAACCACAAGCAG"	"CNT"
"GTACAACCACAAGTTC"	"TAL"
"GTACAACTCAAGCCAT"	"EC-PTC"
"GTACAACTCTTTCGAT"	"DCT_1"
"GTACAGTAGACTTCCA"	"DCT_1"
"GTACAGTAGGCGCTCT"	"DCT_1"
"GTACAGTCAGGAATAT"	"PT_1"
"GTACAGTCAGGAGACT"	"DCT_1"
"GTACAGTCATGAAGCG"	"CNT"
"GTACAGTGTCCACAGC"	"GC-EC"
"GTACAGTGTGACCGAA"	"PT_1"
"GTACAGTTCATCTATC"	"PT_1"
"GTACAGTTCGGCGATC"	"PT_2"
"GTACAGTTCTCAAAGC"	"IC-A1_1"
"GTACAGTTCTCCGCAT"	"PT_1"
"GTACAGTTCTCGGTCT"	"CNT"
"GTAGAAAAGCCATTCA"	"CNT"
"GTAGAAAAGTGTGTTC"	"DCT_1"
"GTAGAAACACCCTATC"	"PT_2"
"GTAGAAACATAGGTAA"	"IC-A1_1"
"GTAGAAAGTGCATACT"	"PT_2"
"GTAGAAAGTTCACGAT"	"DCT_2"
"GTAGAGGAGGAGAATG"	"TAL"
"GTAGAGGCACGCGGTT"	"EC-PTC"
"GTAGAGGCATCCGGCA"	"PT_1"
"GTAGATCAGTTGCATC"	"PT_2"
"GTAGATCCAAATACGA"	"PT_2"
"GTAGATCCAGGCTATT"	"EC-PTC"
"GTAGATCCAGTCTGGC"	"PT_1"
"GTAGATCCATCAGCAT"	"CNT"
"GTAGATCGTCTCCTGT"	"CNT"
"GTAGATCGTGCTTATG"	"DCT_1"
"GTAGCTAAGAAGCCAC"	"DCT_1"
"GTAGCTAAGATTGGGC"	"PT_2"
"GTAGCTACAATACAGA"	"PT_2"
"GTAGCTAGTATGGAAT"	"iPT"
"GTAGCTAGTTCCATTT"	"PT_2"
"GTAGCTATCGGCTATA"	"PT_1"
"GTAGCTATCGTAGCCG"	"DCT_1"
"GTAGCTATCTTACCAT"	"POD"
"GTAGGAGAGACTTAAG"	"IC-A1_1"
"GTAGGAGCACGCCAGT"	"IC-A1_2"
"GTAGGAGCACTGGACC"	"DCT_1"
"GTAGGAGCAGGCACTC"	"GC-EC"
"GTAGGAGGTTACACTG"	"CNT"
"GTAGGAGTCCCGATCT"	"PT_1"
"GTAGGTTCAGTATGAA"	"TAL"
"GTAGGTTCATCTGCGG"	"PT_1"
"GTAGGTTGTCTCAGAT"	"PT_1"
"GTAGGTTGTGATATAG"	"TAL"
"GTAGGTTTCGATCCCT"	"iPT"
"GTAGTACAGATGGTAT"	"DCT_1"
"GTAGTACAGGGTACAC"	"PT_1"
"GTAGTACCAACAGATA"	"EC-PTC"
"GTAGTACCAACTAGAA"	"DCT_1"
"GTAGTACCAAGCGATG"	"iPT"
"GTAGTACGTTGCACGC"	"PT_2"
"GTATTGGAGAAGAGCA"	"TAL"
"GTATTGGAGACGACGT"	"iPT"
"GTATTGGAGTTAGTGA"	"PT_1"
"GTATTGGCACTACCCT"	"PT_1"
"GTATTGGGTCCTTGTC"	"DCT_1"
"GTATTGGGTCTGCAAT"	"PT_1"
"GTATTGGTCGGTTAGT"	"PT_1"
"GTATTGGTCTGTTGGA"	"CNT"
"GTATTGGTCTTTCCAA"	"PT_1"
"GTATTTCAGTAAACGT"	"CNT"
"GTATTTCGTTGGTGTT"	"PT_1"
"GTATTTCTCAACGAGG"	"IC-A1_1"
"GTATTTCTCGCTGTTC"	"PT_2"
"GTCAAACAGGATTTAG"	"EC-PTC"
"GTCAAACAGGCACCAA"	"DCT_1"
"GTCAAACGTACGATTC"	"GC-EC"
"GTCAAACGTGAATAAC"	"DCT_1"
"GTCAAACGTGACACAG"	"PT_1"
"GTCAAACGTGTATTCG"	"TAL"
"GTCAAACGTGTCATTG"	"PT_1"
"GTCAAACTCAGTGCGC"	"TAL"
"GTCAAACTCCGAGGCT"	"CNT"
"GTCAAGTAGAGGCTGT"	"IC-A1_1"
"GTCAAGTAGCAGGCAT"	"IC-A1_1"
"GTCAAGTGTCCAGAAG"	"TAL"
"GTCAAGTGTGCAGATG"	"PT_2"
"GTCAAGTGTGCAGTGA"	"PT_1"
"GTCACGGAGATGACCG"	"PT_2"
"GTCACGGCACACAGAG"	"PT_1"
"GTCACGGCACCCAAGC"	"CNT"
"GTCACGGGTCGTCATA"	"DCT_1"
"GTCACTCCATCTCATT"	"EC-PTC"
"GTCACTCCATGTGACT"	"PT_1"
"GTCACTCTCATTGTGG"	"GC-EC"
"GTCAGCGAGATTCGAA"	"PT_1"
"GTCAGCGCACCCAATA"	"PT_1"
"GTCAGCGGTACGCTAT"	"iPT"
"GTCAGCGGTGATGAAT"	"PT_2"
"GTCAGCGGTTCAACGT"	"DCT_1"
"GTCAGCGTCCACACCT"	"PT_1"
"GTCAGCGTCCTGATAG"	"IC-A1_1"
"GTCATCCCAGCGGTTC"	"DCT_1"
"GTCATCCCAGTCGGAA"	"PT_2"
"GTCATCCGTCATCAGT"	"PT_1"
"GTCATCCGTTGCAACT"	"iPT"
"GTCATCCTCGACCCAG"	"EC-PTC"
"GTCATGAAGAGTCTTC"	"IC-A1_1"
"GTCATGAAGTCTCCTC"	"PT_1"
"GTCATGATCAACTCTT"	"PT_2"
"GTCATGATCCTCAGAA"	"DCT_1"
"GTCATGATCCTTGGAA"	"PT_1"
"GTCATTTAGGTCCCTG"	"iPT"
"GTCATTTCACGACGCT"	"PT_1"
"GTCATTTCAGCTGGTC"	"EC-PTC"
"GTCATTTCATACCATG"	"PT_1"
"GTCATTTGTCCAAAGG"	"PT_1"
"GTCATTTTCCAGTTCC"	"EC-PTC"
"GTCCACTAGCGTTGTT"	"PT_2"
"GTCCACTCAAACTAAG"	"CNT"
"GTCCACTTCTACGGTA"	"PT_2"
"GTCCCATCAAGACGAC"	"DCT_1"
"GTCCCATCATCTCAAG"	"IC-A1_2"
"GTCCCATCATGGCGCT"	"PT_2"
"GTCCCATGTAGCTTTG"	"DCT_1"
"GTCCCATTCCATTTGT"	"CNT"
"GTCCTCACACCAGACC"	"IC-A1_1"
"GTCCTCACACGGCTAC"	"PT_1"
"GTCCTCACATGACTGT"	"iPT"
"GTCCTCAGTAACATAG"	"POD"
"GTCCTCATCATGTCAG"	"PT_1"
"GTCCTCATCTGCGATA"	"PT_1"
"GTCGAATAGATTAGTG"	"DCT_1"
"GTCGAATAGTTGCTGT"	"IC-A1_1"
"GTCGAATCAATGGGTG"	"CNT"
"GTCGAATCACGACGTC"	"iPT"
"GTCGAATCATCTAACG"	"DCT_1"
"GTCGAATTCCGATAAC"	"PT_2"
"GTCGCGAAGATCGCCC"	"IC-A1_1"
"GTCGCGAAGTCGAATA"	"IC-A1_2"
"GTCGCGACACCAATTG"	"EC-PTC"
"GTCGCGACAGTTGGTT"	"PT_1"
"GTCGCGAGTCAGGTAG"	"TAL"
"GTCGCGAGTGACTGTT"	"PT_2"
"GTCGCGAGTGTCACAT"	"GC-EC"
"GTCGCGATCAAACTGC"	"PT_1"
"GTCGCGATCAGCGCAC"	"iPT"
"GTCGCGATCGTTACCC"	"PT_2"
"GTCGCGATCTGTCCGT"	"iPT"
"GTCGCGATCTGTCGCT"	"DCT_1"
"GTCGTAACAGTTCACA"	"GC-EC"
"GTCGTTCAGAAGTCCG"	"TAL"
"GTCGTTCAGCTCGGCT"	"GC-EC"
"GTCGTTCGTAGACTGG"	"PT_2"
"GTCGTTCGTAGCTGCC"	"DCT_2"
"GTCGTTCGTTGCGTAT"	"PT_1"
"GTCTACCAGGAGCTGT"	"PT_2"
"GTCTACCAGTCACAGG"	"DCT_1"
"GTCTACCCAGGTTCCG"	"DCT_1"
"GTCTACCGTCACCCTT"	"DCT_1"
"GTCTACCTCCCAGTGG"	"PT_1"
"GTCTACCTCGCGTTTC"	"PT_1"
"GTCTACCTCTTCCTAA"	"TAL"
"GTCTAGACAACAGCTT"	"PT_1"
"GTCTAGACAACGGGTA"	"EC-PTC"
"GTCTAGACACTGGCCA"	"PT_1"
"GTCTCACAGCGCTGCT"	"PT_2"
"GTCTCACAGTCAGCGA"	"EC-PTC"
"GTCTCACCAGACAATA"	"TAL"
"GTCTCACGTCTGTAGT"	"PT_2"
"GTCTCACTCAGCAGAG"	"CNT"
"GTCTCACTCCAGCAAT"	"DCT_1"
"GTCTGTCAGGCATGCA"	"PT_1"
"GTCTGTCAGTAAATGC"	"DCT_1"
"GTCTGTCGTACGAGTG"	"IC-A1_1"
"GTCTGTCGTGACTCTA"	"PT_2"
"GTCTTTAAGCCAACCC"	"CNT"
"GTCTTTAAGCCTCATA"	"EC-PTC"
"GTCTTTAAGGGAGAAT"	"DCT_1"
"GTCTTTAAGGTCCGAA"	"POD"
"GTCTTTACAAATGGCG"	"PT_2"
"GTCTTTACAGCTGTTA"	"DCT_1"
"GTCTTTATCCACTAGA"	"IC-A1_1"
"GTCTTTATCGTGTGAT"	"DCT_1"
"GTCTTTATCTGAATCG"	"GC-EC"
"GTGACGCAGACGCCCT"	"PT_2"
"GTGACGCAGAGAGTGA"	"PT_2"
"GTGACGCAGCACTCAT"	"DCT_1"
"GTGACGCAGGAGTATT"	"EC-PTC"
"GTGACGCAGTATTGCC"	"PT_1"
"GTGACGCGTTAGCGGA"	"CNT"
"GTGACGCTCACTGAAC"	"PT_2"
"GTGACGCTCGTAACTG"	"CNT"
"GTGACGCTCTGGGAGA"	"PT_1"
"GTGAGCCAGCTGCCTG"	"CNT"
"GTGAGCCCAGCGCGTT"	"TAL"
"GTGAGCCGTCACCACG"	"IC-A1_2"
"GTGAGCCGTCGCACAC"	"IC-A1_1"
"GTGAGCCGTCTGTAGT"	"PT_1"
"GTGAGCCGTCTTGGTA"	"PT_1"
"GTGAGCCGTGGTTTAC"	"IC-A1_1"
"GTGAGCCTCCTAGCTC"	"IC-A1_1"
"GTGAGCCTCTCTATGT"	"EC-PTC"
"GTGAGGACATTCAGGT"	"PT_1"
"GTGAGGATCAAGAGGC"	"CNT"
"GTGAGGATCCTACAAG"	"IC-A1_1"
"GTGAGGATCGAGAATA"	"GC-EC"
"GTGAGTTAGAGCAGAA"	"IC-A1_1"
"GTGAGTTAGCACTTTG"	"PT_1"
"GTGAGTTAGGTAAGTT"	"TAL"
"GTGAGTTCAAATTAGG"	"DCT_1"
"GTGAGTTGTGTGATGG"	"CNT"
"GTGATGTAGTTACTCG"	"EC-PTC"
"GTGATGTCAATTGTGC"	"PT_1"
"GTGATGTCACTCTAGA"	"PT_1"
"GTGATGTCACTGCGAC"	"POD"
"GTGATGTGTAACAAGT"	"TAL"
"GTGATGTGTACTAACC"	"CNT"
"GTGATGTGTCGGTACC"	"PT_1"
"GTGATGTGTTCAAGGG"	"IC-A1_1"
"GTGATGTGTTGCACGC"	"DCT_1"
"GTGCACGAGGTGCATG"	"PT_2"
"GTGCACGCACAAAGCG"	"PT_1"
"GTGCACGGTATGCTAC"	"IC-A1_1"
"GTGCACGGTCCTCCAT"	"GC-EC"
"GTGCACGGTGCCCAGT"	"CNT"
"GTGCACGGTTATAGAG"	"PT_1"
"GTGCACGTCAAGAGTA"	"PT_1"
"GTGCACGTCACAGAGG"	"MC"
"GTGCAGCAGGCACAAC"	"DCT_1"
"GTGCAGCGTCTACGTA"	"PT_1"
"GTGCAGCGTTATCCAG"	"EC-PTC"
"GTGCAGCTCGGTCTAA"	"iPT"
"GTGCGTGAGCAGCCCT"	"CNT"
"GTGCGTGAGTCTCTGA"	"EC-PTC"
"GTGCGTGAGTTGGGAC"	"DCT_1"
"GTGCGTGCACTTGTGA"	"PT_1"
"GTGCGTGGTGTGAATA"	"DCT_1"
"GTGCTGGAGAATCGTA"	"CNT"
"GTGCTGGAGGACTGGT"	"DCT_1"
"GTGCTGGCAACTAGAA"	"iPT"
"GTGCTGGGTAGTGCGA"	"PT_1"
"GTGCTGGGTATCAGCT"	"DCT_1"
"GTGCTGGGTGACTATC"	"PT_2"
"GTGCTGGGTGTTGACT"	"TAL"
"GTGCTTCAGCATGAAT"	"PT_1"
"GTGCTTCAGCTAGTTC"	"PT_1"
"GTGCTTCAGTGACACG"	"TAL"
"GTGCTTCCAAGCCATT"	"DCT_1"
"GTGCTTCCATCGGATT"	"EC-PTC"
"GTGCTTCGTCGTGCCA"	"IC-A1_1"
"GTGCTTCTCCAACCGG"	"TAL"
"GTGGAAGAGGGAGGCA"	"IC-A1_2"
"GTGGAAGCACACGCCA"	"DCT_1"
"GTGGAAGGTACACTCA"	"EC-PTC"
"GTGGAAGGTACGATTC"	"DCT_1"
"GTGGAAGGTCTTGCTC"	"PT_1"
"GTGGAGAAGGCCGCTT"	"CNT"
"GTGGAGAAGTGCAAAT"	"DCT_1"
"GTGGAGACAACCTAAC"	"PT_1"
"GTGGAGACAAGCCATT"	"IC-A1_1"
"GTGGAGACACACCGCA"	"CNT"
"GTGGAGATCGCAGAGA"	"DCT_1"
"GTGGAGATCTCCCAAC"	"PT_2"
"GTGGCGTAGGATACCG"	"IC-A1_1"
"GTGGCGTAGGCCCGTT"	"DCT_1"
"GTGGCGTCAGAGCTAG"	"CNT"
"GTGGCGTGTAAGTTGA"	"GC-EC"
"GTGGCGTGTCTACAAC"	"CNT"
"GTGGCGTGTGGTCAAG"	"EC-PTC"
"GTGGCGTGTGTGAGCA"	"DCT_1"
"GTGGGAAAGTTGTAGA"	"IC-A1_1"
"GTGGGAACAAAGTATG"	"TAL"
"GTGGGAACATAATCCG"	"PT_1"
"GTGGGAAGTAGATCCT"	"CNT"
"GTGGGAAGTGGCAACA"	"PT_1"
"GTGGGAATCTCCACTG"	"DCT_1"
"GTGGTTAAGTGAGTGC"	"CNT"
"GTGGTTACAAGCACAG"	"PT_1"
"GTGTAACAGCTTTCTT"	"PT_1"
"GTGTAACAGTATGTAG"	"CNT"
"GTGTAACGTCCTGAAT"	"PT_2"
"GTGTAACGTCGTTATG"	"CNT"
"GTGTAACGTGTTCGAT"	"IC-A1_2"
"GTGTAACTCGTCTCAC"	"TAL"
"GTGTCCTAGAAAGCGA"	"TAL"
"GTGTCCTAGATTACCC"	"GC-EC"
"GTGTCCTAGCCTCAAT"	"PT_2"
"GTGTCCTAGTCATAGA"	"DCT_1"
"GTGTCCTCATCTGGGC"	"PT_1"
"GTGTCCTGTATGGAGC"	"CNT"
"GTGTCCTGTTTCGTTT"	"PT_1"
"GTGTGATAGCTAGCCC"	"iPT"
"GTGTGATAGGGTCAAC"	"TAL"
"GTGTGATGTCACGCTG"	"DCT_1"
"GTGTGATGTCTGTGTA"	"GC-EC"
"GTGTGATGTGCCTTCT"	"CNT"
"GTGTGATGTTACCCAA"	"DCT_1"
"GTGTGATTCCACAGCG"	"CNT"
"GTGTGATTCCATTTAC"	"PT_1"
"GTGTGATTCTTCGCTG"	"iPT"
"GTGTGGCAGATTGTGA"	"PT_1"
"GTGTGGCCAAGGGCAT"	"PT_2"
"GTGTGGCGTGTAACGG"	"CNT"
"GTGTGGCTCGTCGCTT"	"PT_1"
"GTGTTAGCAACATCGT"	"DCT_1"
"GTGTTAGCAAGACGGT"	"CNT"
"GTGTTAGCACCTAAAC"	"DCT_1"
"GTGTTAGGTCAAACGG"	"DCT_1"
"GTGTTAGGTCCGAAAG"	"PT_1"
"GTGTTAGTCACTGGTA"	"EC-PTC"
"GTGTTAGTCAGCAGAG"	"IC-A1_1"
"GTGTTAGTCTACGCAA"	"CNT"
"GTGTTCCGTTAGAAAC"	"IC-A1_1"
"GTGTTCCGTTTAGTCG"	"GC-EC"
"GTTACAGAGCTCGAAG"	"DCT_1"
"GTTACAGCAGCCGGTT"	"PT_2"
"GTTACAGGTACGGCAA"	"DCT_1"
"GTTACAGGTGGCTCTG"	"EC-PTC"
"GTTACAGTCCGACATA"	"DCT_1"
"GTTACCCAGCCGTCGT"	"IC-A1_1"
"GTTACCCCAACACGTT"	"CNT"
"GTTACCCCACGTCATA"	"CNT"
"GTTACCCCAGTGCCTG"	"TAL"
"GTTACCCGTCGCACAC"	"GC-EC"
"GTTACCCGTTTCAGAC"	"DCT_1"
"GTTACCCGTTTGTGGT"	"TAL"
"GTTACGAAGAAGCCAC"	"EC-PTC"
"GTTACGACAAAGCTCT"	"PT_2"
"GTTACGAGTATAGGAT"	"PT_1"
"GTTACGAGTATGTCTG"	"IC-A1_1"
"GTTACGAGTCACTTAG"	"CNT"
"GTTAGACCAAAGCGTG"	"DCT_1"
"GTTAGACGTGCATGAG"	"PT_1"
"GTTAGACTCGAGAGCA"	"CNT"
"GTTAGACTCGTAGGGA"	"PT_2"
"GTTAGTGAGCAACCAG"	"PT_1"
"GTTAGTGAGGTTGCCC"	"DCT_1"
"GTTAGTGCAATAAGGT"	"TAL"
"GTTAGTGGTATTGGCT"	"PT_2"
"GTTAGTGTCCGATCTC"	"PT_1"
"GTTATGGAGACGAAGA"	"T-cell"
"GTTATGGCAAGGATGC"	"CNT"
"GTTATGGGTAGGCTGA"	"CNT"
"GTTATGGGTTGGATCT"	"CNT"
"GTTATGGTCCCGTGTT"	"iPT"
"GTTATGGTCTCATGCC"	"PT_1"
"GTTCATTAGTGCGACA"	"EC-PTC"
"GTTCATTCATGTCAGT"	"DCT_1"
"GTTCATTCATTGAAAG"	"PT_1"
"GTTCATTGTCCGGTCA"	"PT_2"
"GTTCATTGTCCTGTCT"	"iPT"
"GTTCATTTCGTGCAGC"	"PT_1"
"GTTCCGTAGACGGAAA"	"PT_1"
"GTTCCGTAGATTCGAA"	"EC-PTC"
"GTTCCGTCAGTAGTTC"	"PT_2"
"GTTCCGTGTACGCGTC"	"PT_2"
"GTTCCGTGTCGTTGGC"	"CNT"
"GTTCGCTAGCTGCGAA"	"DCT_1"
"GTTCGCTAGGTAGGCT"	"IC-A1_1"
"GTTCGCTCAACCAACT"	"GC-EC"
"GTTCGCTCATAATCCG"	"PT_1"
"GTTCGCTGTCGAAGCA"	"DCT_1"
"GTTCGCTTCCATATGG"	"PT_2"
"GTTCGCTTCGAGCCAC"	"CNT"
"GTTCTATCACCCATAA"	"IC-A1_1"
"GTTCTATCATCCAATG"	"CNT"
"GTTCTATGTCAAGGCA"	"CNT"
"GTTCTATGTCTAACTG"	"IC-A1_2"
"GTTCTATTCGTTCATT"	"CNT"
"GTTCTATTCTTTGCTA"	"PT_1"
"GTTGAACAGTGGTTAA"	"IC-A1_2"
"GTTGAACTCACTGGGC"	"CNT"
"GTTGAACTCATTGGTG"	"PT_2"
"GTTGAACTCCCTCTTT"	"IC-A1_1"
"GTTGAACTCTCCCAAC"	"iPT"
"GTTGAACTCTCCGTGT"	"PT_2"
"GTTGCGGAGAGTATAC"	"PT_1"
"GTTGCGGAGTGGACGT"	"CNT"
"GTTGCGGAGTGTTCAC"	"PT_1"
"GTTGCGGGTCACCACG"	"EC-PTC"
"GTTGCGGTCCATAAGC"	"PT_2"
"GTTGCGGTCGCTAATG"	"TAL"
"GTTGCTCAGGGCTGAT"	"EC-PTC"
"GTTGCTCAGTGATGGC"	"GC-EC"
"GTTGCTCCAATGGGTG"	"PT_1"
"GTTGCTCCAGGATTCT"	"PT_2"
"GTTGCTCTCGTGCATA"	"CNT"
"GTTGTAGAGACGAGCT"	"TAL"
"GTTGTAGAGGCGATAC"	"iPT"
"GTTGTAGAGGTTGGTG"	"PT_2"
"GTTGTAGCATAAGCAA"	"PT_1"
"GTTGTAGGTAGGACCA"	"GC-EC"
"GTTGTAGGTTGTCAGT"	"GC-EC"
"GTTGTCCAGAACTTCC"	"PT_1"
"GTTGTCCAGGCCTAAG"	"PT_1"
"GTTGTCCGTACGACAG"	"CNT"
"GTTGTCCGTAGAGCTG"	"PT_2"
"GTTGTCCGTTAAAGTG"	"CNT"
"GTTGTCCGTTGGAGAC"	"MC"
"GTTGTCCGTTGTCTAG"	"DCT_1"
"GTTGTCCTCATTGTTC"	"GC-EC"
"GTTGTCCTCCACGGGT"	"PT_2"
"GTTGTCCTCGAGTTGT"	"DCT_1"
"GTTGTCCTCTATCACT"	"DCT_1"
"GTTGTGAGTAACATAG"	"CNT"
"GTTTACTGTTCCGTTC"	"GC-EC"
"GTTTACTTCACCTCAC"	"iPT"
"GTTTGGAAGTGGTCAG"	"DCT_1"
"GTTTGGACAAAGTGTA"	"POD"
"GTTTGGACATCCTGTC"	"TAL"
"TAACACGAGGGAGTTC"	"DCT_1"
"TAACACGCAGCACCCA"	"DCT_1"
"TAACACGGTAACAAGT"	"PT_1"
"TAACACGGTGACGCCT"	"TAL"
"TAACACGTCACCTGGG"	"GC-EC"
"TAACACGTCGGCATTA"	"EC-PTC"
"TAACCAGAGACGCCCT"	"TAL"
"TAACCAGAGAGTCACG"	"CNT"
"TAACCAGCACCAATTG"	"EC-PTC"
"TAACCAGGTAATACCC"	"TAL"
"TAACCAGTCTACCAGA"	"PT_1"
"TAACGACCAACCGACC"	"PT_1"
"TAACGACCATAACCCA"	"DCT_1"
"TAACGACGTACTGACT"	"GC-EC"
"TAACGACGTGTACATC"	"PT_1"
"TAACGACTCTCTTAAC"	"PT_1"
"TAACTTCCACAGCCAC"	"PT_1"
"TAACTTCCAGCAGAAC"	"CNT"
"TAACTTCGTCGATGCC"	"IC-A1_1"
"TAACTTCGTTCGTACA"	"DCT_1"
"TAACTTCTCCGGCAGT"	"PT_1"
"TAACTTCTCGAGTGGA"	"GC-EC"
"TAACTTCTCGCCGAGT"	"PT_1"
"TAAGCACAGCCTGTCG"	"PT_1"
"TAAGCACAGTGCAAAT"	"IC-A1_1"
"TAAGCACAGTTCATCG"	"TAL"
"TAAGCACCAAAGCTCT"	"TAL"
"TAAGCACCAAGTAGTA"	"PT_2"
"TAAGCACGTGAACTAA"	"IC-A1_1"
"TAAGCCAAGAAACTAC"	"TAL"
"TAAGCCAAGACTACCT"	"IC-A1_1"
"TAAGCCAAGCATAGGC"	"PT_1"
"TAAGCCAAGCGATCGA"	"EC-PTC"
"TAAGCCAAGGCCTAGA"	"TAL"
"TAAGCCAAGGCTCAAG"	"PT_1"
"TAAGCCAAGGGTAGCT"	"CNT"
"TAAGCCACAACACTAC"	"EC-PTC"
"TAAGCCACAAGCTGTT"	"POD"
"TAAGCCACAGTCAGAG"	"EC-PTC"
"TAAGCCACATCGGTTA"	"iPT"
"TAAGCCAGTGTGTTTG"	"PT_1"
"TAAGCCATCAAAGCCT"	"DCT_1"
"TAAGCCATCGACATTG"	"GC-EC"
"TAAGCCATCTACACTT"	"PT_1"
"TAAGCGTCAGAGCTAG"	"TAL"
"TAAGCGTGTGCCTTCT"	"DCT_1"
"TAAGCGTGTTGCTTGA"	"CNT"
"TAAGCGTTCTTTGCGC"	"PT_1"
"TAAGTCGAGACCTTTG"	"PT_2"
"TAAGTCGAGAGTTGTA"	"DCT_1"
"TAAGTCGCAGCACGAA"	"PT_1"
"TAAGTCGGTCCTGGGT"	"PT_2"
"TAAGTCGTCATCGCCT"	"IC-A1_1"
"TAAGTCGTCGAGAAAT"	"DCT_1"
"TAATCTCCAGCCATTA"	"POD"
"TAATCTCGTCGTTGGC"	"GC-EC"
"TAATCTCTCCTCTTTC"	"PT_1"
"TAATCTCTCTTAGCAG"	"PT_2"
"TAATTCCAGACTTCAC"	"iPT"
"TAATTCCAGTCTTCCC"	"PT_1"
"TAATTCCCATCGGAAG"	"CNT"
"TAATTCCGTCACAATC"	"DCT_1"
"TAATTCCGTCCAGCGT"	"DCT_1"
"TAATTCCGTGGATACG"	"PT_1"
"TAATTCCGTGTATACC"	"PT_2"
"TAATTCCTCCTAGCTC"	"PT_1"
"TAATTCCTCTCCTGAC"	"DCT_1"
"TACAACGAGAACTGAT"	"IC-A1_1"
"TACAACGAGTAAATGC"	"DCT_1"
"TACAACGAGTATGTAG"	"PT_1"
"TACAACGCATGACGAG"	"PT_1"
"TACAACGCATGGTACT"	"TAL"
"TACAACGGTCCGGTGT"	"PT_2"
"TACAACGGTTCAGTAC"	"GC-EC"
"TACAACGGTTGTAGCT"	"PT_1"
"TACAACGTCCATTCAT"	"PT_1"
"TACACCCGTTGATCGT"	"MC"
"TACACCCTCCTCATAT"	"PT_2"
"TACACCCTCGACGCGT"	"PT_2"
"TACACCCTCTCCTGTG"	"DCT_1"
"TACAGGTAGCAAATGT"	"CNT"
"TACAGGTAGTACGAGC"	"DCT_1"
"TACAGGTCATCGGATT"	"GC-EC"
"TACAGGTTCACCCTGT"	"PT_2"
"TACATTCAGAAACCAT"	"CNT"
"TACATTCAGAAATCCA"	"PT_1"
"TACATTCAGCTGACTT"	"PT_2"
"TACATTCGTAGACGTG"	"PT_2"
"TACATTCGTGGCTGAA"	"TAL"
"TACATTCGTGTGTCCG"	"iPT"
"TACATTCGTTGCAAGG"	"DCT_1"
"TACATTCTCAATGCAC"	"CNT"
"TACCCACAGCATGCAG"	"PT_1"
"TACCCACCACGCTATA"	"iPT"
"TACCCACCAGTAACGG"	"PT_2"
"TACCCACCATGTTCAG"	"DCT_1"
"TACCCACTCAAGAGGC"	"PT_1"
"TACCCGTCACTGGCCA"	"CNT"
"TACCCGTCAGTCAGCC"	"PT_1"
"TACCCGTGTACAAAGT"	"EC-PTC"
"TACCCGTGTCGAAGCA"	"TAL"
"TACCGAAAGGGAGAAT"	"PT_1"
"TACCGAAAGGTCATAA"	"PT_1"
"TACCGAACACACAGAG"	"IC-A1_1"
"TACCGAAGTCGCTTGG"	"TAL"
"TACCGAAGTCGGCACT"	"TAL"
"TACCGAAGTCTCAGGC"	"IC-A1_2"
"TACCGAAGTGTTAGCT"	"PT_2"
"TACCGAAGTTATGTCG"	"PT_1"
"TACCGAATCAGGACAG"	"EC-PTC"
"TACCGAATCGACGATT"	"IC-A1_1"
"TACCGAATCTCCTGAC"	"PT_1"
"TACCGGGAGAAGTCTA"	"PT_1"
"TACCGGGAGACTGAGC"	"GC-EC"
"TACCGGGAGATGACCG"	"CNT"
"TACCGGGAGGTTACCT"	"EC-PTC"
"TACCGGGAGTAAACGT"	"IC-A1_1"
"TACCGGGAGTTGCCTA"	"PT_2"
"TACCGGGCAACTCGTA"	"PT_1"
"TACCGGGCACGTGTGC"	"DCT_1"
"TACCGGGCAGCCCACA"	"DCT_1"
"TACCGGGGTCCGGATC"	"PT_1"
"TACCGGGGTCGGCTAC"	"IC-A1_1"
"TACCGGGTCCGAGTGC"	"EC-PTC"
"TACCGGGTCTTGCAAG"	"PT_1"
"TACCTCGAGGAACGTC"	"iPT"
"TACCTCGAGGACATCG"	"PT_2"
"TACCTCGAGTAGTCTC"	"PT_2"
"TACCTCGTCAACCCGG"	"CNT"
"TACCTCGTCATGGAGG"	"PT_2"
"TACCTCGTCTCTCTAA"	"CNT"
"TACCTGCAGTCGCCAC"	"EC-PTC"
"TACCTGCCAGAGATGC"	"PT_1"
"TACCTGCGTGTCTCCT"	"PT_2"
"TACCTGCTCGCCAATA"	"DCT_1"
"TACGCTCCAAATGGTA"	"T-cell"
"TACGCTCCACACACTA"	"GC-EC"
"TACGCTCGTTGACTAC"	"DCT_1"
"TACGCTCGTTTAGTCG"	"PT_1"
"TACGCTCTCCGTGGCA"	"TAL"
"TACGGGCAGACTCTTG"	"DCT_1"
"TACGGGCAGCATCCCG"	"GC-EC"
"TACGGGCAGTGCGACA"	"PT_1"
"TACGGGCCAGCCTATA"	"TAL"
"TACGGGCGTCCACACG"	"DCT_1"
"TACGGTAAGATGGCAC"	"PT_1"
"TACGGTAAGATGTTCC"	"IC-A1_1"
"TACGGTACAAGTTTGC"	"PT_2"
"TACGGTACAATGTCAC"	"TAL"
"TACGGTACAGTGGGTA"	"PT_1"
"TACGGTAGTAGCCCTG"	"PT_2"
"TACGGTATCAGCTGTA"	"PT_1"
"TACGTCCCAATAGTCC"	"PT_1"
"TACGTCCCACAGCATT"	"DCT_1"
"TACGTCCCACGCCAGT"	"CNT"
"TACGTCCCACTACAGT"	"PT_2"
"TACGTCCCATCTAACG"	"DCT_1"
"TACTGCCGTAATTGGA"	"CNT"
"TACTGCCTCATAGAGA"	"DCT_1"
"TACTGCCTCGCCTATC"	"CNT"
"TACTGCCTCGTCACCT"	"PT_1"
"TACTTACAGGAGACCT"	"EC-PTC"
"TACTTACCAAATCAGA"	"TAL"
"TACTTACCAAGACCTT"	"DCT_1"
"TACTTACCAGGGTCTC"	"PT_1"
"TACTTACCATGCCGGT"	"DCT_1"
"TACTTACGTAATGTGA"	"PT_1"
"TACTTACGTAATTGGA"	"CNT"
"TACTTACTCCCGTTCA"	"GC-EC"
"TACTTACTCGACATTG"	"PT_1"
"TACTTCACATGACGTT"	"PT_1"
"TACTTCAGTCCAAATC"	"DCT_1"
"TACTTCAGTCGAACGA"	"IC-A1_1"
"TACTTCATCGCATGAT"	"PT_1"
"TACTTCATCGGCCCAA"	"PT_2"
"TACTTGTAGAATCGTA"	"PT_1"
"TACTTGTAGATAACGT"	"PT_2"
"TACTTGTAGGTGCCAA"	"PT_1"
"TACTTGTAGTGTTGAA"	"PT_1"
"TACTTGTTCGGAGTGA"	"DCT_2"
"TAGACCAAGATGACAT"	"PT_1"
"TAGACCAAGGGCTGAT"	"GC-EC"
"TAGACCAAGGTTATAG"	"TAL"
"TAGACCACAGAGGTTG"	"IC-A1_1"
"TAGACCACATTCTCCG"	"PT_1"
"TAGACCAGTCGGAACA"	"TAL"
"TAGACCATCACGAGGA"	"GC-EC"
"TAGACCATCAGGAAGC"	"PT_2"
"TAGACCATCATTCGTT"	"PT_1"
"TAGACCATCGTTATCT"	"EC-PTC"
"TAGACTGAGGAGGCAG"	"CNT"
"TAGACTGCAGCGTGCT"	"PT_2"
"TAGACTGGTACCCACG"	"TAL"
"TAGACTGGTCAACCAT"	"PT_1"
"TAGACTGTCAATCGGT"	"CNT"
"TAGACTGTCAGAGCGA"	"iPT"
"TAGACTGTCCTTATCA"	"iPT"
"TAGACTGTCGTCACCT"	"PT_1"
"TAGAGTCAGCTCACTA"	"PT_1"
"TAGAGTCCACTCCCTA"	"PT_1"
"TAGAGTCCATTCGATG"	"PT_2"
"TAGAGTCGTCGGTACC"	"TAL"
"TAGAGTCTCTTGATTC"	"TAL"
"TAGATCGAGCGACAGT"	"PT_2"
"TAGATCGCAAATGGAT"	"PT_1"
"TAGATCGGTACCGCGT"	"DCT_1"
"TAGATCGGTCTTCTAT"	"GC-EC"
"TAGATCGGTGCAGTGA"	"CNT"
"TAGATCGTCCATTTGT"	"PT_1"
"TAGATCGTCTCATTAC"	"CNT"
"TAGCACAAGGGTGGGA"	"CNT"
"TAGCACATCATCCTAT"	"PT_1"
"TAGGAGGAGGTAAACT"	"iPT"
"TAGGAGGCAGGCTTGC"	"PT_2"
"TAGGAGGCAGTCTGGC"	"PT_1"
"TAGGAGGCATGGTACT"	"IC-A1_1"
"TAGGAGGGTCATCCCT"	"DCT_1"
"TAGGAGGGTTAGGACG"	"PT_2"
"TAGGGTTAGAAGCCAC"	"PT_1"
"TAGGGTTCAACAAGAT"	"PT_1"
"TAGGGTTCACACTTAG"	"PT_1"
"TAGGGTTCACGCTTAA"	"PT_1"
"TAGGGTTGTATCTCGA"	"GC-EC"
"TAGGGTTGTCGGATTT"	"PT_1"
"TAGGTACAGACAGCGT"	"DCT_1"
"TAGGTACAGATGTTGA"	"PT_1"
"TAGGTACAGCCACAAG"	"CNT"
"TAGGTACAGGCGCTCT"	"CNT"
"TAGGTACAGTCACTGT"	"PT_1"
"TAGGTACCACTTACAG"	"IC-A1_1"
"TAGGTACGTCTGTGAT"	"CNT"
"TAGGTACTCCATTCGC"	"PT_2"
"TAGGTACTCGTACCTC"	"IC-A1_2"
"TAGGTACTCTTGCAGA"	"CNT"
"TAGGTTGAGCTATCCA"	"PT_2"
"TAGGTTGAGGTGGCTA"	"PT_1"
"TAGGTTGAGTGTTGAA"	"CNT"
"TAGGTTGCATAACCCA"	"PT_1"
"TAGGTTGCATGATCTG"	"PT_1"
"TAGGTTGGTAACCAGG"	"PT_1"
"TAGGTTGGTCACTAGT"	"PT_2"
"TAGGTTGTCTCCGAGG"	"TAL"
"TAGTGCAAGCTCAGAG"	"DCT_1"
"TAGTGCAAGGTACAAT"	"PT_1"
"TAGTGCAAGGTGCAGT"	"DCT_1"
"TAGTGCACAGTTGGTT"	"PT_1"
"TAGTGCATCCGATGTA"	"PT_1"
"TAGTGCATCTAACACG"	"CNT"
"TATACCTAGGGAGGTG"	"CNT"
"TATACCTAGTGCGTCC"	"PT_1"
"TATACCTCATGGTACT"	"PT_2"
"TATACCTGTGCATACT"	"EC-PTC"
"TATACCTGTGTGCCTG"	"PT_2"
"TATACCTTCCTACGAA"	"PT_2"
"TATATCCAGAGGTCAC"	"PT_1"
"TATATCCCAAGCGCAA"	"GC-EC"
"TATATCCCACTAGGCC"	"EC-PTC"
"TATATCCCAGTAGGAC"	"IC-A1_1"
"TATATCCTCCCGAATA"	"CNT"
"TATATCCTCGGCTGGT"	"DCT_1"
"TATCAGGAGCAACCAG"	"PT_1"
"TATCAGGAGGATTCCT"	"IC-A1_1"
"TATCAGGAGTCATGGG"	"EC-PTC"
"TATCAGGGTGGTTCTA"	"DCT_1"
"TATCAGGTCCACTGGG"	"PT_1"
"TATCAGGTCCATAGGT"	"IC-A1_2"
"TATCAGGTCTCTCTTC"	"PT_1"
"TATCCTACATGCAGCC"	"PT_1"
"TATCCTAGTACCCAGC"	"PT_1"
"TATCCTAGTCGAAACG"	"DCT_1"
"TATCCTAGTTCTAACG"	"DCT_1"
"TATCGCCCAAGTACCT"	"DCT_1"
"TATCGCCGTAGAGTTA"	"IC-A1_1"
"TATCGCCGTAGGATAT"	"CNT"
"TATCGCCGTCAATCTG"	"PT_1"
"TATCGCCGTTCGAACT"	"DCT_1"
"TATCTGTAGGCTGAAC"	"PT_2"
"TATCTGTAGTATGGCG"	"CNT"
"TATCTGTCACTACAGT"	"DCT_1"
"TATCTGTGTTTACTGG"	"PT_1"
"TATCTGTTCAGCCTCT"	"TAL"
"TATCTTGAGCAAGTCG"	"PT_1"
"TATCTTGCATGAAGGC"	"PT_1"
"TATCTTGGTCATCTAG"	"DCT_1"
"TATCTTGTCAGTGATC"	"TAL"
"TATCTTGTCGTCCATC"	"PT_1"
"TATGTTCAGTAATACG"	"PT_1"
"TATGTTCCAGGCAATG"	"CNT"
"TATGTTCCATTCTCTA"	"PT_1"
"TATGTTCGTATGGGAC"	"PT_1"
"TATGTTCGTGCATGTT"	"CNT"
"TATGTTCGTGTATTCG"	"PT_2"
"TATGTTCGTTGGCCGT"	"PT_1"
"TATGTTCTCACGGGAA"	"PT_1"
"TATGTTCTCCACTAGA"	"IC-A1_2"
"TATTCCAAGATGAATC"	"GC-EC"
"TATTCCACAAATCGTC"	"PEC"
"TATTCCACACCCGTAG"	"DCT_1"
"TATTCCACACGACAAG"	"DCT_1"
"TATTCCAGTGCATCTA"	"CNT"
"TATTCCATCACGGACC"	"CNT"
"TATTCCATCCTCACGT"	"CNT"
"TATTGCTAGTAGACAT"	"CNT"
"TATTGCTAGTGCACCC"	"PT_2"
"TATTGCTCACTGTTCC"	"DCT_1"
"TATTGCTCAGAGAATT"	"PT_2"
"TATTGCTCAGTCGGTC"	"PT_1"
"TATTGCTGTGCACGCT"	"PT_1"
"TATTGCTGTGTCTTGA"	"CNT"
"TATTGCTTCAAGCCTA"	"iPT"
"TATTGCTTCCCAGTGG"	"CNT"
"TATTGGGAGGCTTAGG"	"CNT"
"TATTGGGAGTCATAGA"	"PT_1"
"TATTGGGCATAATGCC"	"PT_2"
"TATTGGGCATTCGGGC"	"EC-PTC"
"TATTGGGGTACCACGC"	"POD"
"TATTGGGGTGTGAATA"	"iPT"
"TATTGGGGTTAGGACG"	"PEC"
"TATTGGGTCGCCAATA"	"IC-A1_2"
"TATTGGGTCTTTGATC"	"DCT_1"
"TATTTCGAGCGAAACC"	"iPT"
"TATTTCGAGTGGCGAT"	"DCT_1"
"TATTTCGAGTTTCGGT"	"TAL"
"TATTTCGGTGAGAACC"	"CNT"
"TATTTCGGTGAGATTA"	"DCT_1"
"TATTTCGTCATGCCCT"	"iPT"
"TATTTCGTCCGCAGTG"	"TAL"
"TATTTCGTCGGTAGAG"	"PEC"
"TCAAGACAGGTAAACT"	"iPT"
"TCAAGACGTCTACGTA"	"PT_1"
"TCAAGACGTGACACAG"	"DCT_1"
"TCAAGACGTTATGACC"	"iPT"
"TCAAGACGTTCAGCTA"	"PT_1"
"TCAAGACGTTCGTTCC"	"PT_2"
"TCAAGACTCCTCGATC"	"PT_1"
"TCAAGCAAGAGTTCGG"	"EC-PTC"
"TCAAGCAAGCATGTTC"	"IC-A1_2"
"TCAAGCAAGCCTTTCC"	"PT_2"
"TCAAGCACAGCCTTCT"	"PT_1"
"TCAAGCAGTAGTACGG"	"DCT_1"
"TCAAGCAGTCTTTCTA"	"DCT_1"
"TCAAGTGAGACAGTCG"	"DCT_1"
"TCAAGTGAGTAAGAGG"	"PT_1"
"TCAAGTGAGTGAATAC"	"IC-A1_2"
"TCAAGTGCAACCGTAT"	"DCT_1"
"TCAAGTGCAATAGGAT"	"GC-EC"
"TCAAGTGCACCTCGTT"	"GC-EC"
"TCAAGTGGTCGAGTTT"	"PT_1"
"TCAAGTGGTTTAGAGA"	"PT_1"
"TCAAGTGTCAAAGAAC"	"CNT"
"TCAAGTGTCTCCAATT"	"GC-EC"
"TCAATCTAGCGGACAT"	"EC-PTC"
"TCAATCTCAATGTCTG"	"PT_1"
"TCAATCTCACGCAGTC"	"iPT"
"TCAATCTCACTAACGT"	"IC-A1_1"
"TCAATCTCACTGCACG"	"PT_2"
"TCAATCTCAGCTCTGG"	"TAL"
"TCAATCTCAGGTGTTT"	"IC-A1_1"
"TCAATCTGTATTTCTC"	"DCT_1"
"TCAATCTGTCAACCAT"	"CNT"
"TCAATCTGTGGATCAG"	"GC-EC"
"TCAATCTGTTTGCCGG"	"PT_1"
"TCAATCTTCCTAGCCT"	"TAL"
"TCAATCTTCGGTTGTA"	"iPT"
"TCAATCTTCTTCGCTG"	"PT_1"
"TCAATTCAGAAATGGG"	"GC-EC"
"TCAATTCAGTCATTGC"	"PT_2"
"TCAATTCCACAAAGCG"	"PT_1"
"TCAATTCGTTCCAGGC"	"EC-PTC"
"TCAATTCTCAATCGGT"	"PT_1"
"TCAATTCTCACAACCA"	"PT_1"
"TCAATTCTCCATCAGA"	"MC"
"TCACAAGCAGGGACTA"	"DCT_1"
"TCACAAGGTCCTGAAT"	"PT_1"
"TCACAAGTCAATGCAC"	"IC-A1_1"
"TCACAAGTCGCAGTCG"	"TAL"
"TCACACCAGGTAGGCT"	"PT_1"
"TCACACCCACGTACTA"	"TAL"
"TCACACCGTAGGAGGG"	"DCT_1"
"TCACACCGTGATTAGA"	"TAL"
"TCACATTAGGAAGTCC"	"DCT_1"
"TCACATTAGGTGCCTC"	"PT_2"
"TCACATTTCACCTACC"	"T-cell"
"TCACATTTCGAGATGG"	"DCT_1"
"TCACGCTAGAGGTGCT"	"CNT"
"TCACGCTAGCCTGAAG"	"DCT_1"
"TCACGCTAGCGTCGAA"	"EC-PTC"
"TCACGCTCAGTGCCTG"	"CNT"
"TCACGCTCATTAGGCT"	"CNT"
"TCACGCTTCGCTAAAC"	"PT_1"
"TCACGCTTCGGCTGAC"	"DCT_1"
"TCACGGGAGGAATCGC"	"IC-A1_1"
"TCACGGGCAGCACAGA"	"GC-EC"
"TCACGGGTCAATCAGC"	"IC-A1_1"
"TCACGGGTCCACCCTA"	"DCT_1"
"TCACGGGTCCTCACTG"	"PT_2"
"TCACGGGTCTAAACGC"	"PT_1"
"TCACGGGTCTCTGCCA"	"IC-A1_1"
"TCACTATAGCTAATGA"	"POD"
"TCACTATAGGCTTAGG"	"PT_1"
"TCACTATCAACACGTT"	"CNT"
"TCACTATGTACTCCCT"	"CNT"
"TCACTATGTCATCCCT"	"CNT"
"TCACTATGTCCGAAGA"	"PT_1"
"TCACTATGTTGTCATG"	"GC-EC"
"TCACTATGTTGTGCAT"	"PT_2"
"TCACTATTCGATTGAC"	"EC-PTC"
"TCACTATTCTCTTCAA"	"PT_2"
"TCACTCGAGAGCGACT"	"PT_2"
"TCACTCGCATTCTTCA"	"PT_1"
"TCACTCGGTACGGCAA"	"DCT_1"
"TCACTCGGTGAGATAT"	"CNT"
"TCACTCGTCCTCACTG"	"TAL"
"TCACTCGTCGTTCTAT"	"PT_1"
"TCAGCAACAAAGCGTG"	"EC-PTC"
"TCAGCAACACGGGTAA"	"DCT_1"
"TCAGCAACAGCTCTGG"	"CNT"
"TCAGCAACAGCTGAAG"	"PT_1"
"TCAGCAAGTAATGCTC"	"IC-A1_1"
"TCAGCAAGTAGAGCTG"	"PT_2"
"TCAGCAATCACACCGG"	"CNT"
"TCAGCAATCTCCTGCA"	"PT_2"
"TCAGCCTAGACATAAC"	"DCT_1"
"TCAGCCTCAGAAGTTA"	"CNT"
"TCAGCCTCAGGATCTT"	"PT_1"
"TCAGCCTGTAGACAGC"	"PT_2"
"TCAGCCTGTGTCATTG"	"PEC"
"TCAGCCTTCATTCATC"	"TAL"
"TCAGCCTTCGCGGTAC"	"PT_1"
"TCAGCCTTCTAACGGT"	"PT_2"
"TCAGGGCAGCATGAAT"	"DCT_1"
"TCAGGGCAGTTAGTGA"	"PT_1"
"TCAGGGCCAGAATGTA"	"PT_1"
"TCAGGGCGTGCCTAAT"	"GC-EC"
"TCAGGGCGTTACGGAG"	"MC"
"TCAGGGCGTTCTGAGT"	"PT_2"
"TCAGGGCTCTAACGCA"	"CNT"
"TCAGGGCTCTTCCGTG"	"DCT_1"
"TCAGGTAAGAATTCAG"	"GC-EC"
"TCAGGTAAGACATCCT"	"PT_1"
"TCAGGTAAGACTTGTC"	"POD"
"TCAGTCCAGGCCCAAA"	"IC-A1_1"
"TCAGTCCCACCGGTCA"	"PT_1"
"TCAGTCCCATTCAGGT"	"PT_1"
"TCAGTCCTCATCTCTA"	"EC-PTC"
"TCAGTCCTCTTTCCAA"	"PT_1"
"TCAGTGAAGGCTAACG"	"GC-EC"
"TCAGTGAAGGGTGGGA"	"iPT"
"TCAGTGAAGGTTCACT"	"CNT"
"TCAGTGACAAACGTGG"	"PT_2"
"TCAGTGACAAATGGTA"	"CNT"
"TCAGTGACATCGAGCC"	"CNT"
"TCAGTGACATTGACCA"	"PT_2"
"TCAGTGAGTAAGCAAT"	"PT_2"
"TCAGTGAGTCCGGTGT"	"iPT"
"TCAGTGAGTTGCACGC"	"PT_1"
"TCAGTGATCGCAAGAG"	"DCT_1"
"TCAGTTTCATTCTCTA"	"PT_1"
"TCAGTTTGTAACCCTA"	"PT_1"
"TCAGTTTGTATCGTGT"	"PT_2"
"TCAGTTTTCTCTGCCA"	"PT_1"
"TCATACTAGGATTTGA"	"PT_2"
"TCATACTAGGGAGTGG"	"IC-A1_1"
"TCATACTAGTGGATAT"	"PT_2"
"TCATACTCAAAGGAGA"	"GC-EC"
"TCATACTGTGCAAGAC"	"PT_1"
"TCATACTGTGCCCAGT"	"CNT"
"TCATACTGTGCGTTTA"	"PT_1"
"TCATACTGTTCTGAGT"	"PT_1"
"TCATACTTCGAGAAGC"	"PT_1"
"TCATATCAGTACAGAT"	"DCT_1"
"TCATATCCAAATCCCA"	"PT_2"
"TCATATCCAGCATACT"	"CNT"
"TCATATCCATTCACAG"	"PT_1"
"TCATATCGTTGCGTAT"	"EC-PTC"
"TCATATCTCAAATGCC"	"EC-PTC"
"TCATCATAGCGTTAGG"	"PT_1"
"TCATCATAGTGAGCCA"	"PT_1"
"TCATCATCAAGTGGCA"	"IC-A1_1"
"TCATCATCACGATAGG"	"IC-A1_1"
"TCATCATGTGCGCTCA"	"PT_1"
"TCATCATTCAGGAGAC"	"CNT"
"TCATCATTCGCCCAGA"	"PT_2"
"TCATCATTCTGCTGAA"	"PT_2"
"TCATCATTCTTCCACG"	"PT_2"
"TCATCCGAGCACAAAT"	"PT_1"
"TCATCCGAGCGTCTGC"	"TAL"
"TCATCCGAGGGACAGG"	"GC-EC"
"TCATCCGCACAAGTTC"	"iPT"
"TCATCCGCACTTCAAG"	"DCT_1"
"TCATCCGGTCTTGGTA"	"CNT"
"TCATGAGCAACGGTAG"	"POD"
"TCATGAGGTCCAAATC"	"PT_1"
"TCATGAGTCAAACCCA"	"DCT_1"
"TCATGAGTCTCTCGAC"	"IC-A1_1"
"TCATGCCAGGCTAACG"	"PT_1"
"TCATGCCAGTGATTCC"	"EC-PTC"
"TCATGCCCAGCCGTTG"	"CNT"
"TCATGCCGTTCCTAAG"	"CNT"
"TCATGCCTCGCTGTTC"	"POD"
"TCATGCCTCGGCCTTT"	"iPT"
"TCATGGAAGACAGCTG"	"PT_1"
"TCATGGAAGAGTATAC"	"PT_2"
"TCATGGACAAATTAGG"	"TAL"
"TCATGGACAGAACATA"	"PT_1"
"TCATGGACATAGATGA"	"PT_1"
"TCATGGACATGATGCT"	"DCT_2"
"TCATGGATCTTCACAT"	"PT_2"
"TCATGTTAGGGATGTC"	"CNT"
"TCATGTTAGTAGGAAG"	"EC-PTC"
"TCATGTTGTCGACTTA"	"IC-A1_1"
"TCATGTTTCAGAGCGA"	"PT_1"
"TCATGTTTCATTACCT"	"PT_2"
"TCATTACAGGAGTATT"	"EC-PTC"
"TCATTACCAGAGAATT"	"PT_1"
"TCATTACCAGGTGGAT"	"PT_2"
"TCATTACCATCGAGCC"	"EC-PTC"
"TCATTACCATTGGGAG"	"POD"
"TCATTACGTAGGTCAG"	"DCT_1"
"TCATTACGTCGTTGGC"	"PT_2"
"TCATTACTCGAACCTA"	"PT_1"
"TCATTCAAGTTAGTAG"	"PT_2"
"TCATTCACAACAGTGG"	"EC-PTC"
"TCATTCACAAGGCCTC"	"PT_1"
"TCATTCACATCGTGGC"	"EC-PTC"
"TCATTCATCGACACCG"	"DCT_1"
"TCATTGTAGGTTCACT"	"PT_2"
"TCATTGTGTAACTTCG"	"DCT_1"
"TCATTGTGTCAACGCC"	"EC-PTC"
"TCATTGTGTCTGCATA"	"PT_1"
"TCATTGTGTTCTCAGA"	"DCT_1"
"TCATTGTTCAGTGCGC"	"DCT_1"
"TCATTGTTCGACGCTG"	"PT_1"
"TCATTTGAGGAGTATT"	"PT_1"
"TCATTTGAGTGCTCAT"	"GC-EC"
"TCATTTGCAGGTTCGC"	"EC-PTC"
"TCATTTGGTACGGTTT"	"PT_1"
"TCATTTGGTGAATAAC"	"PT_1"
"TCATTTGGTGTTCAGT"	"DCT_1"
"TCATTTGTCCTAGCTC"	"TAL"
"TCATTTGTCGACATAC"	"PT_2"
"TCATTTGTCGCCGAAC"	"PT_2"
"TCCACCACAAGAGTTA"	"IC-A1_1"
"TCCACCACACACGGTC"	"DCT_1"
"TCCACCAGTCCTGGTG"	"PT_2"
"TCCACCAGTTAAGACA"	"PT_1"
"TCCACCAGTTGTCCCT"	"GC-EC"
"TCCACCATCAGAGTTC"	"PT_1"
"TCCACCATCCACAAGT"	"iPT"
"TCCACGTAGTTCATCG"	"IC-A1_1"
"TCCACGTCAACCGCTG"	"EC-PTC"
"TCCACGTGTTGTGTAC"	"GC-EC"
"TCCACGTTCCCATTTA"	"iPT"
"TCCACGTTCGCCACTT"	"PT_1"
"TCCAGAAAGACTCATC"	"CNT"
"TCCAGAAAGATTGACA"	"PT_1"
"TCCAGAAGTTCGAACT"	"PT_1"
"TCCAGAAGTTTACCAG"	"iPT"
"TCCATCGAGAGTCTTC"	"PT_1"
"TCCATCGTCAAGAATG"	"PT_2"
"TCCATGCGTAGGTGCA"	"TAL"
"TCCATGCGTGTTAGCT"	"PT_1"
"TCCATGCTCAGTAGGG"	"TAL"
"TCCATGCTCTCCAAGA"	"PT_1"
"TCCATGCTCTTCTTCC"	"PT_2"
"TCCCACAAGCTCTGTA"	"IC-A1_1"
"TCCCACACACTTGACA"	"CNT"
"TCCCACACATGATGCT"	"DCT_1"
"TCCCACACATGTTCGA"	"PT_1"
"TCCCACAGTCCTGTTC"	"PT_1"
"TCCCACATCCACCTGT"	"PT_1"
"TCCCACATCCTAGCCT"	"CNT"
"TCCCAGTAGCTTAAGA"	"PT_1"
"TCCCAGTAGTAGCCAG"	"iPT"
"TCCCAGTGTCGACTTA"	"GC-EC"
"TCCCAGTGTGGCGTAA"	"DCT_1"
"TCCCAGTTCACCGACG"	"CNT"
"TCCCAGTTCAGGAACG"	"GC-EC"
"TCCCATGAGAACCCGA"	"DCT_1"
"TCCCATGAGAATTGTG"	"DCT_1"
"TCCCATGCACAAGCCC"	"PT_1"
"TCCCATGCACGGATCC"	"iPT"
"TCCCATGCACGGTGAA"	"CNT"
"TCCCATGCAGAGGCAT"	"DCT_1"
"TCCCATGGTCGTGTTA"	"IC-A1_1"
"TCCCATGTCGATCCCT"	"iPT"
"TCCGAAAAGTTGCGCC"	"PT_1"
"TCCGAAACAGTGGTGA"	"TAL"
"TCCGAAAGTGATACTC"	"CNT"
"TCCGAAAGTGGTTTGT"	"PEC"
"TCCGATCAGACGATAT"	"PT_1"
"TCCGATCAGATTGTGA"	"DCT_1"
"TCCGATCTCCAAGCAT"	"CNT"
"TCCGATCTCCACCTGT"	"CNT"
"TCCGGGAAGCTACTGT"	"EC-PTC"
"TCCGGGACACCTAAAC"	"PT_2"
"TCCGGGACATAAGCGG"	"CNT"
"TCCGGGACATGAAAGT"	"DCT_1"
"TCCGGGAGTGTATTCG"	"PT_2"
"TCCGGGAGTTATAGCC"	"DCT_1"
"TCCGGGATCTACCCAC"	"PT_1"
"TCCGGGATCTGGGATT"	"iPT"
"TCCGTGTCAAGAGCTG"	"DCT_1"
"TCCGTGTGTATCATGC"	"CNT"
"TCCGTGTGTCCCTAAA"	"PT_1"
"TCCGTGTTCGGTTGTA"	"PT_1"
"TCCTAATCACAACGTT"	"DCT_1"
"TCCTCCCAGCATCTTG"	"CNT"
"TCCTCCCCAGCACAGA"	"PT_1"
"TCCTCCCCAGGATCTT"	"CNT"
"TCCTCCCCAGGGCTTC"	"DCT_1"
"TCCTCCCCATTGTACG"	"DCT_1"
"TCCTCCCGTCCATAGT"	"PT_1"
"TCCTCGACACTGCATA"	"MC"
"TCCTCGACAGCTGTGC"	"PT_1"
"TCCTCGACATTCTGTT"	"EC-PTC"
"TCCTCGAGTTTACTTC"	"EC-PTC"
"TCCTCGATCAGGAGAC"	"PT_2"
"TCCTCGATCTGGGCAC"	"DCT_1"
"TCCTCGATCTTCTTCC"	"PT_2"
"TCCTCTTAGCCACTCG"	"PT_1"
"TCCTCTTAGGTTCCAT"	"DCT_1"
"TCCTCTTCATGGCCAC"	"IC-A1_1"
"TCCTCTTGTACGTAGG"	"PT_1"
"TCCTCTTGTCAAACGG"	"PT_2"
"TCCTCTTGTTCGAAGG"	"PT_1"
"TCCTCTTGTTGCTTGA"	"PT_1"
"TCCTCTTTCCGACATA"	"PT_2"
"TCCTCTTTCGTAATGC"	"IC-A1_1"
"TCCTCTTTCTAGCCAA"	"PT_1"
"TCCTGCAAGTCGGCAA"	"EC-PTC"
"TCCTGCACAGACCTAT"	"PT_1"
"TCCTGCACAGGATGAC"	"PT_1"
"TCCTGCAGTAAGATCA"	"DCT_1"
"TCCTGCATCCCAACTC"	"PT_2"
"TCCTGCATCGAGAACG"	"CNT"
"TCCTTCTCAACCGCTG"	"EC-PTC"
"TCCTTCTCACGACAGA"	"IC-A1_1"
"TCCTTCTGTAATGTGA"	"TAL"
"TCCTTCTTCCATATGG"	"PT_1"
"TCCTTCTTCGAATCCA"	"IC-A1_1"
"TCCTTCTTCTCAGGCG"	"IC-A1_2"
"TCCTTTCAGATCGACG"	"GC-EC"
"TCCTTTCAGTATGTAG"	"TAL"
"TCCTTTCCAATTGGTC"	"PT_1"
"TCCTTTCCAGTAGTGG"	"PT_1"
"TCCTTTCGTCATGCAT"	"EC-PTC"
"TCCTTTCGTCGATTCA"	"MC"
"TCCTTTCTCAGCTGTA"	"GC-EC"
"TCCTTTCTCCATTCAT"	"TAL"
"TCGAACAAGAGTAACT"	"iPT"
"TCGAACACAGCGTTTA"	"EC-PTC"
"TCGAACACATGGGCAA"	"DCT_1"
"TCGAACAGTAGGAAAG"	"GC-EC"
"TCGAACATCATTGGTG"	"IC-A1_1"
"TCGAACATCGACACTA"	"IC-A1_1"
"TCGAACATCTCAGTCC"	"EC-PTC"
"TCGAAGTCAATCGCCG"	"PT_1"
"TCGAAGTCAGCGGATA"	"CNT"
"TCGAAGTGTTCGGACC"	"PT_2"
"TCGAAGTTCATCACTT"	"CNT"
"TCGAAGTTCATTTCCA"	"DCT_1"
"TCGACCTAGTAGGAAG"	"T-cell"
"TCGACCTCAGCTAACT"	"PT_1"
"TCGACCTCATCATTGG"	"EC-PTC"
"TCGACCTGTGAATATG"	"PEC"
"TCGACCTTCAATCCGA"	"PT_2"
"TCGACCTTCAGTGTTG"	"TAL"
"TCGACCTTCCACATAG"	"MC"
"TCGACCTTCCGTAATG"	"PT_1"
"TCGACCTTCTCGCTCA"	"PT_1"
"TCGACGGAGAGGCTGT"	"PT_2"
"TCGACGGGTCATCCGG"	"iPT"
"TCGACGGGTGGCTCTG"	"PT_1"
"TCGACGGGTTCAGGTT"	"PT_2"
"TCGACGGTCGACACTA"	"MC"
"TCGATTTAGACGACTG"	"DCT_1"
"TCGATTTCATGCCGAC"	"PT_1"
"TCGATTTGTCACCACG"	"PT_2"
"TCGATTTGTGACTCGC"	"PT_1"
"TCGATTTGTTCCTAGA"	"iPT"
"TCGATTTTCGATTGGT"	"CNT"
"TCGATTTTCTACCTTA"	"PT_2"
"TCGCACTAGATCCGAG"	"CNT"
"TCGCACTAGCGTGTTT"	"IC-A1_1"
"TCGCACTCAATCCTTT"	"CNT"
"TCGCACTCACTGTGTA"	"CNT"
"TCGCACTCAGCGTTTA"	"CNT"
"TCGCACTCATTCATCT"	"PT_1"
"TCGCACTGTACGCTAT"	"PT_1"
"TCGCACTGTCGCGGTT"	"PT_2"
"TCGCACTGTTAAGCAA"	"PT_1"
"TCGCACTGTTCCAAAC"	"CNT"
"TCGCACTTCGATTTCT"	"PT_2"
"TCGCAGGCAGTGGTGA"	"PT_1"
"TCGCAGGTCTCCCTAG"	"TAL"
"TCGCTCAAGCAACAAT"	"EC-PTC"
"TCGCTCACATCTTCGC"	"iPT"
"TCGCTCAGTTCGTAAC"	"POD"
"TCGCTCATCATCGGGC"	"EC-PTC"
"TCGCTCATCCCAGGCA"	"DCT_1"
"TCGCTTGAGGATTTGA"	"DCT_1"
"TCGCTTGGTAGCCCTG"	"IC-A1_2"
"TCGCTTGGTCAGGTGA"	"PT_2"
"TCGCTTGTCAACGAGG"	"PT_1"
"TCGCTTGTCCGGCAGT"	"CNT"
"TCGCTTGTCTAGTGTG"	"PT_2"
"TCGGATAAGGTAAGTT"	"DCT_1"
"TCGGATAAGGTATCTC"	"DCT_2"
"TCGGATAGTATGGGAC"	"PT_1"
"TCGGATAGTCATAAAG"	"CNT"
"TCGGATAGTTATCCAG"	"PT_2"
"TCGGATATCCATAAGC"	"PT_1"
"TCGGGACAGGACGGAG"	"DCT_1"
"TCGGGACCATGGAGAC"	"CNT"
"TCGGGACGTAGACGGT"	"PT_1"
"TCGGGACGTGTTAACC"	"PT_1"
"TCGGGCAAGCTACGTT"	"CNT"
"TCGGGCAAGGCGTTAG"	"IC-A1_1"
"TCGGGCAAGTGTAGAT"	"DCT_1"
"TCGGGCAGTTGAGGAC"	"iPT"
"TCGGGCATCGACGTCG"	"PT_2"
"TCGGGCATCTGATGGT"	"GC-EC"
"TCGGGCATCTGTAACG"	"CNT"
"TCGGGTGAGAGAGCGG"	"CNT"
"TCGGGTGAGCAACCAG"	"PT_2"
"TCGGGTGAGGTGCATG"	"POD"
"TCGGGTGCAAGCGGAT"	"PT_1"
"TCGGGTGCACGTAGAG"	"DCT_1"
"TCGGGTGTCATTCGTT"	"EC-PTC"
"TCGGGTGTCGTGGCTG"	"T-cell"
"TCGGTCTAGCTAATGA"	"POD"
"TCGGTCTGTAGAGTTA"	"DCT_1"
"TCGGTCTGTAGGTCAG"	"EC-PTC"
"TCGGTCTGTCAGCGTC"	"PT_1"
"TCGGTCTTCCTACGGG"	"DCT_1"
"TCGTAGACATGTTCAG"	"PT_2"
"TCGTAGAGTCCACTCT"	"TAL"
"TCGTAGATCCATCAGA"	"PT_1"
"TCGTAGATCCGTGTAA"	"EC-PTC"
"TCGTCCAAGGCGAACT"	"PT_2"
"TCGTCCAAGTATGAGT"	"PT_2"
"TCGTCCACACGCGTGT"	"iPT"
"TCGTCCACATCGGAGA"	"TAL"
"TCGTCCAGTCGGAACA"	"IC-A1_1"
"TCGTCCAGTGCTTATG"	"CNT"
"TCGTCCATCAACGAGG"	"PT_1"
"TCGTCCATCTGTGCGG"	"CNT"
"TCGTGCTCAATCCTTT"	"DCT_1"
"TCGTGCTCACGATTCA"	"CNT"
"TCGTGCTCAGGCGAAT"	"DCT_1"
"TCGTGCTTCGGCGATC"	"PT_1"
"TCGTGGGAGAGTGTGC"	"CNT"
"TCGTGGGCACGACTAT"	"IC-A1_1"
"TCGTGGGCAGAACCGA"	"CNT"
"TCGTGGGGTATGAGCG"	"GC-EC"
"TCGTGGGTCTCCGTGT"	"PT_1"
"TCTAACTAGCGTCAAG"	"PT_1"
"TCTAACTAGTCAACAA"	"CNT"
"TCTAACTCAAGGTCGA"	"PT_1"
"TCTAACTCAGACTGCC"	"EC-PTC"
"TCTAACTCATAGAGGC"	"CNT"
"TCTAACTCATCATTTC"	"GC-EC"
"TCTAACTCATGACCCG"	"IC-A1_1"
"TCTAACTGTCCGAAAG"	"iPT"
"TCTAACTGTGGGTTGA"	"TAL"
"TCTAACTTCCGACATA"	"PT_1"
"TCTAACTTCCGTTGGG"	"IC-A1_1"
"TCTACATAGACTTAAG"	"PT_2"
"TCTACATAGTGTAGTA"	"PT_1"
"TCTACATGTAGCTGCC"	"TAL"
"TCTACATGTCTGCATA"	"CNT"
"TCTACATGTGAATTAG"	"PT_1"
"TCTACATGTGCTCTTC"	"PT_2"
"TCTACATTCCGTACGG"	"PT_2"
"TCTACATTCTCCCATG"	"PT_1"
"TCTACATTCTGACAGT"	"iPT"
"TCTACCGAGCGATCGA"	"PT_2"
"TCTACCGAGCTGACCC"	"TAL"
"TCTACCGCAAATACAG"	"GC-EC"
"TCTACCGCACGACGTC"	"TAL"
"TCTATACAGGCATCTT"	"PT_1"
"TCTATACCAGACCAGA"	"CNT"
"TCTATACCATGGTGGA"	"DCT_1"
"TCTATACGTCCACTTC"	"PEC"
"TCTATACTCATTGCTT"	"DCT_1"
"TCTATACTCGTTAGTG"	"DCT_1"
"TCTATACTCTTTGATC"	"PT_2"
"TCTATCAAGGCCTAAG"	"PT_2"
"TCTATCACAATTGCCA"	"CNT"
"TCTATCACATATGCGT"	"TAL"
"TCTATCAGTCAGGCAA"	"PT_1"
"TCTCACGAGGTTGACG"	"TAL"
"TCTCACGCACATTCGA"	"PT_2"
"TCTCACGCAGAGCGTA"	"IC-A1_1"
"TCTCACGCAGCCCAGT"	"CNT"
"TCTCACGCAGCTATAC"	"EC-PTC"
"TCTCACGGTAGCACAG"	"PT_2"
"TCTCACGGTCCTACGG"	"PT_1"
"TCTCACGGTGTGGTCC"	"TAL"
"TCTCACGGTTGCCATA"	"IC-A1_1"
"TCTCACGTCGGTGTTA"	"DCT_1"
"TCTCAGCAGCACCGAA"	"iPT"
"TCTCAGCAGGTTGTTC"	"IC-A1_2"
"TCTCAGCAGTCGCCCA"	"PT_2"
"TCTCAGCCACTGGACC"	"CNT"
"TCTCAGCTCAGGTAAA"	"CNT"
"TCTCAGCTCGAGTGAG"	"PT_1"
"TCTCCGAAGCGTTACT"	"DCT_1"
"TCTCCGACAGTTGTTG"	"CNT"
"TCTCCGAGTATCAGCT"	"CNT"
"TCTCCGATCCATCAGA"	"DCT_1"
"TCTCCGATCTAGTTCT"	"DCT_1"
"TCTCCGATCTATGTGG"	"PT_1"
"TCTCTGGAGAATTGTG"	"PT_1"
"TCTCTGGAGCATGAAT"	"PT_1"
"TCTCTGGCAAGCAATA"	"IC-A1_1"
"TCTCTGGCACAGCCAC"	"DCT_1"
"TCTCTGGCAGGAGGTT"	"PT_1"
"TCTGCCAAGACATAGT"	"IC-A1_1"
"TCTGCCACATCTATCT"	"CNT"
"TCTGCCAGTGATGGCA"	"TAL"
"TCTGCCAGTGTACATC"	"CNT"
"TCTGCCATCAGAGCGA"	"PT_1"
"TCTGGCTAGGTCGTGA"	"PT_1"
"TCTGGCTCATAGGAGC"	"CNT"
"TCTGGCTGTTGCCATA"	"PT_1"
"TCTGGCTGTTGCGTAT"	"TAL"
"TCTGGCTTCTTCTCAA"	"PT_1"
"TCTGTCGCAGGTATGG"	"DCT_1"
"TCTGTCGGTGCATCTA"	"PT_1"
"TCTGTCGTCGAACCTA"	"EC-PTC"
"TCTGTCGTCTGTTCAT"	"CNT"
"TCTTAGTAGAACTTCC"	"PT_2"
"TCTTAGTCAACTGTGT"	"EC-PTC"
"TCTTAGTCACGCGGTT"	"DCT_1"
"TCTTAGTCATAGAATG"	"PT_2"
"TCTTAGTGTAGTGCGA"	"CNT"
"TCTTAGTGTCTGTGAT"	"PT_1"
"TCTTAGTGTGGGACAT"	"EC-PTC"
"TCTTAGTTCTACGGTA"	"PT_1"
"TCTTCCTAGTGGACTG"	"EC-PTC"
"TCTTCCTCAAGAATAC"	"GC-EC"
"TCTTCCTCACCCTATC"	"GC-EC"
"TCTTCCTCAGAATTCC"	"DCT_1"
"TCTTCCTGTACGGCAA"	"PT_2"
"TCTTCCTTCCTGATAG"	"iPT"
"TCTTCCTTCGAGAGAC"	"CNT"
"TCTTCCTTCGCTACAA"	"DCT_1"
"TCTTCCTTCGTTGTAG"	"PT_2"
"TCTTGCGAGACATCCT"	"DCT_1"
"TCTTGCGCAGGAGACT"	"DCT_1"
"TCTTGCGGTCTAGGCC"	"CNT"
"TCTTGCGTCTGGGCGT"	"PT_1"
"TCTTTGAAGAATTCAG"	"IC-A1_1"
"TCTTTGAAGCATTGAA"	"PT_2"
"TCTTTGAAGCTAGCCC"	"PT_1"
"TCTTTGAGTACTGTTG"	"EC-PTC"
"TCTTTGAGTTGTAGCT"	"CNT"
"TCTTTGATCGATCCAA"	"iPT"
"TGAACGTCAAAGCTAA"	"EC-PTC"
"TGAACGTCAAATACGA"	"IC-A1_1"
"TGAACGTCATCCGCGA"	"EC-PTC"
"TGAACGTGTAGCGTTT"	"POD"
"TGAACGTGTGATACCT"	"IC-A1_1"
"TGAACGTGTGGCCCAT"	"DCT_1"
"TGAATCGAGGAACGAA"	"PT_1"
"TGAATCGGTCACTCGG"	"CNT"
"TGAATCGGTCGTCGGT"	"CNT"
"TGAATCGGTGCAATAA"	"IC-A1_1"
"TGAATCGTCATGGATC"	"iPT"
"TGAATGCAGAATCCCT"	"GC-EC"
"TGAATGCAGCCAGTAG"	"CNT"
"TGAATGCGTCCAGAAG"	"DCT_1"
"TGAATGCGTGATGAAT"	"IC-A1_1"
"TGAATGCGTGTAGTGG"	"PT_2"
"TGAATGCTCAATCCAG"	"TAL"
"TGAATGCTCATTCATC"	"PT_1"
"TGAATGCTCTCAGTCC"	"PEC"
"TGAATGCTCTCCACTG"	"GC-EC"
"TGACAGTAGTTCACTG"	"MC"
"TGACAGTCAAGGTCGA"	"PT_1"
"TGACAGTCAGGACTTT"	"PT_1"
"TGACAGTGTCGTCTCT"	"EC-PTC"
"TGACAGTTCAGACCTA"	"DCT_1"
"TGACCCTGTATCTCGA"	"PT_1"
"TGACCCTGTCTTGTCC"	"PT_2"
"TGACCCTTCGATACTG"	"CNT"
"TGACGCGAGTAAGAGG"	"GC-EC"
"TGACGCGCATCCTTGC"	"DCT_1"
"TGACGCGGTCCACATA"	"DCT_1"
"TGACGCGGTCCACTCT"	"GC-EC"
"TGACGCGGTTAAGTCC"	"DCT_1"
"TGACTCCAGACCTCAT"	"PT_2"
"TGACTCCAGCCTGGAA"	"DCT_1"
"TGACTCCAGGACGCTA"	"CNT"
"TGACTCCAGTTGCCCG"	"TAL"
"TGACTCCCACAACGTT"	"GC-EC"
"TGACTCCCACAAGCAG"	"POD"
"TGACTCCCAGAAACCG"	"EC-PTC"
"TGACTCCGTATGGAAT"	"DCT_1"
"TGACTCCGTCACCGCA"	"CNT"
"TGACTCCGTCGCATCG"	"iPT"
"TGACTCCGTTTGTGGT"	"PT_1"
"TGACTCCTCCAAACCA"	"EC-PTC"
"TGAGACTAGTTCATGC"	"EC-PTC"
"TGAGACTCAATTGAGA"	"IC-A1_1"
"TGAGACTCACCACTGG"	"PT_2"
"TGAGACTCAGACAAAT"	"POD"
"TGAGACTGTCAGATTC"	"EC-PTC"
"TGAGACTTCAAGGAGC"	"PT_2"
"TGAGACTTCGGTAGAG"	"PT_1"
"TGAGACTTCTTGGTCC"	"CNT"
"TGAGCATAGACTGGGT"	"PT_2"
"TGAGCATAGCAGTACG"	"PT_1"
"TGAGCATAGGTAAGAG"	"CNT"
"TGAGCATAGGTACAGC"	"TAL"
"TGAGCATCAATACCTG"	"PT_1"
"TGAGCATCAGACGATG"	"TAL"
"TGAGCATCAGCTCTGG"	"PT_2"
"TGAGCATGTGAGATTA"	"TAL"
"TGAGCATGTGTTAGCT"	"DCT_1"
"TGAGCGCCAAACCGGA"	"CNT"
"TGAGCGCCACCAGACC"	"PT_2"
"TGAGCGCGTAAGTAGT"	"EC-PTC"
"TGAGCGCTCTCCAATT"	"DCT_1"
"TGAGCGCTCTGACCCT"	"PT_1"
"TGAGGAGAGAGCAAGA"	"TAL"
"TGAGGAGAGCTAAGTA"	"PT_2"
"TGAGGAGAGGGTGAAA"	"PT_2"
"TGAGGAGAGGTCCGAA"	"DCT_1"
"TGAGGAGAGTGGTTCT"	"PT_1"
"TGAGGAGCAAGCGATG"	"CNT"
"TGAGGAGCAGCTCCTT"	"PT_1"
"TGAGGAGTCGAAGCCC"	"PT_2"
"TGAGGGAAGAGTGAAG"	"CNT"
"TGAGGGACAACCAATC"	"EC-PTC"
"TGAGGGATCAAACTGC"	"PT_1"
"TGAGGGATCGTGGCTG"	"IC-A1_1"
"TGAGGGATCTTGCGCT"	"DCT_1"
"TGAGGTTAGACTCAAA"	"DCT_1"
"TGAGGTTAGATCGCTT"	"PT_2"
"TGAGGTTAGGACAAGA"	"PT_2"
"TGAGGTTCAAATAGCA"	"PT_2"
"TGAGGTTCAATCCTAG"	"PT_1"
"TGAGGTTCATCCTTCG"	"TAL"
"TGAGGTTTCCATACAG"	"CNT"
"TGAGTCAGTGAGTAAT"	"DCT_1"
"TGAGTCATCTTAGCAG"	"PT_1"
"TGATCAGCAGGAACCA"	"PT_1"
"TGATCAGGTGATTCAC"	"PT_1"
"TGATCTTAGCGAAACC"	"IC-A1_1"
"TGATCTTAGTCTCTGA"	"EC-PTC"
"TGATCTTCAAACGAGC"	"DCT_1"
"TGATCTTCACTGAATC"	"PT_1"
"TGATCTTGTCACAGAG"	"GC-EC"
"TGATCTTTCTAATTCC"	"DCT_1"
"TGATGCACACTTCTCG"	"IC-A1_1"
"TGATGCACATGAGAAT"	"PT_2"
"TGATGCAGTCCCTGAG"	"PT_2"
"TGATGGTGTTTGGAGG"	"DCT_1"
"TGATGGTTCTGTCTCG"	"IC-A1_1"
"TGATTCTAGCTGACCC"	"CNT"
"TGATTCTCAAGGCAAC"	"PT_1"
"TGATTCTCACGTAACT"	"PT_1"
"TGATTCTCAGTTAGGG"	"PT_1"
"TGATTTCAGACGCCCT"	"PT_2"
"TGATTTCCATGGGAAC"	"PT_1"
"TGATTTCTCGCCAATA"	"PT_1"
"TGATTTCTCTTAGCTT"	"EC-PTC"
"TGCACGGCACTACCCT"	"PT_1"
"TGCACGGGTAGACGTG"	"PT_1"
"TGCACGGGTATCAGCT"	"DCT_1"
"TGCACGGTCCAATCCC"	"PT_2"
"TGCAGATAGACACACG"	"DCT_1"
"TGCAGATCACCATTCC"	"PT_2"
"TGCAGATCAGGTGGAT"	"PT_2"
"TGCAGATTCCCTCATG"	"PT_1"
"TGCAGATTCTCTCAAT"	"PT_2"
"TGCAGGCAGGTCCCGT"	"iPT"
"TGCAGGCCACTATGTG"	"iPT"
"TGCAGGCGTAAGATAC"	"PT_1"
"TGCAGGCGTCATAGTC"	"GC-EC"
"TGCAGGCGTCCTCAGG"	"POD"
"TGCAGGCGTTGGTAGG"	"PT_1"
"TGCAGGCTCGGACTTA"	"PT_1"
"TGCAGTAAGAAACCAT"	"PT_1"
"TGCAGTACACAGCCTG"	"EC-PTC"
"TGCAGTACATGCTGCG"	"PT_1"
"TGCAGTAGTATACCTG"	"DCT_1"
"TGCAGTATCATCACAG"	"TAL"
"TGCAGTATCTAAGCGT"	"PT_1"
"TGCATCCAGCATTTGC"	"DCT_1"
"TGCATCCAGCTCTTCC"	"PT_1"
"TGCATCCAGTGTACAA"	"DCT_1"
"TGCATCCCAAATTAGG"	"iPT"
"TGCATCCCAACTCCAA"	"TAL"
"TGCATCCGTACCTAAC"	"CNT"
"TGCATCCGTTAGGCCC"	"DCT_1"
"TGCATCCTCAGGAACG"	"CNT"
"TGCATCCTCTAGAGCT"	"PT_1"
"TGCATGAAGATCACTC"	"TAL"
"TGCATGACATTACTCT"	"GC-EC"
"TGCATGAGTCGAATTC"	"CNT"
"TGCATGAGTTTCACTT"	"TAL"
"TGCCGAGAGTGAGCCA"	"PT_1"
"TGCCGAGCAACATCGT"	"PT_1"
"TGCCGAGGTGCGGTAA"	"IC-A1_1"
"TGCCGAGTCCATCTGC"	"iPT"
"TGCCGAGTCGAACCTA"	"CNT"
"TGCGACGAGGTACATA"	"CNT"
"TGCGACGAGTCAGAGC"	"PT_1"
"TGCGACGAGTCGCCAC"	"PT_1"
"TGCGACGGTACGCGTC"	"EC-PTC"
"TGCGACGGTTGCGGCT"	"CNT"
"TGCGACGTCTCATGCC"	"PT_2"
"TGCGACGTCTCGCCTA"	"PT_1"
"TGCGATAAGTGCACTT"	"PT_2"
"TGCGATACAATAACGA"	"DCT_1"
"TGCGATAGTACGAAAT"	"PT_1"
"TGCGATAGTGACATCT"	"PT_1"
"TGCGATATCGGTGAAG"	"DCT_1"
"TGCGGCAGTCTGTGGC"	"DCT_1"
"TGCGGCAGTTTACCTT"	"POD"
"TGCGGCAGTTTGTTCT"	"T-cell"
"TGCGGCATCAGACCCG"	"PT_1"
"TGCGGCATCGGTGAAG"	"CNT"
"TGCGGCATCTAGTGAC"	"TAL"
"TGCGGGTAGCCTCATA"	"DCT_1"
"TGCGGGTAGGAGAGGC"	"DCT_1"
"TGCGGGTCACGACGTC"	"CNT"
"TGCGGGTCACGCACCA"	"PT_2"
"TGCGGGTCACTTCTCG"	"IC-A1_1"
"TGCGGGTGTAGTCGGA"	"IC-A1_1"
"TGCGGGTGTCTACGAT"	"PT_2"
"TGCGGGTGTTGACTAC"	"PT_1"
"TGCGGGTTCAGCTCTC"	"CNT"
"TGCGGGTTCGACCCAG"	"MC"
"TGCGGGTTCGACTCCT"	"PT_2"
"TGCTCCAAGCAGCCCT"	"PT_2"
"TGCTCCAAGTGATGGC"	"DCT_1"
"TGCTCCACAAGAGAGA"	"PT_1"
"TGCTCCATCGACGACC"	"CNT"
"TGCTCCATCTAGGAAA"	"TAL"
"TGCTCCATCTCGTGGG"	"EC-PTC"
"TGCTCGTCAACTCCAA"	"DCT_1"
"TGCTCGTCAAGAAACT"	"IC-A1_1"
"TGCTCGTCAGAGGTTG"	"GC-EC"
"TGCTCGTGTTGACGGA"	"IC-A1_1"
"TGCTCGTTCACCATGA"	"iPT"
"TGCTGAAAGGCCTAGA"	"DCT_1"
"TGCTGAAAGGGAGGTG"	"EC-PTC"
"TGCTGAAAGTGTACAA"	"CNT"
"TGCTGAACATCGTCCT"	"MC"
"TGCTGAATCCCTTGGT"	"PT_1"
"TGCTGAATCTCTGGTC"	"PT_1"
"TGCTGAATCTTCTTCC"	"GC-EC"
"TGCTTCGAGCCTTTGA"	"PT_2"
"TGCTTCGGTCACTACA"	"DCT_1"
"TGCTTCGTCGCTTGCT"	"DCT_1"
"TGCTTGCGTATGCGTT"	"CNT"
"TGCTTGCGTTCAGCTA"	"DCT_1"
"TGCTTGCGTTCTCCTG"	"DCT_1"
"TGGAACTCAACTCGAT"	"PT_1"
"TGGAACTCATTGCCTC"	"TAL"
"TGGAACTTCGATGGAG"	"CNT"
"TGGAGAGAGGCATCGA"	"CNT"
"TGGAGAGCAATTTCGG"	"PT_2"
"TGGAGAGTCGTGGGAA"	"iPT"
"TGGAGGAAGCCTTTGA"	"PT_2"
"TGGAGGAAGGTAGTCG"	"CNT"
"TGGAGGACACAACGTT"	"PT_2"
"TGGAGGATCACCTACC"	"PT_1"
"TGGATCAAGCTACAAA"	"PT_1"
"TGGATCACAATCTCTT"	"PT_2"
"TGGATCACACAGCCTG"	"TAL"
"TGGATCAGTAGGAGTC"	"CNT"
"TGGATCATCACCTGGG"	"PT_1"
"TGGATCATCCCATAGA"	"DCT_1"
"TGGATCATCCGCTGTT"	"DCT_1"
"TGGATCATCCGTGTGG"	"PT_1"
"TGGATCATCCTGGCTT"	"TAL"
"TGGATGTAGCGATCGA"	"CNT"
"TGGATGTAGGTGCTAG"	"EC-PTC"
"TGGATGTAGTAATTGG"	"PT_1"
"TGGATGTCATTAAGCC"	"PT_1"
"TGGATGTGTTTGTTGG"	"PT_1"
"TGGATGTTCTTCACAT"	"IC-A1_1"
"TGGCGTGAGCTTCGTA"	"DCT_1"
"TGGCGTGAGGCTTCCG"	"TAL"
"TGGCGTGCAACGGCTC"	"CNT"
"TGGCGTGCACATGAAA"	"PT_1"
"TGGCGTGCATGTGCCG"	"DCT_1"
"TGGCGTGCATTCACAG"	"IC-A1_1"
"TGGCGTGGTACTGCCG"	"IC-A1_1"
"TGGCGTGGTCGCAACC"	"PT_1"
"TGGCGTGTCACCTGTC"	"PT_1"
"TGGCGTGTCGTCTCAC"	"PT_2"
"TGGGAAGAGACTAGAT"	"PT_1"
"TGGGAAGAGTAACCTC"	"IC-A1_2"
"TGGGAAGCAGTCCGTG"	"DCT_1"
"TGGGAAGTCTGTCGTC"	"PT_2"
"TGGGAGAAGTGGAAAG"	"GC-EC"
"TGGGAGACAAGACAAT"	"CNT"
"TGGGAGACACAAGCCC"	"CNT"
"TGGGAGACATGACACT"	"EC-PTC"
"TGGGAGAGTTCGTACA"	"PT_1"
"TGGGAGATCCGGCAGT"	"PT_2"
"TGGGAGATCCTGTAAG"	"CNT"
"TGGGAGATCCTTCTAA"	"POD"
"TGGGAGATCGCACTCT"	"CNT"
"TGGGATTAGAGCAGCT"	"DCT_1"
"TGGGATTAGCCATCCG"	"TAL"
"TGGGATTCAGTTAGGG"	"PT_1"
"TGGGATTGTGAGATTA"	"GC-EC"
"TGGGATTGTGCACATT"	"PT_2"
"TGGGATTGTTCGAACT"	"GC-EC"
"TGGGATTTCACCCTTG"	"PT_1"
"TGGGATTTCTCCATAT"	"CNT"
"TGGGCGTAGCTTCGTA"	"CNT"
"TGGGCGTCACCGGTCA"	"TAL"
"TGGGCGTCAGCCATTA"	"EC-PTC"
"TGGGCGTGTCCGGCAT"	"CNT"
"TGGGCGTTCAAACTGC"	"CNT"
"TGGGCGTTCGTGGTAT"	"PT_1"
"TGGGCGTTCTTCACAT"	"TAL"
"TGGGCTGAGTCTAGCT"	"PT_2"
"TGGGCTGAGTTGAAAC"	"DCT_1"
"TGGGCTGCACACTGGC"	"PT_2"
"TGGGCTGCACGTTGGC"	"DCT_1"
"TGGGCTGGTAGACTGG"	"DCT_1"
"TGGGCTGGTAGGTTTC"	"PT_2"
"TGGGCTGTCACCGCTT"	"GC-EC"
"TGGGTTAAGGTCATAA"	"PT_2"
"TGGGTTAGTGCCGTAC"	"TAL"
"TGGGTTATCGAGGCAA"	"GC-EC"
"TGGGTTATCTGCACCT"	"CNT"
"TGGTACAAGAGGCGGA"	"PT_1"
"TGGTACACACATACGT"	"iPT"
"TGGTACACAGGATTCT"	"DCT_1"
"TGGTACATCTTCACGC"	"PT_1"
"TGGTACATCTTCTAAC"	"EC-PTC"
"TGGTAGTAGCTCCACG"	"iPT"
"TGGTAGTAGGTGCTTT"	"PT_2"
"TGGTAGTGTTAAACCC"	"PEC"
"TGGTAGTTCCAGCCTT"	"PT_1"
"TGGTGATCAATTGAGA"	"IC-A1_1"
"TGGTGATCACGATAGG"	"EC-PTC"
"TGGTGATCAGAGATGC"	"CNT"
"TGGTGATTCGGTCTGG"	"CNT"
"TGGTGATTCTCTATAC"	"CNT"
"TGGTTAGAGAATTGTG"	"CNT"
"TGGTTAGAGACGAGCT"	"TAL"
"TGGTTAGAGCTCAGAG"	"PT_2"
"TGGTTAGCAAGAAACT"	"CNT"
"TGGTTAGTCAAGTGTC"	"PT_2"
"TGGTTAGTCACGGACC"	"PT_2"
"TGGTTAGTCCGCTTAC"	"iPT"
"TGGTTAGTCCTACAAG"	"PT_2"
"TGGTTAGTCGCGATCG"	"CNT"
"TGTAACGCAAGAATAC"	"POD"
"TGTAACGCAATGTGGG"	"DCT_1"
"TGTAACGCAGTTTCAG"	"DCT_1"
"TGTAACGGTATCGTTG"	"PT_2"
"TGTAACGGTCGATTAC"	"PT_1"
"TGTAACGGTGCTCCGA"	"EC-PTC"
"TGTAACGGTTGGAGAC"	"CNT"
"TGTAACGTCACAAGAA"	"PT_1"
"TGTAACGTCTGCTTAT"	"iPT"
"TGTAAGCAGGATTACA"	"PT_1"
"TGTAAGCTCCATAGGT"	"PT_1"
"TGTAAGCTCCATGAGT"	"PT_1"
"TGTAAGCTCTAAGAAG"	"DCT_1"
"TGTACAGAGTTATGGA"	"CNT"
"TGTACAGCACCTGAAT"	"PT_1"
"TGTACAGCATACAGGG"	"TAL"
"TGTACAGGTGCTCTTC"	"DCT_1"
"TGTACAGTCCGAGCTG"	"CNT"
"TGTACAGTCTCTCGCA"	"PT_1"
"TGTAGACAGGTCTACT"	"DCT_1"
"TGTAGACAGTTAGTGA"	"DCT_1"
"TGTAGACCAAAGCACG"	"DCT_1"
"TGTAGACCACACCTAA"	"PT_2"
"TGTAGACCATGGTACT"	"MC"
"TGTAGACTCAGCCTTC"	"CNT"
"TGTAGACTCCCGAGAC"	"DCT_1"
"TGTAGACTCCGCAGTG"	"GC-EC"
"TGTAGACTCCTGGGTG"	"EC-PTC"
"TGTAGACTCTCTATAC"	"iPT"
"TGTCAGACAATTGCCA"	"DCT_1"
"TGTCAGACAGGCAATG"	"GC-EC"
"TGTCAGAGTACACGTT"	"iPT"
"TGTCCACCAAATGCGG"	"EC-PTC"
"TGTCCACGTTTGGAGG"	"EC-PTC"
"TGTCCACTCGCTATTT"	"DCT_1"
"TGTCCCAAGAAATCCA"	"CNT"
"TGTCCCAAGGAGACCT"	"DCT_1"
"TGTCCCAAGGAGGCAG"	"PT_1"
"TGTCCCAGTAGATTAG"	"PT_2"
"TGTCCCATCCGTGGGT"	"EC-PTC"
"TGTCCTGAGCACACAG"	"IC-A1_1"
"TGTCCTGAGTGCCGAA"	"CNT"
"TGTCCTGCACTTGAAC"	"IC-A1_2"
"TGTGAGTAGGCACCAA"	"PT_1"
"TGTGAGTCACTCAGAT"	"CNT"
"TGTGAGTTCACCATAG"	"PT_1"
"TGTGAGTTCCATAAGC"	"PT_1"
"TGTGAGTTCGCAGTCG"	"PT_1"
"TGTGAGTTCTGGTGCG"	"iPT"
"TGTGATGAGCCGGATA"	"GC-EC"
"TGTGATGAGGTAGATT"	"CNT"
"TGTGATGTCGAGAAGC"	"PT_1"
"TGTGATGTCTTTCGAT"	"GC-EC"
"TGTGCGGCACACCGCA"	"PT_1"
"TGTGCGGCATACTTTC"	"CNT"
"TGTGCGGCATAGGAGC"	"PT_1"
"TGTGCGGTCACCCTGT"	"CNT"
"TGTGCGGTCTAGGCAT"	"PT_1"
"TGTGGCGAGAAATCCA"	"GC-EC"
"TGTGGCGAGTGCCCGT"	"PT_2"
"TGTGGCGCAAGTGGAC"	"CNT"
"TGTGGCGCACCAGTAT"	"IC-A1_1"
"TGTGGCGCATCCAATG"	"PT_1"
"TGTGGCGGTAACACGG"	"DCT_1"
"TGTGGCGTCATCTACT"	"GC-EC"
"TGTGTGACACGGCTAC"	"TAL"
"TGTGTGACAGTTGCGC"	"DCT_1"
"TGTGTGAGTAGCTTGT"	"PT_2"
"TGTGTGATCCACGTAA"	"DCT_1"
"TGTTACTAGACGACGT"	"CNT"
"TGTTACTAGCGCCGTT"	"TAL"
"TGTTACTAGGACGCTA"	"PT_2"
"TGTTACTAGGTACCTT"	"CNT"
"TGTTACTCACTCCTTG"	"PT_2"
"TGTTACTTCCGAAGGA"	"PT_1"
"TGTTCATAGCTCCACG"	"CNT"
"TGTTCATGTACCCGAC"	"GC-EC"
"TGTTCATGTGTGAATA"	"IC-A1_1"
"TGTTCATGTTATGGTC"	"TAL"
"TGTTCCGAGAGAGTGA"	"IC-A1_1"
"TGTTCCGAGCTCCACG"	"DCT_1"
"TGTTCCGAGTGCTAGG"	"DCT_1"
"TGTTCCGGTGGCCCAT"	"GC-EC"
"TGTTCCGTCAAGTGGG"	"CNT"
"TGTTCCGTCAGAGTGG"	"PT_2"
"TGTTCCGTCATTACCT"	"DCT_1"
"TGTTCTAAGCACCGTC"	"CNT"
"TGTTCTAAGCTCCGAC"	"MC"
"TGTTCTACAAAGGTTA"	"PT_1"
"TGTTCTAGTAACTGCT"	"DCT_2"
"TGTTCTAGTTATGTGC"	"DCT_1"
"TGTTCTATCTTGGATG"	"IC-A1_1"
"TGTTGAGAGCGATCGA"	"GC-EC"
"TGTTGAGCAAATGGTA"	"PT_1"
"TGTTGAGCACTGCACG"	"PT_2"
"TGTTGAGGTACACGCC"	"PT_2"
"TGTTGAGTCTTCGTAT"	"DCT_1"
"TGTTGAGTCTTGGATG"	"CNT"
"TGTTGGAAGAAATTCG"	"PT_2"
"TGTTGGAAGGGACTGT"	"PT_2"
"TGTTGGACAATCACGT"	"PT_1"
"TGTTGGACATCGATGT"	"PT_2"
"TGTTGGAGTAGACACG"	"PT_1"
"TGTTGGAGTGCGGATA"	"PT_2"
"TGTTGGATCAGTCTTT"	"PT_2"
"TGTTGGATCATCTATC"	"TAL"
"TGTTTGTAGGTCTGGA"	"iPT"
"TGTTTGTAGTCTCGTA"	"PT_1"
"TGTTTGTGTGACTAAA"	"PT_2"
"TGTTTGTGTTCGTACA"	"CNT"
"TGTTTGTTCGGTCTAA"	"DCT_1"
"TGTTTGTTCTGGTGCG"	"PT_2"
"TTAATCCAGGACAAGA"	"DCT_1"
"TTAATCCAGGTAAAGG"	"DCT_1"
"TTAATCCCAACGATTC"	"PT_1"
"TTAATCCCAAGGTCGA"	"CNT"
"TTAATCCCAATCAGCT"	"DCT_1"
"TTAATCCGTGGTATGG"	"PT_1"
"TTAATCCGTTCGATTG"	"EC-PTC"
"TTAATCCGTTGGTAGG"	"CNT"
"TTAATCCTCCGAGATT"	"CNT"
"TTAATCCTCCTCACTG"	"PT_1"
"TTAATCCTCGCTCTCA"	"iPT"
"TTACAGGAGGCGTCCT"	"GC-EC"
"TTACAGGAGTTGGAGC"	"TAL"
"TTACAGGCAAAGACGC"	"EC-PTC"
"TTACAGGCATCGTGGC"	"DCT_1"
"TTACAGGGTCCCAAAT"	"PT_2"
"TTACAGGGTGAAAGTT"	"PT_2"
"TTACAGGGTGCGAGTA"	"DCT_1"
"TTACAGGGTTAGAAAC"	"GC-EC"
"TTACAGGTCAGCTAGT"	"PT_1"
"TTACAGGTCTCCCATG"	"PT_1"
"TTACAGGTCTGTCTCG"	"DCT_1"
"TTACCATAGAGGTTTA"	"PT_1"
"TTACCATAGCACTCGC"	"DCT_1"
"TTACCATGTAAGCTCT"	"EC-PTC"
"TTACCATGTATCTCTT"	"PT_2"
"TTACCATGTCATCACA"	"CNT"
"TTACCATGTGCGTGCT"	"CNT"
"TTACCATGTGTTGCCG"	"TAL"
"TTACCATTCTACGCAA"	"PT_1"
"TTACCGCAGACTTGTC"	"CNT"
"TTACCGCAGGGTGAAA"	"DCT_1"
"TTACCGCGTCGTAATC"	"DCT_1"
"TTACCGCGTGATACAA"	"PT_2"
"TTACCGCGTTATGTCG"	"IC-A1_1"
"TTACCGCGTTGGACCC"	"GC-EC"
"TTACCGCTCTTCCAGC"	"DCT_1"
"TTACGCCAGAGGGTGG"	"EC-PTC"
"TTACGCCCATGCACTA"	"DCT_1"
"TTACGCCGTATCGATC"	"PT_1"
"TTACGCCGTCGCAGTC"	"DCT_1"
"TTACGCCTCAAAGGAT"	"PT_1"
"TTACGCCTCGCCAACG"	"DCT_1"
"TTACGCCTCTGGGCCA"	"DCT_1"
"TTACGTTAGATGGCAC"	"PT_2"
"TTACGTTAGCATGATA"	"DCT_2"
"TTACGTTAGCTCTATG"	"CNT"
"TTACGTTAGGCCCACT"	"CNT"
"TTACGTTAGGCCTGAA"	"PT_1"
"TTACGTTAGGGCAGAG"	"PT_2"
"TTACGTTCAAACGTGG"	"PT_1"
"TTACGTTCAACTGCTA"	"CNT"
"TTACGTTCACGGGCTT"	"iPT"
"TTACGTTGTAGGTACG"	"IC-A1_2"
"TTACGTTGTCCAGCGT"	"PT_2"
"TTACGTTGTGCGTTTA"	"PEC"
"TTACGTTGTGGCTGCT"	"EC-PTC"
"TTACTGTAGTGCTAGG"	"PT_2"
"TTACTGTCATCAGCGC"	"PT_2"
"TTACTGTGTAGGAAAG"	"PT_1"
"TTACTGTGTATGATCC"	"IC-A1_1"
"TTACTGTGTGAGATCG"	"PT_1"
"TTACTGTGTTAACCTG"	"DCT_1"
"TTACTGTTCAGGGATG"	"PT_1"
"TTACTGTTCATAGAGA"	"TAL"
"TTACTGTTCGTGGCTG"	"PT_1"
"TTAGGCAAGACGGAAA"	"CNT"
"TTAGGCAAGGCTTCCG"	"PT_1"
"TTAGGCAAGTGCACCC"	"PT_1"
"TTAGGCAGTCCAATCA"	"IC-A1_1"
"TTAGGCATCACAGAGG"	"CNT"
"TTAGGCATCTCAATCT"	"PT_1"
"TTAGGGTAGACTCGAG"	"PT_1"
"TTAGGGTAGGATCATA"	"PT_1"
"TTAGGGTAGGTTAGTA"	"GC-EC"
"TTAGGGTCATGAGATA"	"TAL"
"TTAGGGTGTAGCTAAA"	"CNT"
"TTAGGGTGTCAAAGTA"	"PT_1"
"TTAGGGTTCAGAATAG"	"DCT_1"
"TTAGGGTTCCGGCAGT"	"DCT_1"
"TTAGGGTTCCTTCTGG"	"TAL"
"TTAGGGTTCTGTCCCA"	"DCT_1"
"TTAGTCTAGGGACCAT"	"DCT_1"
"TTAGTCTAGGTCCAGA"	"TAL"
"TTAGTCTCAAGTAGTA"	"iPT"
"TTAGTCTCAGGTGTGA"	"PT_1"
"TTAGTCTCATGGACAG"	"CNT"
"TTAGTCTGTCTCAAGT"	"PT_1"
"TTAGTCTTCAGGTGTT"	"PT_1"
"TTAGTCTTCCATCGTC"	"PT_2"
"TTATTGCAGAGGTTAT"	"CNT"
"TTATTGCAGCCATATC"	"PT_2"
"TTATTGCAGGCAGGTT"	"CNT"
"TTATTGCAGGTCTGGA"	"DCT_1"
"TTATTGCCACAGTACT"	"iPT"
"TTATTGCCAGTTTGGT"	"GC-EC"
"TTATTGCCATGACACT"	"TAL"
"TTCAATCCAATACAGA"	"TAL"
"TTCAATCCAATAGGAT"	"EC-PTC"
"TTCAATCCAGGACTAG"	"IC-A1_1"
"TTCACCGAGTCCGCCA"	"PT_2"
"TTCACCGAGTGGCGAT"	"PT_2"
"TTCACCGGTGACAGCA"	"CNT"
"TTCACCGTCAATCTCT"	"T-cell"
"TTCACCGTCGACGCGT"	"PT_1"
"TTCACCGTCGCTTAAG"	"TAL"
"TTCACCGTCTCCGTGT"	"DCT_1"
"TTCACGCAGCGATGGT"	"PT_2"
"TTCACGCAGGGTTAGC"	"iPT"
"TTCACGCAGGTTGTTC"	"PT_1"
"TTCACGCGTCCGGTCA"	"TAL"
"TTCACGCTCAGGAAGC"	"DCT_1"
"TTCACGCTCTGTACAG"	"PT_1"
"TTCAGGAAGCGCACAA"	"iPT"
"TTCAGGAAGCGGCTCT"	"PT_2"
"TTCAGGACACGAGGTA"	"PT_2"
"TTCAGGAGTCATGGCC"	"EC-PTC"
"TTCAGGAGTCGTTGCG"	"CNT"
"TTCAGGAGTTAACAGA"	"EC-PTC"
"TTCAGGATCGATGCTA"	"PT_1"
"TTCATGTAGGTGGTTG"	"DCT_1"
"TTCATGTCAAGTTCCA"	"PT_2"
"TTCATGTCAGTTAGGG"	"PT_1"
"TTCATGTCATCGCTAA"	"iPT"
"TTCATGTGTACCAGAG"	"PT_1"
"TTCATGTGTTGCGAAG"	"PT_1"
"TTCATGTGTTTCACAG"	"PT_2"
"TTCATGTTCCACTTCG"	"PT_1"
"TTCATTGAGAAACCAT"	"CNT"
"TTCATTGCAACGGCTC"	"PT_1"
"TTCATTGCAGCGGATA"	"DCT_1"
"TTCATTGCAGTGCGCT"	"CNT"
"TTCATTGCATAGAATG"	"CNT"
"TTCATTGGTACAACGG"	"PT_1"
"TTCATTGTCAGCGCGT"	"GC-EC"
"TTCATTGTCAGTCTTT"	"PT_2"
"TTCATTGTCATAGGCT"	"IC-A1_1"
"TTCATTGTCGATCCCT"	"IC-A1_1"
"TTCATTGTCTGATTCT"	"CNT"
"TTCCAATGTCGCCACA"	"CNT"
"TTCCAATTCATGTCAG"	"GC-EC"
"TTCCAATTCGTCGACG"	"PT_1"
"TTCCACGAGGCTCACC"	"iPT"
"TTCCACGAGTTTCGAC"	"TAL"
"TTCCACGCACGTGAGA"	"CNT"
"TTCCACGCACTTGAAC"	"EC-PTC"
"TTCCGGTAGGAGAGTA"	"DCT_1"
"TTCCGGTAGTAGTGCG"	"T-cell"
"TTCCGGTCACAGTGTT"	"EC-PTC"
"TTCCGGTGTCCAGCGT"	"iPT"
"TTCCGGTGTTGTAGCT"	"PT_1"
"TTCCGGTTCAGTGTGT"	"PT_1"
"TTCCGGTTCTGGAAGG"	"GC-EC"
"TTCCGTGAGCTACGTT"	"CNT"
"TTCCGTGCATATGAAG"	"DCT_1"
"TTCCGTGTCAGCGGAA"	"TAL"
"TTCCGTGTCCCATTCG"	"PT_1"
"TTCCGTGTCTACCACC"	"PT_1"
"TTCCGTGTCTCCTGTG"	"GC-EC"
"TTCCGTGTCTGAGGCC"	"TAL"
"TTCCTAAAGCTCGCAC"	"PT_1"
"TTCCTAACACTCCTGT"	"TAL"
"TTCCTAACATCCGTTC"	"CNT"
"TTCCTAAGTATCCCAA"	"MC"
"TTCCTAAGTATTGCCA"	"DCT_1"
"TTCCTAATCAGTCACA"	"DCT_1"
"TTCCTAATCATGGATC"	"TAL"
"TTCCTAATCTTAGCAG"	"PT_1"
"TTCCTCTAGCCAGAGT"	"IC-A1_1"
"TTCCTCTCAATTGAGA"	"DCT_1"
"TTCCTCTGTAACCAGG"	"GC-EC"
"TTCCTCTGTTGCATTG"	"CNT"
"TTCCTCTTCCCAGGAC"	"GC-EC"
"TTCCTCTTCCTACGAA"	"DCT_1"
"TTCCTCTTCTCGTTTA"	"IC-A1_1"
"TTCCTTCAGCAGTACG"	"EC-PTC"
"TTCCTTCCAGGAAGTC"	"PT_1"
"TTCCTTCGTAACATCC"	"PT_1"
"TTCCTTCGTCCGTTTC"	"DCT_1"
"TTCCTTCGTTCAAGTC"	"IC-A1_1"
"TTCCTTCTCACATACG"	"GC-EC"
"TTCCTTCTCGGTGTAT"	"MC"
"TTCGATTCACAACGTT"	"PT_2"
"TTCGATTCACCTGATA"	"DCT_1"
"TTCGATTGTATCGTGT"	"IC-A1_1"
"TTCGATTGTCATGGCC"	"PT_1"
"TTCGATTGTCGGAACA"	"IC-A1_2"
"TTCGATTGTTACTCAG"	"PT_1"
"TTCGATTTCATAAGGA"	"EC-PTC"
"TTCGATTTCTCATTAC"	"TAL"
"TTCGCTGAGCGTCTCG"	"TAL"
"TTCGCTGAGCTCCGAC"	"PT_2"
"TTCGCTGCAACCGCTG"	"PT_1"
"TTCGCTGGTCAACCAT"	"IC-A1_1"
"TTCGCTGGTCTTACAG"	"PT_2"
"TTCGCTGTCGAGAAAT"	"EC-PTC"
"TTCGCTGTCTGACGCG"	"T-cell"
"TTCGGTCAGGGCTTCC"	"CNT"
"TTCGGTCAGTCAACAA"	"EC-PTC"
"TTCGGTCCAGTAGAAT"	"IC-A1_2"
"TTCGGTCTCCATGAGT"	"CNT"
"TTCTAACAGACCATGG"	"POD"
"TTCTAACAGCGGCTCT"	"GC-EC"
"TTCTAACAGTGAACAT"	"DCT_1"
"TTCTAACCAAGTGACG"	"DCT_1"
"TTCTAACGTGACGTCC"	"PT_1"
"TTCTAACGTGGACCAA"	"CNT"
"TTCTAACTCCACAAGT"	"iPT"
"TTCTCTCAGAACGCGT"	"PT_1"
"TTCTCTCAGAAGCCAC"	"TAL"
"TTCTCTCCAATGGGTG"	"PT_2"
"TTCTCTCCAGAGCGTA"	"IC-A1_2"
"TTCTCTCCATCTCGTC"	"DCT_1"
"TTCTCTCCATTCTGTT"	"PT_1"
"TTCTCTCTCTAGGCCG"	"IC-A1_2"
"TTCTGTAAGACGCAGT"	"DCT_1"
"TTCTGTAAGAGCATCG"	"DCT_1"
"TTCTGTACATCATGAC"	"PT_2"
"TTCTGTAGTACAGAGC"	"TAL"
"TTCTGTATCGGAGTGA"	"DCT_1"
"TTCTGTATCTGAGAGG"	"PT_1"
"TTCTGTATCTGTAAGC"	"PT_1"
"TTCTTCCCAAATGGAT"	"PT_2"
"TTCTTCCCACAGGATG"	"PT_1"
"TTCTTCCGTGAATGTA"	"TAL"
"TTCTTCCGTGAGTAGC"	"TAL"
"TTCTTCCGTGGGCTTC"	"PT_1"
"TTCTTCCTCCTCTCTT"	"DCT_2"
"TTCTTCCTCTGTTGGA"	"DCT_1"
"TTCTTGAAGAGAGCAA"	"TAL"
"TTCTTGAAGGTCTTTG"	"PT_1"
"TTCTTGAAGTAGCAAT"	"DCT_1"
"TTCTTGACACCCTTAC"	"PT_1"
"TTCTTGACAGAGGGTT"	"DCT_1"
"TTCTTGACATAGGTTC"	"GC-EC"
"TTCTTGAGTCCAATCA"	"iPT"
"TTCTTGAGTGATTAGA"	"TAL"
"TTCTTGATCAGTAGGG"	"PT_1"
"TTGAACGAGCTCTATG"	"PT_1"
"TTGAACGAGGTCGTGA"	"DCT_1"
"TTGAACGCATTACTCT"	"CNT"
"TTGAACGGTAACATCC"	"PT_1"
"TTGAACGGTCCACTTC"	"iPT"
"TTGAACGGTCGAGTGA"	"PT_2"
"TTGAACGGTGGGCTTC"	"PT_2"
"TTGACCCAGTAGTGCG"	"PT_1"
"TTGACCCAGTGGCCTC"	"PT_1"
"TTGAGTGAGCCAAGTG"	"IC-A1_1"
"TTGAGTGTCGCAGTTA"	"PT_2"
"TTGATGGCATCGGTTA"	"PEC"
"TTGATGGGTTGGAGGT"	"PT_1"
"TTGATGGTCCCAACTC"	"PT_1"
"TTGATGGTCGAGTTGT"	"PT_2"
"TTGATGGTCTCGGTCT"	"POD"
"TTGCATTGTCACCGCA"	"DCT_1"
"TTGCCTGAGTACAACA"	"EC-PTC"
"TTGCCTGCAGAACTTC"	"GC-EC"
"TTGCCTGGTCACCACG"	"DCT_1"
"TTGCCTGGTGTGACCC"	"TAL"
"TTGCCTGTCTTGGTCC"	"DCT_1"
"TTGCGTCCAGGAATAT"	"PT_1"
"TTGCGTCCATATTCGG"	"DCT_1"
"TTGCGTCCATTGCTGA"	"PT_2"
"TTGCGTCGTATCGAGG"	"CNT"
"TTGCGTCGTCCCTGTT"	"EC-PTC"
"TTGCGTCGTCCGAAAG"	"GC-EC"
"TTGCGTCTCCCGAGGT"	"PT_1"
"TTGCTGCAGTAGTGCG"	"PT_2"
"TTGCTGCCAATTCACG"	"PT_1"
"TTGCTGCCACAATTCG"	"PT_1"
"TTGCTGCGTGTTACTG"	"PT_1"
"TTGCTGCTCAACTCTT"	"IC-A1_1"
"TTGCTGCTCCCTAGGG"	"DCT_1"
"TTGCTGCTCTGGGAGA"	"CNT"
"TTGGATGAGAATCGCG"	"CNT"
"TTGGATGAGTTCTACG"	"TAL"
"TTGGATGCAAACAGGC"	"DCT_1"
"TTGGATGGTAAGTTAG"	"PT_2"
"TTGGATGGTCAGGTAG"	"IC-A1_1"
"TTGGATGGTGTCCGGT"	"EC-PTC"
"TTGGATGTCCCAATAG"	"PT_1"
"TTGGGATAGATTGGGC"	"CNT"
"TTGGGATAGGAGTATT"	"GC-EC"
"TTGGGATAGGGCCAAT"	"PT_2"
"TTGGGATCATCCGTTC"	"PT_1"
"TTGGGATGTACAAGCG"	"CNT"
"TTGGGATGTGCATCTA"	"GC-EC"
"TTGGGATGTTGGGTTT"	"CNT"
"TTGGGATTCGAGCTGC"	"PT_2"
"TTGGGTACATGACTTG"	"CNT"
"TTGGGTAGTCTAACTG"	"CNT"
"TTGGGTAGTGCGGATA"	"TAL"
"TTGGGTATCACTAGCA"	"DCT_1"
"TTGGGTATCGGACTTA"	"PT_1"
"TTGGTTTAGTTGGACG"	"TAL"
"TTGGTTTCACACCGCA"	"PT_1"
"TTGGTTTCAGTAACGG"	"TAL"
"TTGGTTTGTCGCAACC"	"EC-PTC"
"TTGGTTTGTCTATGAC"	"DCT_1"
"TTGGTTTGTGCGTCGT"	"PT_1"
"TTGGTTTTCACCTGTC"	"PT_2"
"TTGTGGAAGGGTCACA"	"CNT"
"TTGTGGACACCCAACG"	"DCT_1"
"TTGTGGAGTATGCGGA"	"PT_1"
"TTGTGGATCATGACAC"	"CNT"
"TTGTGGATCGGACTTA"	"DCT_1"
"TTGTGGATCTAGAACC"	"PT_1"
"TTGTGTTTCAAGTGTC"	"CNT"
"TTGTGTTTCTCTAAGG"	"PT_1"
"TTGTTCAAGTCCGTCG"	"DCT_2"
"TTGTTCACAATAGTAG"	"PEC"
"TTGTTCACATAACTCG"	"iPT"
"TTGTTCAGTGATACTC"	"DCT_1"
"TTGTTCAGTTGACTAC"	"POD"
"TTGTTCATCCATAGAC"	"IC-A1_1"
"TTGTTGTAGGTGGGTT"	"PT_1"
"TTGTTGTCATGACAGG"	"PT_1"
"TTGTTGTTCACTCTTA"	"PT_2"
"TTGTTGTTCCAATCCC"	"IC-A1_1"
"TTGTTGTTCCACTTCG"	"DCT_2"
"TTGTTTGAGACGCAGT"	"DCT_1"
"TTGTTTGAGCTCAGAG"	"T-cell"
"TTGTTTGCAAAGGCGT"	"iPT"
"TTGTTTGCACCTGCAG"	"CNT"
"TTGTTTGCACGACGAA"	"PT_1"
"TTGTTTGCACGGTGCT"	"PT_2"
"TTGTTTGCATCTTAGG"	"PT_2"
"TTGTTTGGTAGTCCTA"	"PT_1"
"TTGTTTGGTATCAAGA"	"IC-A1_1"
"TTGTTTGGTCCGATCG"	"DCT_1"
"TTGTTTGGTTGCCTAA"	"EC-PTC"
"TTGTTTGTCCGCACGA"	"DCT_1"
"TTGTTTGTCGTGTCAA"	"TAL"
"TTTACCAAGCTGCCTG"	"iPT"
"TTTACCACAACACACT"	"CNT"
"TTTACCACACGACGCT"	"EC-PTC"
"TTTACCAGTGGCGCTT"	"TAL"
"TTTACCATCGCGATCG"	"IC-A1_1"
"TTTACGTAGCACCTGC"	"POD"
"TTTACGTAGTAGACAT"	"DCT_1"
"TTTACGTCAAAGGGTC"	"PT_1"
"TTTACGTGTCGCTTGG"	"DCT_1"
"TTTACGTTCCCTCTTT"	"PT_1"
"TTTACGTTCCCTTTGG"	"EC-PTC"
"TTTACGTTCGCGTCGA"	"PT_1"
"TTTACGTTCGCTACAA"	"PT_1"
"TTTACTGAGCATCAAA"	"CNT"
"TTTACTGCAAGCGATG"	"PT_2"
"TTTACTGCACGGCACT"	"EC-PTC"
"TTTACTGCAGTGGCTC"	"PT_2"
"TTTACTGGTCGCCTAG"	"EC-PTC"
"TTTACTGGTTACCTTT"	"PT_1"
"TTTACTGTCATTGTGG"	"PT_2"
"TTTACTGTCCGGGACT"	"PT_1"
"TTTACTGTCGAGTGAG"	"PT_1"
"TTTACTGTCTCGTCAC"	"GC-EC"
"TTTAGTCAGACTACCT"	"DCT_1"
"TTTAGTCGTGGAGGTT"	"CNT"
"TTTAGTCTCACCATCC"	"DCT_1"
"TTTAGTCTCTCCGAGG"	"DCT_2"
"TTTATGCAGGGTATAT"	"GC-EC"
"TTTATGCCACTTGAAC"	"PT_2"
"TTTATGCCATCAGCTA"	"PT_1"
"TTTATGCGTAGCGAGT"	"DCT_1"
"TTTATGCTCATGTCTT"	"PT_1"
"TTTATGCTCCGAGTGC"	"CNT"
"TTTATGCTCCTGTACC"	"PT_2"
"TTTATGCTCGGACGTC"	"CNT"
"TTTCACAAGCCGTCGT"	"DCT_1"
"TTTCACAGTATGCTTG"	"PT_2"
"TTTCACAGTTAGAGAT"	"PT_1"
"TTTCAGTAGAATAGTC"	"PT_1"
"TTTCAGTAGATTCGCT"	"GC-EC"
"TTTCAGTCACATGGTT"	"PT_2"
"TTTCAGTCACGCCACA"	"EC-PTC"
"TTTCAGTGTCGAGCAA"	"DCT_1"
"TTTCAGTGTGAATATG"	"PEC"
"TTTCAGTTCGGACTTA"	"CNT"
"TTTCATGAGTAACGAT"	"PT_2"
"TTTCATGAGTGAATAC"	"CNT"
"TTTCATGCAAGACCTT"	"PT_1"
"TTTCATGGTATTTCCT"	"PT_1"
"TTTCATGGTGTGTACT"	"PT_1"
"TTTCATGTCCCTAGGG"	"iPT"
"TTTCATGTCCTGTTAT"	"DCT_1"
"TTTCCTCAGACCAGAC"	"PT_2"
"TTTCCTCAGGATTACA"	"PT_1"
"TTTCCTCAGGCACGAT"	"PT_2"
"TTTCCTCAGTCCGCCA"	"PT_1"
"TTTCCTCGTCACTCTC"	"iPT"
"TTTCCTCTCATCAGTG"	"PT_1"
"TTTCCTCTCCAACCGG"	"PT_1"
"TTTCCTCTCCACGGAC"	"PEC"
"TTTCCTCTCTGTGCTC"	"EC-PTC"
"TTTCGATAGTAGCAAT"	"PT_1"
"TTTCGATGTGCATACT"	"PT_1"
"TTTCGATTCCCTCAAC"	"DCT_1"
"TTTGACTAGCTCGACC"	"PT_1"
"TTTGACTGTGGCCTCA"	"POD"
"TTTGACTGTTCGAGCC"	"TAL"
"TTTGACTTCACTTGTT"	"PT_2"
"TTTGACTTCGATACAC"	"PT_1"
"TTTGATCAGTGATCGG"	"DCT_1"
"TTTGATCGTCATACCA"	"CNT"
"TTTGATCGTTGCCAAT"	"PT_1"
"TTTGATCTCAATCAGC"	"EC-PTC"
"TTTGATCTCACAACCA"	"PT_1"
"TTTGATCTCAGCCTTC"	"EC-PTC"
"TTTGATCTCATGGTAC"	"CNT"
"TTTGATCTCATTTGCT"	"GC-EC"
"TTTGATCTCGCTGTTC"	"PT_1"
"TTTGATCTCTCGGTAA"	"CNT"
"TTTGGAGCAGAGCCCT"	"PT_2"
"TTTGGAGGTCGAATGG"	"DCT_1"
"TTTGGAGTCACCCTCA"	"CNT"
"TTTGGAGTCCACGTAA"	"PT_2"
"TTTGGAGTCCGCACGA"	"PT_2"
"TTTGGTTAGACGTCGA"	"CNT"
"TTTGGTTAGGCGAACT"	"CNT"
"TTTGGTTAGTACTCGT"	"IC-A1_1"
"TTTGGTTGTACAACGG"	"EC-PTC"
"TTTGTTGAGATTAGCA"	"PT_2"
"TTTGTTGAGGACTATA"	"PT_1"
"TTTGTTGAGGCATCAG"	"IC-A1_1"
"TTTGTTGCACGCGCAT"	"PT_1"
"TTTGTTGGTAGACAGC"	"PT_1"
"TTTGTTGGTGAGACGT"	"PT_1"
"TTTGTTGGTTATGACC"	"DCT_1"
"TTTGTTGGTTTCACTT"	"GC-EC"
"TTTGTTGTCAGCGGAA"	"PT_1"
"TTTGTTGTCCATCTGC"	"GC-EC"
"TTTGTTGTCTCACGAA"	"PT_2"
