""	"Ident"
"AAACCCATCGAGTCCG"	"TPC_5"
"AAACGCTAGGTCCCTG"	"TPC_1"
"AAAGAACAGGATCACG"	"TPC_1"
"AAAGGGCCACATAACC"	"TPC_3:HighMT"
"AAAGGGCCAGAGTGAC"	"TPC_1"
"AAAGGGCGTGTGTGGA"	"TPC_1"
"AAAGGTAAGTACAACA"	"TPC_1"
"AAAGGTACAAACCATC"	"TPC_5"
"AAAGGTAGTATCGCAT"	"TPC_1"
"AAAGGTAGTTACGATC"	"TPC_2:LowCov"
"AAAGGTAGTTTCGCTC"	"TPC_3:HighMT"
"AAAGTCCGTTTAAGGA"	"TPC_4"
"AAATGGACAGGAGGAG"	"TPC_4"
"AACAACCAGCACAAAT"	"TPC_3:HighMT"
"AACAAGAAGCGACTAG"	"TPC_4"
"AACAAGAAGGTTACAA"	"TPC_2:LowCov"
"AACACACAGCAGCCTC"	"TPC_1"
"AACACACCAGACGATG"	"TPC_2:LowCov"
"AACACACGTTCTGACA"	"TPC_2:LowCov"
"AACACACTCGGAGCAA"	"TPC_1"
"AACAGGGAGCACTTTG"	"TPC_5"
"AACAGGGAGGTCGCCT"	"TPC_1"
"AACCAACTCCGTCAAA"	"TPC_5"
"AACCACATCTGTGCTC"	"TPC_1"
"AACCATGGTCCTATAG"	"TPC_1"
"AACCCAAAGTAGAATC"	"TPC_1"
"AACCCAAGTCTCCCTA"	"TPC_3:HighMT"
"AACCCAATCGGCTCTT"	"TPC_5"
"AACCTGAAGGGTTAGC"	"TPC_2:LowCov"
"AACCTGAGTTGCATGT"	"TPC_2:LowCov"
"AACCTGATCCGAGAAG"	"TPC_4"
"AACCTGATCTGTTCAT"	"TPC_4"
"AACCTTTCAACATCGT"	"TPC_2:LowCov"
"AACCTTTTCGTTCCCA"	"TPC_1"
"AACGAAACACACCGAC"	"TPC_1"
"AACGGGACAACATACC"	"TPC_5"
"AACGGGACAGAGGAAA"	"TPC_1"
"AACGGGAGTGCTTCAA"	"TPC_4"
"AACGTCACACACCGCA"	"TPC_1"
"AACGTCACATATGCGT"	"TPC_1"
"AACGTCATCTGACAGT"	"TPC_1"
"AACTTCTCACTTCCTG"	"TPC_2:LowCov"
"AACTTCTGTTTGGAAA"	"TPC_2:LowCov"
"AACTTCTTCGTTAGAC"	"TPC_6:lowCov"
"AAGAACAAGGAAAGGT"	"TPC_1"
"AAGAACAAGGCACTCC"	"TPC_2:LowCov"
"AAGAACAAGTCGTTAC"	"TPC_7"
"AAGAACAGTCAGACTT"	"TPC_2:LowCov"
"AAGAACAGTGAGGCAT"	"TPC_5"
"AAGAACAGTGCTGCAC"	"TPC_2:LowCov"
"AAGACAAAGTTCGGTT"	"TPC_2:LowCov"
"AAGACAATCCTAACAG"	"TPC_1"
"AAGACAATCGAAGCAG"	"TPC_3:HighMT"
"AAGACAATCGTGCTCT"	"TPC_1"
"AAGACTCAGCGTGAGT"	"TPC_7"
"AAGACTCGTTAATGAG"	"TPC_2:LowCov"
"AAGATAGCAACGATTC"	"TPC_2:LowCov"
"AAGATAGCAGCTGTCG"	"TPC_4"
"AAGATAGGTAGCTTAC"	"TPC_1"
"AAGATAGTCGTTATCT"	"TPC_3:HighMT"
"AAGCATCGTACCCAGC"	"TPC_2:LowCov"
"AAGCATCTCCCGTGAG"	"TPC_2:LowCov"
"AAGCATCTCGACCACG"	"TPC_4"
"AAGCCATAGAGAGAAC"	"TPC_4"
"AAGCCATCATTACTCT"	"TPC_1"
"AAGCCATTCGGCTGAC"	"TPC_2:LowCov"
"AAGCCATTCGGTTGTA"	"TPC_1"
"AAGCGAGCAGGACTTT"	"TPC_2:LowCov"
"AAGCGAGGTAGGAGTC"	"TPC_2:LowCov"
"AAGCGTTCAACCGCCA"	"TPC_2:LowCov"
"AAGGAATGTACAAGCG"	"TPC_5"
"AAGGAATTCCAAATGC"	"TPC_2:LowCov"
"AAGTACCAGACCTCCG"	"TPC_1"
"AAGTACCAGAGAGCCT"	"TPC_3:HighMT"
"AAGTCGTAGCGCATCC"	"TPC_2:LowCov"
"AAGTCGTGTAACTTCG"	"TPC_4"
"AAGTGAAAGATCCAAA"	"TPC_3:HighMT"
"AAGTGAACAAAGCGTG"	"TPC_2:LowCov"
"AAGTGAACAGAGTTCT"	"TPC_2:LowCov"
"AAGTGAACAGCAGAAC"	"TPC_1"
"AAGTGAAGTCTGTGCG"	"TPC_2:LowCov"
"AAGTTCGAGAGAGGGC"	"TPC_3:HighMT"
"AAGTTCGAGTCTCTGA"	"TPC_5"
"AAGTTCGCAGGTGACA"	"TPC_4"
"AAGTTCGCATAGACTC"	"TPC_3:HighMT"
"AAGTTCGGTCCCGGTA"	"TPC_3:HighMT"
"AAGTTCGTCGCAACAT"	"TPC_2:LowCov"
"AAGTTCGTCGCCATAA"	"TPC_4"
"AATAGAGCAAGAGATT"	"TPC_1"
"AATAGAGGTAAGGCTG"	"TPC_1"
"AATAGAGGTGTCTTGA"	"TPC_5"
"AATAGAGTCCCGTAAA"	"TPC_1"
"AATCGACAGCTGGCTC"	"TPC_1"
"AATCGACCACAAATGA"	"TPC_1"
"AATCGACCATAAGATG"	"TPC_4"
"AATCGACTCGTTCTAT"	"TPC_5"
"AATCGTGAGACACACG"	"TPC_1"
"AATCGTGAGCAGATAT"	"TPC_5"
"AATCGTGAGTACCGGA"	"TPC_4"
"AATCGTGTCTTGGATG"	"TPC_1"
"AATGAAGAGGGCCCTT"	"TPC_1"
"AATGAAGGTCGCTGCA"	"TPC_1"
"AATGAAGGTGATGTAA"	"TPC_1"
"AATGAAGGTTACCCAA"	"TPC_2:LowCov"
"AATGACCCAGTAGATA"	"TPC_3:HighMT"
"AATGACCGTCGATTAC"	"TPC_1"
"AATGCCAAGTACTGGG"	"TPC_3:HighMT"
"AATGCCACACAGCATT"	"TPC_2:LowCov"
"AATGCCATCACCTACC"	"TPC_1"
"AATGCCATCGCAGTTA"	"TPC_2:LowCov"
"AATGGAAAGTTGTCGT"	"TPC_3:HighMT"
"AATGGAATCCAGCACG"	"TPC_2:LowCov"
"AATGGAATCCATTTCA"	"TPC_3:HighMT"
"AATGGAATCCGGCAAC"	"TPC_4"
"AATGGCTAGCCTCAGC"	"TPC_2:LowCov"
"AATGGCTCAACACAGG"	"TPC_5"
"AATGGCTCAATTAGGA"	"TPC_6:lowCov"
"AATGGCTCAGGGAATC"	"TPC_5"
"AATTCCTAGAAGGGAT"	"TPC_2:LowCov"
"AATTCCTGTTGTCTAG"	"TPC_1"
"AATTTCCAGCCTCAGC"	"TPC_2:LowCov"
"AATTTCCGTCACCTTC"	"TPC_2:LowCov"
"ACAAAGACACCAGTTA"	"TPC_1"
"ACAACCAAGAAACACT"	"TPC_5"
"ACAACCATCCGAGGCT"	"TPC_4"
"ACAAGCTAGCTTCTAG"	"TPC_4"
"ACAAGCTAGTATGAAC"	"TPC_2:LowCov"
"ACAAGCTTCCCATACC"	"TPC_3:HighMT"
"ACACAGTAGGCTCTCG"	"TPC_3:HighMT"
"ACACAGTCAAAGGCGT"	"TPC_2:LowCov"
"ACACAGTGTGAATTAG"	"TPC_3:HighMT"
"ACACAGTGTGGCTGCT"	"TPC_3:HighMT"
"ACACCAAAGACTAGAT"	"TPC_2:LowCov"
"ACACCAAAGGATAATC"	"TPC_4"
"ACACCAAAGGTATCTC"	"TPC_2:LowCov"
"ACACCAACAGATCCTA"	"TPC_1"
"ACACCAAGTTCCTTGC"	"TPC_3:HighMT"
"ACACGCGAGTCGAGGT"	"TPC_1"
"ACACGCGCAAGCACAG"	"TPC_2:LowCov"
"ACACGCGCACCACTGG"	"TPC_2:LowCov"
"ACACGCGGTACGTACT"	"TPC_2:LowCov"
"ACACGCGGTACTGCCG"	"TPC_2:LowCov"
"ACACGCGGTATCGATC"	"TPC_3:HighMT"
"ACACGCGGTCCGGTCA"	"TPC_2:LowCov"
"ACACGCGGTGAATTAG"	"TPC_3:HighMT"
"ACACTGAGTAACCCTA"	"TPC_4"
"ACAGAAAAGTTCACTG"	"TPC_3:HighMT"
"ACAGAAACATAGGCGA"	"TPC_2:LowCov"
"ACAGCCGCAATGGCAG"	"TPC_1"
"ACAGGGAAGAACCCGA"	"TPC_1"
"ACAGGGAAGTAGGGTC"	"TPC_2:LowCov"
"ACAGGGACAAATTGGA"	"TPC_1"
"ACAGGGACACACGGAA"	"TPC_2:LowCov"
"ACAGGGACATAGATCC"	"TPC_1"
"ACAGGGAGTCCCTGTT"	"TPC_2:LowCov"
"ACAGGGATCAAGCCGC"	"TPC_1"
"ACAGGGATCGGTCACG"	"TPC_1"
"ACATCCCAGCGTGTCC"	"TPC_1"
"ACATCCCAGGAAGAAC"	"TPC_2:LowCov"
"ACATCCCAGTCTACCA"	"TPC_4"
"ACATCCCGTATCAAGA"	"TPC_6:lowCov"
"ACATCCCGTGGGACAT"	"TPC_2:LowCov"
"ACATCCCTCGAACGGA"	"TPC_3:HighMT"
"ACATCCCTCTCGAGTA"	"TPC_3:HighMT"
"ACATCGAAGGCCTTCG"	"TPC_3:HighMT"
"ACATCGATCCGCTGTT"	"TPC_2:LowCov"
"ACATGCAAGGTGCAGT"	"TPC_1"
"ACATGCAGTAGAGTTA"	"TPC_1"
"ACATGCAGTTTACTGG"	"TPC_1"
"ACATGCATCTTCGTAT"	"TPC_2:LowCov"
"ACATTTCAGAACTTCC"	"TPC_1"
"ACATTTCAGATGTAGT"	"TPC_1"
"ACATTTCCACGGTCTG"	"TPC_2:LowCov"
"ACATTTCGTCTTGGTA"	"TPC_1"
"ACATTTCTCACCGACG"	"TPC_1"
"ACATTTCTCCTGGCTT"	"TPC_2:LowCov"
"ACCAACACAGGAACCA"	"TPC_1"
"ACCAACAGTGCATCTA"	"TPC_2:LowCov"
"ACCACAACAAATGCTC"	"TPC_3:HighMT"
"ACCACAACAGGCGATA"	"TPC_2:LowCov"
"ACCACAATCGCGGACT"	"TPC_2:LowCov"
"ACCACAATCTAGAGCT"	"TPC_3:HighMT"
"ACCATTTTCGCGTGCA"	"TPC_2:LowCov"
"ACCCAAAAGAACTTCC"	"TPC_3:HighMT"
"ACCCAAAAGCTACGTT"	"TPC_1"
"ACCCAAACATGTGACT"	"TPC_1"
"ACCCAAAGTCAACATC"	"TPC_5"
"ACCCTCACAGCTATTG"	"TPC_1"
"ACCCTCACAGTAGAGC"	"TPC_1"
"ACCCTCAGTGGACTGA"	"TPC_3:HighMT"
"ACCCTTGTCAGCTGTA"	"TPC_3:HighMT"
"ACCGTTCAGTAGTCAA"	"TPC_2:LowCov"
"ACCGTTCCAAACTCTG"	"TPC_6:lowCov"
"ACCGTTCCATGTTTGG"	"TPC_2:LowCov"
"ACCGTTCGTGCGTTTA"	"TPC_1"
"ACCTACCAGGGAGGCA"	"TPC_2:LowCov"
"ACCTACCCACACGTGC"	"TPC_2:LowCov"
"ACCTACCCACCTGCAG"	"TPC_2:LowCov"
"ACCTACCCAGCTACCG"	"TPC_2:LowCov"
"ACCTACCTCCAGGACC"	"TPC_1"
"ACCTGAAAGGAGTCTG"	"TPC_1"
"ACCTGAAAGGATAATC"	"TPC_1"
"ACCTGAACACTACGGC"	"TPC_3:HighMT"
"ACCTGAACATTAAAGG"	"TPC_2:LowCov"
"ACCTGAAGTATGGGAC"	"TPC_1"
"ACCTGTCAGTATTGCC"	"TPC_2:LowCov"
"ACCTGTCCAAGCTACT"	"TPC_3:HighMT"
"ACGATCAAGCCAAGCA"	"TPC_1"
"ACGATCAAGCTCGCAC"	"TPC_2:LowCov"
"ACGATCACACACGTGC"	"TPC_2:LowCov"
"ACGATCACATGGCCAC"	"TPC_4"
"ACGATCAGTTGTGTTG"	"TPC_1"
"ACGATCATCGTCAACA"	"TPC_2:LowCov"
"ACGATGTAGCGTACAG"	"TPC_1"
"ACGATGTAGGGAGATA"	"TPC_1"
"ACGATGTCACTTGGGC"	"TPC_2:LowCov"
"ACGGAAGCAAATCGGG"	"TPC_2:LowCov"
"ACGGAAGTCAAACGAA"	"TPC_4"
"ACGGGTCAGCATGAAT"	"TPC_3:HighMT"
"ACGGGTCCATGTTCAG"	"TPC_1"
"ACGGTCGCAGGTTCGC"	"TPC_2:LowCov"
"ACGGTCGTCAGGACGA"	"TPC_3:HighMT"
"ACGGTTAAGCTACTGT"	"TPC_1"
"ACGGTTAGTCTTTATC"	"TPC_1"
"ACGGTTATCTACGCGG"	"TPC_2:LowCov"
"ACGTAACAGCCTCTGG"	"TPC_2:LowCov"
"ACGTAACAGTGTAGAT"	"TPC_1"
"ACGTAACGTCAAAGCG"	"TPC_1"
"ACGTACAAGGACAAGA"	"TPC_3:HighMT"
"ACGTACAAGGGAGATA"	"TPC_2:LowCov"
"ACGTACACAAATCGGG"	"TPC_6:lowCov"
"ACGTACACAGTAGGAC"	"TPC_2:LowCov"
"ACGTAGTTCACATACG"	"TPC_1"
"ACGTCCTGTAATGATG"	"TPC_1"
"ACTACGACAGACGATG"	"TPC_2:LowCov"
"ACTACGACATCATTTC"	"TPC_4"
"ACTACGACATTCCTCG"	"TPC_1"
"ACTACGATCACTTCTA"	"TPC_1"
"ACTACGATCTTTACAC"	"TPC_2:LowCov"
"ACTATCTCACGGTGTC"	"TPC_2:LowCov"
"ACTATGGGTCTAGATC"	"TPC_3:HighMT"
"ACTATGGGTGAGCGAT"	"TPC_1"
"ACTATGGTCTGAGTCA"	"TPC_2:LowCov"
"ACTATGGTCTTAGTTC"	"TPC_2:LowCov"
"ACTATTCCAGACCTGC"	"TPC_4"
"ACTATTCGTTGTTGTG"	"TPC_1"
"ACTATTCTCAGAGCAG"	"TPC_3:HighMT"
"ACTCCCATCGACGTCG"	"TPC_1"
"ACTCCCATCTTCCGTG"	"TPC_1"
"ACTCTCGAGATCGACG"	"TPC_1"
"ACTCTCGCACGCTGCA"	"TPC_1"
"ACTCTCGTCTCGTCAC"	"TPC_4"
"ACTGATGAGAAGAGCA"	"TPC_2:LowCov"
"ACTGATGAGTCTGCAT"	"TPC_2:LowCov"
"ACTGATGCACGTTGGC"	"TPC_3:HighMT"
"ACTGCAAAGGTATCTC"	"TPC_5"
"ACTGCAACAATCTAGC"	"TPC_2:LowCov"
"ACTGCAACATCTCGTC"	"TPC_2:LowCov"
"ACTGCAATCTTGGAAC"	"TPC_2:LowCov"
"ACTGTCCAGAGCCGTA"	"TPC_3:HighMT"
"ACTGTCCCACAGGATG"	"TPC_1"
"ACTGTCCGTAGAGTTA"	"TPC_2:LowCov"
"ACTGTCCGTCCATAGT"	"TPC_1"
"ACTGTGAAGAAACTAC"	"TPC_4"
"ACTGTGACAGAGGAAA"	"TPC_3:HighMT"
"ACTGTGATCGACGCTG"	"TPC_1"
"ACTTAGGCACCGTCGA"	"TPC_1"
"ACTTAGGGTGGTCTTA"	"TPC_5"
"ACTTAGGTCCGCAGTG"	"TPC_3:HighMT"
"ACTTAGGTCGTGCTCT"	"TPC_1"
"ACTTATCAGATAGGGA"	"TPC_4"
"ACTTATCAGTCCGCCA"	"TPC_1"
"ACTTATCCAATCCTAG"	"TPC_1"
"ACTTATCTCTCGCGTT"	"TPC_1"
"ACTTCCGGTTCGCGTG"	"TPC_1"
"ACTTCCGTCCCGTTGT"	"TPC_3:HighMT"
"ACTTCCGTCCGTAATG"	"TPC_1"
"ACTTCGCAGAACCGCA"	"TPC_2:LowCov"
"ACTTCGCAGACTTAAG"	"TPC_5"
"ACTTCGCCATGGACAG"	"TPC_3:HighMT"
"ACTTCGCGTCTACGAT"	"TPC_4"
"ACTTCGCGTGTTGCCG"	"TPC_2:LowCov"
"ACTTCGCTCACGACTA"	"TPC_2:LowCov"
"ACTTTCAAGTATGGCG"	"TPC_4"
"ACTTTCAAGTGCTACT"	"TPC_2:LowCov"
"ACTTTCATCCGATGTA"	"TPC_3:HighMT"
"ACTTTCATCCTTACCG"	"TPC_4"
"ACTTTGTCAATACGCT"	"TPC_1"
"ACTTTGTGTCATGGCC"	"TPC_5"
"ACTTTGTTCCGTATAG"	"TPC_4"
"ACTTTGTTCTATCGCC"	"TPC_2:LowCov"
"AGAAATGCAGATTAAG"	"TPC_4"
"AGAAATGTCCGATCTC"	"TPC_3:HighMT"
"AGAACAACAGCCCAGT"	"TPC_1"
"AGAACCTAGGGACTGT"	"TPC_3:HighMT"
"AGAACCTCACAGAGAC"	"TPC_3:HighMT"
"AGAACCTGTAGCTTAC"	"TPC_2:LowCov"
"AGAAGCGAGTTGAAAC"	"TPC_2:LowCov"
"AGAAGCGGTTAGGAGC"	"TPC_4"
"AGAAGTACAAACTCTG"	"TPC_1"
"AGAAGTAGTTGCATTG"	"TPC_3:HighMT"
"AGACAAAAGACTGTTC"	"TPC_1"
"AGACAAAAGGTAGCCA"	"TPC_1"
"AGACAAACACCCTAGG"	"TPC_4"
"AGACAAATCCTTGACC"	"TPC_1"
"AGACAAATCTAAGAAG"	"TPC_3:HighMT"
"AGACAAATCTATGTGG"	"TPC_1"
"AGACAAATCTCATGCC"	"TPC_1"
"AGACACTTCCAAGGGA"	"TPC_3:HighMT"
"AGACACTTCTAACACG"	"TPC_3:HighMT"
"AGACAGGAGAAGTCAT"	"TPC_1"
"AGACAGGAGATGAACT"	"TPC_2:LowCov"
"AGACAGGAGTACAACA"	"TPC_5"
"AGACAGGTCATCTATC"	"TPC_1"
"AGACCATAGCCGGAAT"	"TPC_6:lowCov"
"AGACCATTCAAGGAGC"	"TPC_2:LowCov"
"AGACCCGCACAAGTTC"	"TPC_4"
"AGACCCGTCCCTATTA"	"TPC_5"
"AGACCCGTCTCCTGAC"	"TPC_2:LowCov"
"AGACTCAGTGTGTGGA"	"TPC_7"
"AGAGAATAGCACCGTC"	"TPC_1"
"AGAGAATAGTGATGGC"	"TPC_1"
"AGAGAATTCCGTTGAA"	"TPC_3:HighMT"
"AGAGAATTCTCGGGAC"	"TPC_4"
"AGAGAATTCTTAGGAC"	"TPC_1"
"AGAGAGCAGACCAACG"	"TPC_1"
"AGAGAGCAGCCATTTG"	"TPC_2:LowCov"
"AGAGAGCGTCATAAAG"	"TPC_4"
"AGAGAGCGTGAAGCGT"	"TPC_3:HighMT"
"AGAGAGCGTGGCTGAA"	"TPC_3:HighMT"
"AGAGAGCTCTATTCGT"	"TPC_4"
"AGAGCAGAGACCGCCT"	"TPC_4"
"AGAGCAGCAAGTGGAC"	"TPC_1"
"AGAGCAGTCCAAACCA"	"TPC_1"
"AGAGCCCTCCGAAGGA"	"TPC_4"
"AGATAGAGTGCACGCT"	"TPC_5"
"AGATAGATCCACTTTA"	"TPC_3:HighMT"
"AGATAGATCCTGTTAT"	"TPC_3:HighMT"
"AGATCCAGTAGAGACC"	"TPC_4"
"AGATCCATCCTTCGAC"	"TPC_1"
"AGATCGTAGGCATTTC"	"TPC_4"
"AGATCGTAGGCCTTGC"	"TPC_6:lowCov"
"AGATCGTCAATGTCTG"	"TPC_2:LowCov"
"AGATCGTGTAAGCTCT"	"TPC_2:LowCov"
"AGATCGTTCCCGAATA"	"TPC_3:HighMT"
"AGATGAAGTTCGGTCG"	"TPC_5"
"AGATGAAGTTGCTCAA"	"TPC_3:HighMT"
"AGATGCTCAGGACAGT"	"TPC_2:LowCov"
"AGATGCTCATCCCACT"	"TPC_1"
"AGATGCTGTGTTTACG"	"TPC_1"
"AGATGCTTCAGACTGT"	"TPC_1"
"AGCATCAAGAATTGTG"	"TPC_2:LowCov"
"AGCATCAAGCCTCTCT"	"TPC_1"
"AGCATCACAGCACACC"	"TPC_3:HighMT"
"AGCATCATCGTCAACA"	"TPC_2:LowCov"
"AGCCAATAGGTGTGAC"	"TPC_2:LowCov"
"AGCCAGCAGTAGTCTC"	"TPC_2:LowCov"
"AGCCAGCCAGTCAACT"	"TPC_2:LowCov"
"AGCGATTAGAGTCGAC"	"TPC_2:LowCov"
"AGCGATTTCTGGTCAA"	"TPC_1"
"AGCGCCAAGCTGTTAC"	"TPC_1"
"AGCGCCACACTGCATA"	"TPC_2:LowCov"
"AGCGCCAGTAAGATAC"	"TPC_2:LowCov"
"AGCGCCAGTAGTCGGA"	"TPC_1"
"AGCGCTGGTACTGCCG"	"TPC_2:LowCov"
"AGCGTATAGATACCAA"	"TPC_1"
"AGCGTATCAGGCACTC"	"TPC_3:HighMT"
"AGCGTCGAGGTACTGG"	"TPC_1"
"AGCGTCGCAATGAAAC"	"TPC_1"
"AGCGTCGGTCTACAGT"	"TPC_4"
"AGCTACACAAATCGGG"	"TPC_2:LowCov"
"AGCTACAGTCCACGCA"	"TPC_3:HighMT"
"AGCTACATCGATCCCT"	"TPC_2:LowCov"
"AGCTCAAAGTAGAGTT"	"TPC_3:HighMT"
"AGCTCAAGTAGCTCGC"	"TPC_2:LowCov"
"AGCTTCCGTTTCCAAG"	"TPC_4"
"AGCTTCCTCCTTCAGC"	"TPC_2:LowCov"
"AGGAAATAGCCACCGT"	"TPC_5"
"AGGAAATCATTGTCGA"	"TPC_2:LowCov"
"AGGAAATGTAAGATAC"	"TPC_2:LowCov"
"AGGAAATGTTAGAAAC"	"TPC_1"
"AGGAATAAGCTCCACG"	"TPC_1"
"AGGAATAGTACAAAGT"	"TPC_1"
"AGGAATAGTTCAAAGA"	"TPC_4"
"AGGAATAGTTCTATCT"	"TPC_1"
"AGGAATATCATTCACT"	"TPC_2:LowCov"
"AGGACGAAGAAGCGAA"	"TPC_1"
"AGGACGACAGAGATGC"	"TPC_2:LowCov"
"AGGACGAGTCCGACGT"	"TPC_2:LowCov"
"AGGACGATCACCTCAC"	"TPC_4"
"AGGACGATCTAGACCA"	"TPC_1"
"AGGACTTAGTTGGAAT"	"TPC_1"
"AGGACTTCAGTGAGCA"	"TPC_4"
"AGGAGGTAGACTTCAC"	"TPC_2:LowCov"
"AGGAGGTGTCACCACG"	"TPC_1"
"AGGATAAAGCTGGTGA"	"TPC_1"
"AGGATAAAGTATGAAC"	"TPC_2:LowCov"
"AGGATAATCTCTATAC"	"TPC_1"
"AGGATCTCAATAACCC"	"TPC_1"
"AGGATCTGTATCTTCT"	"TPC_1"
"AGGCATTGTAGAGCTG"	"TPC_2:LowCov"
"AGGCATTTCCGAAGGA"	"TPC_1"
"AGGCATTTCGTTCAGA"	"TPC_1"
"AGGCCACCAATTGCCA"	"TPC_5"
"AGGCCACCAGTAGGAC"	"TPC_1"
"AGGCTGCAGCAGGTCA"	"TPC_1"
"AGGCTGCAGTGTAGAT"	"TPC_2:LowCov"
"AGGCTGCCACCCTTGT"	"TPC_1"
"AGGCTGCCAGATTCGT"	"TPC_2:LowCov"
"AGGCTGCCAGCTCCTT"	"TPC_2:LowCov"
"AGGCTGCGTTGTGTTG"	"TPC_1"
"AGGGAGTAGACCATTC"	"TPC_2:LowCov"
"AGGGAGTAGGCAGGTT"	"TPC_3:HighMT"
"AGGGCCTAGAGGTTAT"	"TPC_1"
"AGGGCTCGTGTATACC"	"TPC_1"
"AGGGCTCTCCCGAGAC"	"TPC_1"
"AGGGTCCCACATAACC"	"TPC_2:LowCov"
"AGGGTCCGTGGGATTG"	"TPC_2:LowCov"
"AGGGTTTAGATGACCG"	"TPC_5"
"AGGGTTTCATGACGGA"	"TPC_4"
"AGGGTTTTCGTACACA"	"TPC_5"
"AGGTAGGAGATGCTTC"	"TPC_2:LowCov"
"AGGTAGGTCGCCTATC"	"TPC_1"
"AGGTCATGTTGGAGGT"	"TPC_4"
"AGGTCTAAGTGGTGAC"	"TPC_3:HighMT"
"AGGTCTAAGTTTGGCT"	"TPC_3:HighMT"
"AGGTCTAGTTCCACGG"	"TPC_3:HighMT"
"AGGTGTTCAGTCTTCC"	"TPC_5"
"AGGTGTTGTGGTCTCG"	"TPC_1"
"AGGTGTTTCACAGAGG"	"TPC_4"
"AGGTGTTTCTAGAACC"	"TPC_3:HighMT"
"AGGTTACAGAAACCAT"	"TPC_2:LowCov"
"AGGTTACCAAGAGCTG"	"TPC_1"
"AGGTTACCAATGAACA"	"TPC_1"
"AGGTTACCATAGAAAC"	"TPC_1"
"AGGTTGTAGTTGCCCG"	"TPC_1"
"AGGTTGTCACATTGTG"	"TPC_2:LowCov"
"AGGTTGTGTACGATCT"	"TPC_1"
"AGTACTGAGTACCCTA"	"TPC_2:LowCov"
"AGTACTGAGTCTCGTA"	"TPC_1"
"AGTACTGAGTTCCAGT"	"TPC_5"
"AGTACTGCATATGAAG"	"TPC_1"
"AGTACTGGTACCCGCA"	"TPC_3:HighMT"
"AGTACTGTCGGCATAT"	"TPC_1"
"AGTACTGTCGGCGATC"	"TPC_2:LowCov"
"AGTAGCTAGCACTCGC"	"TPC_4"
"AGTAGCTAGGGAGGCA"	"TPC_1"
"AGTAGCTAGTCCGCGT"	"TPC_4"
"AGTAGCTTCTCACGAA"	"TPC_4"
"AGTAGCTTCTGCTAGA"	"TPC_2:LowCov"
"AGTAGTCAGAGTCAAT"	"TPC_2:LowCov"
"AGTAGTCCACTCTGCT"	"TPC_4"
"AGTAGTCGTATTGGCT"	"TPC_1"
"AGTAGTCTCGGTCAGC"	"TPC_5"
"AGTCAACCAATCGCAT"	"TPC_1"
"AGTCAACGTATGTCAC"	"TPC_5"
"AGTCAACTCCCGAACG"	"TPC_1"
"AGTCACACATAATGAG"	"TPC_1"
"AGTCACACATGGAAGC"	"TPC_1"
"AGTCACAGTGTAGTGG"	"TPC_2:LowCov"
"AGTCACAGTTTCGTTT"	"TPC_2:LowCov"
"AGTCATGAGAAACACT"	"TPC_1"
"AGTCATGAGTTGTCAC"	"TPC_4"
"AGTCATGGTGGACAGT"	"TPC_1"
"AGTCTCCCACCACTGG"	"TPC_5"
"AGTCTCCTCTAGATCG"	"TPC_1"
"AGTGACTAGCAGCACA"	"TPC_2:LowCov"
"AGTGACTGTAGTCGTT"	"TPC_4"
"AGTGATCGTTTGGGAG"	"TPC_1"
"AGTGCCGAGCTCGTGC"	"TPC_4"
"AGTGCCGAGGATACCG"	"TPC_1"
"AGTGCCGAGTTGCCTA"	"TPC_1"
"AGTGCCGTCGCCAGAC"	"TPC_4"
"AGTGTTGGTCGAACGA"	"TPC_4"
"AGTTAGCAGTTGGAAT"	"TPC_5"
"AGTTAGCCATAGGTTC"	"TPC_3:HighMT"
"AGTTCCCAGTTGCCTA"	"TPC_3:HighMT"
"ATACCGAAGAGAGCAA"	"TPC_5"
"ATACCGAAGCGTTAGG"	"TPC_1"
"ATACCTTCAAGCCCAC"	"TPC_2:LowCov"
"ATACCTTCATCCTTCG"	"TPC_4"
"ATACTTCAGCAAGCCA"	"TPC_2:LowCov"
"ATACTTCGTAGCGTAG"	"TPC_1"
"ATACTTCTCATTCACT"	"TPC_1"
"ATAGACCAGATTAGTG"	"TPC_2:LowCov"
"ATAGACCAGCAATTCC"	"TPC_1"
"ATAGACCAGCGTGTCC"	"TPC_1"
"ATAGAGAAGCTCACTA"	"TPC_1"
"ATAGAGACACTGGCGT"	"TPC_1"
"ATAGAGAGTGTCCCTT"	"TPC_2:LowCov"
"ATAGAGAGTTGGTAGG"	"TPC_1"
"ATATCCTAGTAGCTCT"	"TPC_2:LowCov"
"ATATCCTGTTACGTAC"	"TPC_4"
"ATATCCTTCCCGAGTG"	"TPC_2:LowCov"
"ATATCCTTCTCCGCAT"	"TPC_3:HighMT"
"ATATCCTTCTCCTGCA"	"TPC_2:LowCov"
"ATCACAGAGTACCATC"	"TPC_2:LowCov"
"ATCACAGGTAGTCGGA"	"TPC_1"
"ATCACAGGTGCCTTTC"	"TPC_2:LowCov"
"ATCACAGTCCCACAGG"	"TPC_2:LowCov"
"ATCACGAAGTCGTCTA"	"TPC_2:LowCov"
"ATCACGAGTCGGCACT"	"TPC_2:LowCov"
"ATCAGGTAGGACCCAA"	"TPC_1"
"ATCAGGTAGTTGGCTT"	"TPC_2:LowCov"
"ATCAGGTTCGGTCGGT"	"TPC_1"
"ATCAGGTTCTCTCAAT"	"TPC_5"
"ATCATTCAGGTTAGTA"	"TPC_2:LowCov"
"ATCATTCTCCGCTGTT"	"TPC_1"
"ATCATTCTCGAAGCCC"	"TPC_1"
"ATCATTCTCTCATGGA"	"TPC_1"
"ATCCACCAGGTGTGAC"	"TPC_2:LowCov"
"ATCCACCTCAGGCGAA"	"TPC_2:LowCov"
"ATCCACCTCCCATACC"	"TPC_1"
"ATCCACCTCTGCAGCG"	"TPC_2:LowCov"
"ATCCATTCAAGGTCGA"	"TPC_6:lowCov"
"ATCCATTGTAATGCGG"	"TPC_6:lowCov"
"ATCCATTGTATTCCTT"	"TPC_4"
"ATCCATTTCACGAACT"	"TPC_2:LowCov"
"ATCCCTGAGAATACAC"	"TPC_1"
"ATCCCTGAGGTTACCT"	"TPC_3:HighMT"
"ATCCCTGGTCTCACGG"	"TPC_3:HighMT"
"ATCCGTCGTACTCCGG"	"TPC_2:LowCov"
"ATCCGTCGTCGTCTCT"	"TPC_1"
"ATCGATGCAATTGCTG"	"TPC_1"
"ATCGATGCAGAGAGGG"	"TPC_2:LowCov"
"ATCGATGTCTTGTTAC"	"TPC_2:LowCov"
"ATCGCCTCAACTAGAA"	"TPC_4"
"ATCGCCTGTCACTCAA"	"TPC_2:LowCov"
"ATCGCCTTCTTGGATG"	"TPC_2:LowCov"
"ATCGGATAGTAGGATT"	"TPC_5"
"ATCGGATGTGACCTGC"	"TPC_2:LowCov"
"ATCGGATGTTAGTCGT"	"TPC_5"
"ATCGGCGCACTGGATT"	"TPC_2:LowCov"
"ATCGGCGCAGATCCTA"	"TPC_1"
"ATCGGCGGTCTCGCGA"	"TPC_5"
"ATCGGCGTCATTTGGG"	"TPC_1"
"ATCGTAGTCGGACAAG"	"TPC_2:LowCov"
"ATCGTAGTCTCCGCAT"	"TPC_1"
"ATCGTCCGTAATCAGA"	"TPC_4"
"ATCGTGAAGCACCAGA"	"TPC_1"
"ATCGTGACATATACCG"	"TPC_4"
"ATCGTGAGTAGTGGCA"	"TPC_2:LowCov"
"ATCGTGAGTCCTCAGG"	"TPC_2:LowCov"
"ATCGTGAGTGCCTGCA"	"TPC_1"
"ATCTTCAAGTTGGGAC"	"TPC_5"
"ATCTTCATCCGGCAAC"	"TPC_2:LowCov"
"ATGAAAGAGATGCTTC"	"TPC_1"
"ATGAAAGCATGACGTT"	"TPC_3:HighMT"
"ATGAAAGGTTGGATCT"	"TPC_3:HighMT"
"ATGAAAGTCGTGGGAA"	"TPC_1"
"ATGACCAAGGATATAC"	"TPC_1"
"ATGAGGGAGTTGCTCA"	"TPC_2:LowCov"
"ATGAGGGCATCCTATT"	"TPC_2:LowCov"
"ATGAGTCAGCTACTAC"	"TPC_2:LowCov"
"ATGATCGAGCGCCCAT"	"TPC_2:LowCov"
"ATGATCGCACCATAAC"	"TPC_3:HighMT"
"ATGATCGTCCGAGCTG"	"TPC_1"
"ATGCATGTCCAGTGTA"	"TPC_7"
"ATGCCTCCAACGACTT"	"TPC_2:LowCov"
"ATGCCTCCAAGTCATC"	"TPC_2:LowCov"
"ATGCCTCCAATCGCGC"	"TPC_5"
"ATGCGATCAACTCGAT"	"TPC_4"
"ATGCGATTCAAGTGGG"	"TPC_2:LowCov"
"ATGCGATTCTTCCAGC"	"TPC_4"
"ATGGAGGAGCATTGTC"	"TPC_4"
"ATGGAGGAGGGCTTCC"	"TPC_1"
"ATGGAGGCAAACGAGC"	"TPC_1"
"ATGGAGGTCACTACTT"	"TPC_2:LowCov"
"ATGGAGGTCGTCCTTG"	"TPC_5"
"ATGGATCAGCTCATAC"	"TPC_3:HighMT"
"ATGGATCAGGTGCATG"	"TPC_6:lowCov"
"ATGGATCCACTGCGTG"	"TPC_4"
"ATGGATCCAGCGTTTA"	"TPC_1"
"ATGGGAGAGGTTCCAT"	"TPC_1"
"ATGGGAGAGTAACAGT"	"TPC_5"
"ATGGGAGCAAGCACAG"	"TPC_2:LowCov"
"ATGGGAGGTACTAACC"	"TPC_3:HighMT"
"ATGGGTTAGGTGCTTT"	"TPC_6:lowCov"
"ATGGGTTTCAGGGTAG"	"TPC_6:lowCov"
"ATGGGTTTCCTTCGAC"	"TPC_2:LowCov"
"ATGGTTGGTTCAAGGG"	"TPC_1"
"ATGGTTGTCCTGGGAC"	"TPC_6:lowCov"
"ATGTCCCCAAGTCCCG"	"TPC_4"
"ATGTCTTAGCGAGTAC"	"TPC_2:LowCov"
"ATGTCTTCATGCGTGC"	"TPC_2:LowCov"
"ATGTCTTGTCCACAGC"	"TPC_2:LowCov"
"ATTACCTAGTTGCCTA"	"TPC_3:HighMT"
"ATTACCTCAGAGATGC"	"TPC_5"
"ATTACCTCATGCAGGA"	"TPC_2:LowCov"
"ATTACCTGTCGAAACG"	"TPC_3:HighMT"
"ATTACCTGTTTGTGGT"	"TPC_1"
"ATTACCTTCGACGATT"	"TPC_3:HighMT"
"ATTACTCAGAAATTCG"	"TPC_1"
"ATTACTCAGCGTCTCG"	"TPC_4"
"ATTACTCAGTAGATCA"	"TPC_1"
"ATTACTCGTCTAGATC"	"TPC_2:LowCov"
"ATTACTCTCTTGGCTC"	"TPC_1"
"ATTCACTAGTGGAATT"	"TPC_4"
"ATTCACTCACTCATAG"	"TPC_2:LowCov"
"ATTCACTCATCCGTTC"	"TPC_5"
"ATTCACTCATGGCACC"	"TPC_2:LowCov"
"ATTCAGGAGCCACTCG"	"TPC_1"
"ATTCAGGAGTAACGAT"	"TPC_4"
"ATTCAGGCAGAAGCGT"	"TPC_1"
"ATTCATCAGCTTACGT"	"TPC_1"
"ATTCATCGTGACTGAG"	"TPC_1"
"ATTCATCTCCGGTAGC"	"TPC_4"
"ATTCATCTCTTAGCCC"	"TPC_3:HighMT"
"ATTCCATAGTCCTGCG"	"TPC_4"
"ATTCCATGTTCACCGG"	"TPC_2:LowCov"
"ATTCCATTCATAGGCT"	"TPC_1"
"ATTCCTAAGCGGTAAC"	"TPC_5"
"ATTCCTACACGATAGG"	"TPC_1"
"ATTCGTTTCAAATGCC"	"TPC_6:lowCov"
"ATTCGTTTCTAGCCTC"	"TPC_4"
"ATTCTACAGGGATCGT"	"TPC_1"
"ATTCTACAGTGCAGGT"	"TPC_3:HighMT"
"ATTCTTGCACGATTCA"	"TPC_2:LowCov"
"ATTCTTGGTCCGAAAG"	"TPC_2:LowCov"
"ATTGGGTTCAGCTGAT"	"TPC_3:HighMT"
"ATTGTTCAGCCTCACG"	"TPC_2:LowCov"
"ATTGTTCAGCTCAGAG"	"TPC_3:HighMT"
"ATTGTTCAGCTTTCCC"	"TPC_1"
"ATTGTTCAGGATACAT"	"TPC_3:HighMT"
"ATTGTTCGTGCACGCT"	"TPC_1"
"ATTGTTCTCTGAGATC"	"TPC_2:LowCov"
"ATTTACCAGATTACCC"	"TPC_4"
"ATTTACCAGGTAAGAG"	"TPC_3:HighMT"
"ATTTACCCATGACGTT"	"TPC_1"
"ATTTACCGTACAGAGC"	"TPC_1"
"ATTTCACAGTACAACA"	"TPC_3:HighMT"
"ATTTCACCATCCTGTC"	"TPC_1"
"ATTTCACGTTACCTGA"	"TPC_1"
"ATTTCACTCCTGGCTT"	"TPC_2:LowCov"
"ATTTCACTCGTCCTTG"	"TPC_1"
"ATTTCTGCAAACTGCT"	"TPC_5"
"ATTTCTGCAGGAGGTT"	"TPC_1"
"CAAAGAACAGATCCAT"	"TPC_2:LowCov"
"CAAAGAAGTAGTGATA"	"TPC_1"
"CAAAGAAGTTACGGAG"	"TPC_2:LowCov"
"CAAAGAATCATTCGGA"	"TPC_4"
"CAACAACCAAATGCTC"	"TPC_5"
"CAACCAACAGGTGAGT"	"TPC_1"
"CAACCAATCAACCTTT"	"TPC_3:HighMT"
"CAACCTCAGACCTCAT"	"TPC_2:LowCov"
"CAACCTCGTCAAAGTA"	"TPC_3:HighMT"
"CAACCTCGTTAAACAG"	"TPC_1"
"CAACCTCTCGAGTTGT"	"TPC_2:LowCov"
"CAACGATGTGTCCTAA"	"TPC_3:HighMT"
"CAACGATTCAAATGCC"	"TPC_2:LowCov"
"CAACGGCCAATCGCAT"	"TPC_4"
"CAACGGCTCTGCTAGA"	"TPC_4"
"CAAGACTGTGGATCGA"	"TPC_4"
"CAAGAGGAGAACGTGC"	"TPC_2:LowCov"
"CAAGAGGAGATGTAGT"	"TPC_2:LowCov"
"CAAGAGGAGGTACTGG"	"TPC_2:LowCov"
"CAAGAGGCAGCACAGA"	"TPC_1"
"CAAGAGGCATCAGCTA"	"TPC_3:HighMT"
"CAAGAGGTCCACAGGC"	"TPC_2:LowCov"
"CAAGCTAAGACGTCCC"	"TPC_4"
"CAAGCTAAGTCAATCC"	"TPC_1"
"CAAGCTAGTTATGGTC"	"TPC_1"
"CAAGCTATCCCGAGTG"	"TPC_2:LowCov"
"CAATACGAGAAGATCT"	"TPC_3:HighMT"
"CAATCGAAGTCCCAGC"	"TPC_4"
"CAATCGAGTTGCCGCA"	"TPC_2:LowCov"
"CAATCGATCCGTATAG"	"TPC_3:HighMT"
"CAATGACCAATCGTCA"	"TPC_3:HighMT"
"CAATGACCAGTCGCTG"	"TPC_1"
"CAATGACTCTAACGCA"	"TPC_1"
"CAATTTCAGATTGATG"	"TPC_7"
"CACAACAGTAATGCGG"	"TPC_4"
"CACAACATCACCGCTT"	"TPC_3:HighMT"
"CACACAAAGCCTATCA"	"TPC_3:HighMT"
"CACACAACAATTGCCA"	"TPC_3:HighMT"
"CACACAAGTAGAAACT"	"TPC_4"
"CACACAAGTTGCCGAC"	"TPC_2:LowCov"
"CACAGATAGTAATACG"	"TPC_3:HighMT"
"CACAGATCATGTGGTT"	"TPC_4"
"CACAGATGTAATTAGG"	"TPC_2:LowCov"
"CACAGATGTGGAACCA"	"TPC_1"
"CACAGGCAGACCCTTA"	"TPC_3:HighMT"
"CACAGGCGTACAAGCG"	"TPC_5"
"CACAGGCTCCGGGACT"	"TPC_2:LowCov"
"CACATGATCCATTGCC"	"TPC_1"
"CACCAAAAGGTTCTAC"	"TPC_4"
"CACCAAATCTTACGGA"	"TPC_2:LowCov"
"CACCGTTTCATTTGGG"	"TPC_3:HighMT"
"CACGAATAGGAGAGGC"	"TPC_1"
"CACGAATAGGCTGAAC"	"TPC_1"
"CACGAATCAAGTGTCT"	"TPC_2:LowCov"
"CACGAATTCTGACGCG"	"TPC_1"
"CACGGGTCACGCTGTG"	"TPC_3:HighMT"
"CACGGGTTCGTTGTGA"	"TPC_4"
"CACGGGTTCTATTCGT"	"TPC_5"
"CACGTGGTCTAGACCA"	"TPC_2:LowCov"
"CACGTTCGTCTCAAGT"	"TPC_1"
"CACGTTCTCCGAGGCT"	"TPC_2:LowCov"
"CACTAAGAGGCCGCTT"	"TPC_1"
"CACTGAAGTGATACAA"	"TPC_1"
"CACTGGGAGTTGAAGT"	"TPC_1"
"CACTGGGCATGGCCCA"	"TPC_1"
"CACTGGGGTGCTTATG"	"TPC_1"
"CACTGGGTCCGATGTA"	"TPC_4"
"CACTGGGTCGCCGATG"	"TPC_1"
"CACTGTCCAAAGACGC"	"TPC_2:LowCov"
"CACTGTCGTATACCTG"	"TPC_1"
"CAGAGCCAGCTCTATG"	"TPC_1"
"CAGAGCCCAATACCTG"	"TPC_1"
"CAGAGCCCAGCCATTA"	"TPC_1"
"CAGAGCCCAGTCAGTT"	"TPC_5"
"CAGATACTCCACTGGG"	"TPC_2:LowCov"
"CAGATCAAGCCGATCC"	"TPC_1"
"CAGATCACAGATCATC"	"TPC_2:LowCov"
"CAGATTGAGACTAGAT"	"TPC_1"
"CAGATTGAGCTACTAC"	"TPC_3:HighMT"
"CAGATTGGTCCACTTC"	"TPC_1"
"CAGATTGTCGCCAGAC"	"TPC_4"
"CAGCAATGTTTAAGGA"	"TPC_2:LowCov"
"CAGCACGAGAAGCCAC"	"TPC_2:LowCov"
"CAGCACGAGAGGTTAT"	"TPC_1"
"CAGCAGCAGAAACCAT"	"TPC_6:lowCov"
"CAGCAGCAGCACCGTC"	"TPC_1"
"CAGCAGCAGTGCACTT"	"TPC_1"
"CAGCCAGCAGCTATTG"	"TPC_3:HighMT"
"CAGCCAGTCCGTTTCG"	"TPC_3:HighMT"
"CAGCCAGTCTCGCGTT"	"TPC_5"
"CAGCGTGAGACTAAGT"	"TPC_2:LowCov"
"CAGCGTGAGCTAGAAT"	"TPC_1"
"CAGCGTGCACAAGCTT"	"TPC_2:LowCov"
"CAGCGTGTCCTCTGCA"	"TPC_1"
"CAGGCCAAGATAGTGT"	"TPC_1"
"CAGGCCATCTGGGCGT"	"TPC_3:HighMT"
"CAGGCCATCTTCACAT"	"TPC_1"
"CAGGGCTCACAACGCC"	"TPC_2:LowCov"
"CAGGGCTCACGCCAGT"	"TPC_2:LowCov"
"CAGGGCTGTATATGGA"	"TPC_1"
"CAGGGCTGTCTTCTAT"	"TPC_4"
"CAGGGCTGTGAATTAG"	"TPC_2:LowCov"
"CAGGGCTGTGGTCCCA"	"TPC_4"
"CAGGTATTCCCTGTTG"	"TPC_3:HighMT"
"CAGTTAGAGAAACTGT"	"TPC_1"
"CAGTTAGAGATGGGCT"	"TPC_2:LowCov"
"CAGTTAGAGCCTCATA"	"TPC_5"
"CAGTTAGGTGGGACAT"	"TPC_2:LowCov"
"CAGTTAGGTTGTGTTG"	"TPC_2:LowCov"
"CAGTTCCCAATGGCCC"	"TPC_3:HighMT"
"CAGTTCCCAGGTTCAT"	"TPC_6:lowCov"
"CAGTTCCGTTCGGCTG"	"TPC_1"
"CAGTTCCGTTTGATCG"	"TPC_1"
"CATAAGCGTAGTCTTG"	"TPC_1"
"CATAAGCTCTCATGGA"	"TPC_4"
"CATACAGAGCTATCCA"	"TPC_1"
"CATACCCAGATGACAT"	"TPC_3:HighMT"
"CATACCCAGGTCACAG"	"TPC_1"
"CATACTTAGTTAGTAG"	"TPC_1"
"CATACTTTCAGAATAG"	"TPC_1"
"CATACTTTCCCATGGG"	"TPC_3:HighMT"
"CATAGACGTGCTTATG"	"TPC_1"
"CATCAAGAGTCCGTCG"	"TPC_5"
"CATCAAGCAGTAACGG"	"TPC_4"
"CATCCACTCCCAGGCA"	"TPC_1"
"CATCCCACAAACACGG"	"TPC_2:LowCov"
"CATCCCACAAGGTTGG"	"TPC_6:lowCov"
"CATCCGTAGGAAGTGA"	"TPC_4"
"CATCCGTAGGGTAGCT"	"TPC_3:HighMT"
"CATCCGTCACGTCGGT"	"TPC_1"
"CATCCGTGTACGTGTT"	"TPC_2:LowCov"
"CATCCGTGTGTGTGGA"	"TPC_2:LowCov"
"CATCGCTCAACTGGTT"	"TPC_1"
"CATCGCTCACGCCAGT"	"TPC_1"
"CATCGCTGTACAATAG"	"TPC_1"
"CATCGCTTCAACTCTT"	"TPC_4"
"CATCGCTTCAGCAGAG"	"TPC_2:LowCov"
"CATCGCTTCGCTATTT"	"TPC_2:LowCov"
"CATCGGGAGTGGCCTC"	"TPC_5"
"CATCGGGGTGGGACAT"	"TPC_1"
"CATCGGGTCACCGGTG"	"TPC_3:HighMT"
"CATCGGGTCCGTATAG"	"TPC_3:HighMT"
"CATCGTCAGACTACGG"	"TPC_3:HighMT"
"CATCGTCAGATGCGAC"	"TPC_1"
"CATCGTCAGATTGATG"	"TPC_1"
"CATCGTCAGGTGCCAA"	"TPC_1"
"CATCGTCCAAGCGCAA"	"TPC_2:LowCov"
"CATCGTCGTCACGTGC"	"TPC_4"
"CATGAGTCAGTTTCGA"	"TPC_2:LowCov"
"CATGAGTGTACTGAGG"	"TPC_4"
"CATGAGTTCGAACGGA"	"TPC_1"
"CATGCAACAAATGGTA"	"TPC_6:lowCov"
"CATGCAAGTAGGAAAG"	"TPC_1"
"CATGCCTAGGAGAATG"	"TPC_2:LowCov"
"CATGCCTGTTGTATGC"	"TPC_4"
"CATGCCTTCACCCTGT"	"TPC_1"
"CATGCGGGTATATGGA"	"TPC_5"
"CATGCGGTCAGTGTTG"	"TPC_1"
"CATGCGGTCGCAGTCG"	"TPC_1"
"CATGCTCCAACCGCTG"	"TPC_3:HighMT"
"CATGCTCCAACCGTAT"	"TPC_4"
"CATGCTCTCGATACTG"	"TPC_4"
"CATGGATAGGTTCTAC"	"TPC_2:LowCov"
"CATGGATCACGACAAG"	"TPC_1"
"CATGGATTCTCGAACA"	"TPC_2:LowCov"
"CATTCATAGATGACAT"	"TPC_1"
"CATTCATCATGACAGG"	"TPC_1"
"CATTCATGTGCTAGCC"	"TPC_1"
"CATTCATTCATTGCCC"	"TPC_1"
"CATTCATTCTAGCAAC"	"TPC_5"
"CATTCCGAGCATCAGG"	"TPC_1"
"CATTCCGCAAAGCACG"	"TPC_3:HighMT"
"CATTCCGCATCCAATG"	"TPC_5"
"CATTCTAGTACAGTTC"	"TPC_4"
"CATTCTAGTACCGGAA"	"TPC_7"
"CATTCTAGTCAAGTTC"	"TPC_4"
"CATTCTAGTGCCAAGA"	"TPC_1"
"CATTCTATCTCCTGAC"	"TPC_1"
"CATTGAGCAGCAGTCC"	"TPC_2:LowCov"
"CATTGAGTCTCAACCC"	"TPC_2:LowCov"
"CATTGCCAGTTCATCG"	"TPC_1"
"CATTGCCGTACAATAG"	"TPC_1"
"CATTGCCGTTCTCTCG"	"TPC_4"
"CATTGCCTCTTGCAAG"	"TPC_4"
"CATTGTTGTATTCCTT"	"TPC_4"
"CATTGTTTCGACACCG"	"TPC_2:LowCov"
"CATTTCAAGGAAGAAC"	"TPC_4"
"CATTTCATCGAAACAA"	"TPC_5"
"CCAAGCGCAGAGACTG"	"TPC_2:LowCov"
"CCAATGAGTTTCTATC"	"TPC_1"
"CCACAAAAGATGTAGT"	"TPC_2:LowCov"
"CCACAAAAGGGTCAAC"	"TPC_4"
"CCACACTAGAGAGTGA"	"TPC_1"
"CCACACTCAAAGCTCT"	"TPC_1"
"CCACACTGTACTAACC"	"TPC_1"
"CCACACTGTAGGTAGC"	"TPC_2:LowCov"
"CCACCATAGCTCACTA"	"TPC_1"
"CCACCATAGTATGCAA"	"TPC_1"
"CCACCATGTCCTTTGC"	"TPC_3:HighMT"
"CCACCATTCACCGGTG"	"TPC_1"
"CCACCATTCATTACCT"	"TPC_4"
"CCACGAGCAAGCGAAC"	"TPC_1"
"CCACGAGCAGGTTCCG"	"TPC_5"
"CCACGAGGTGATACTC"	"TPC_1"
"CCACGAGTCACGACTA"	"TPC_3:HighMT"
"CCACGAGTCGAGAGAC"	"TPC_1"
"CCACGTTCACAGTGAG"	"TPC_3:HighMT"
"CCACGTTTCTCGTGGG"	"TPC_1"
"CCACGTTTCTTAATCC"	"TPC_5"
"CCACTTGGTTACGGAG"	"TPC_1"
"CCATAAGAGAGTAACT"	"TPC_1"
"CCATAAGCACAAGCCC"	"TPC_1"
"CCATAAGTCAAGGACG"	"TPC_2:LowCov"
"CCCAACTAGGCCACCT"	"TPC_2:LowCov"
"CCCATTGAGGATATGT"	"TPC_5"
"CCCATTGCACAGTATC"	"TPC_4"
"CCCATTGGTGCTGCAC"	"TPC_2:LowCov"
"CCCGAAGAGTTTCGAC"	"TPC_2:LowCov"
"CCCGAAGTCAGCCCAG"	"TPC_3:HighMT"
"CCCGGAACAAGTGCTT"	"TPC_1"
"CCCGGAACAGGGTCTC"	"TPC_1"
"CCCGGAACATGGGATG"	"TPC_1"
"CCCTAACCAACCGTAT"	"TPC_2:LowCov"
"CCCTAACGTCACCCTT"	"TPC_1"
"CCCTCAAAGGTGCCAA"	"TPC_2:LowCov"
"CCCTCAACAAATACAG"	"TPC_2:LowCov"
"CCCTCAAGTATGGTTC"	"TPC_3:HighMT"
"CCCTCAATCATAGACC"	"TPC_1"
"CCCTCTCAGGGATCTG"	"TPC_2:LowCov"
"CCCTCTCAGGGTAGCT"	"TPC_1"
"CCCTCTCCAACTGCTA"	"TPC_5"
"CCCTCTCCACGCTATA"	"TPC_1"
"CCCTCTCGTAGTCGTT"	"TPC_1"
"CCCTGATCAAGAGGTC"	"TPC_4"
"CCCTGATCACTCTCGT"	"TPC_3:HighMT"
"CCCTTAGCAGCACAGA"	"TPC_3:HighMT"
"CCCTTAGGTGGGAGAG"	"TPC_1"
"CCGAACGCAGTCTACA"	"TPC_2:LowCov"
"CCGATCTAGCGACTGA"	"TPC_1"
"CCGATCTCACATGAAA"	"TPC_2:LowCov"
"CCGATCTCATGCGGTC"	"TPC_4"
"CCGATCTGTGAGCTCC"	"TPC_2:LowCov"
"CCGATGGCATTGTGCA"	"TPC_1"
"CCGATGGGTTCTCGCT"	"TPC_4"
"CCGATGGTCTCTGCTG"	"TPC_5"
"CCGCAAGAGCGGTAAC"	"TPC_1"
"CCGCAAGCAATACGCT"	"TPC_2:LowCov"
"CCGCAAGCAGACATCT"	"TPC_4"
"CCGCAAGGTAAGTTGA"	"TPC_1"
"CCGCAAGTCAGGAAAT"	"TPC_2:LowCov"
"CCGCAAGTCAGTCAGT"	"TPC_6:lowCov"
"CCGGACACAATTCTCT"	"TPC_3:HighMT"
"CCGGGTAAGGGAGATA"	"TPC_2:LowCov"
"CCGGGTAAGTCATGAA"	"TPC_2:LowCov"
"CCGGGTACATGCCGCA"	"TPC_2:LowCov"
"CCGGTAGCATCCTAAG"	"TPC_1"
"CCGGTAGGTTCAACGT"	"TPC_2:LowCov"
"CCGGTAGTCGCTTGAA"	"TPC_2:LowCov"
"CCGGTGAAGAGAGAAC"	"TPC_1"
"CCGGTGAAGAGGTATT"	"TPC_4"
"CCGGTGAGTGATATAG"	"TPC_1"
"CCGGTGATCGTCTACC"	"TPC_5"
"CCGGTGATCTACTCAT"	"TPC_2:LowCov"
"CCGTAGGCAGCGGTTC"	"TPC_4"
"CCGTAGGCATCTTAGG"	"TPC_6:lowCov"
"CCGTAGGGTGCAGGAT"	"TPC_1"
"CCGTTCACACGTAGTT"	"TPC_2:LowCov"
"CCGTTCAGTAGAGTTA"	"TPC_2:LowCov"
"CCGTTCAGTTTAAGGA"	"TPC_1"
"CCGTTCATCTCGCCTA"	"TPC_5"
"CCTAACCCAAGTTGGG"	"TPC_5"
"CCTAACCCATCCGAAT"	"TPC_2:LowCov"
"CCTAACCGTAAGATCA"	"TPC_4"
"CCTAACCGTGTATCCA"	"TPC_2:LowCov"
"CCTAACCTCTTCTCAA"	"TPC_2:LowCov"
"CCTAAGAAGATCCCGC"	"TPC_4"
"CCTAAGAGTAGCTAAA"	"TPC_6:lowCov"
"CCTAAGATCCTCAGGG"	"TPC_4"
"CCTAAGATCGTGGTAT"	"TPC_3:HighMT"
"CCTACGTAGTTGGAGC"	"TPC_1"
"CCTACGTCACAATGTC"	"TPC_1"
"CCTACGTTCATTCACT"	"TPC_3:HighMT"
"CCTATCGAGTCCGTCG"	"TPC_3:HighMT"
"CCTATCGCAAAGTGTA"	"TPC_4"
"CCTATCGCACTCGATA"	"TPC_2:LowCov"
"CCTCACAAGTGGCGAT"	"TPC_2:LowCov"
"CCTCACACAACGTATC"	"TPC_2:LowCov"
"CCTCAGTAGCGCACAA"	"TPC_1"
"CCTCAGTCACGACCTG"	"TPC_2:LowCov"
"CCTCAGTCACTGCACG"	"TPC_1"
"CCTCATGAGGGCCAAT"	"TPC_2:LowCov"
"CCTCCAACAGGTCTCG"	"TPC_2:LowCov"
"CCTCCAAGTGGGACAT"	"TPC_2:LowCov"
"CCTCCAATCATTTGCT"	"TPC_3:HighMT"
"CCTCCAATCCAGTACA"	"TPC_2:LowCov"
"CCTCCAATCGAGCCTG"	"TPC_3:HighMT"
"CCTCCTCTCAAATGCC"	"TPC_1"
"CCTCCTCTCTAGCCTC"	"TPC_2:LowCov"
"CCTCTAGAGACCAAGC"	"TPC_1"
"CCTCTCCAGTAGACCG"	"TPC_1"
"CCTCTCCGTCGAAGCA"	"TPC_2:LowCov"
"CCTCTCCGTGCCGTTG"	"TPC_4"
"CCTGCATAGGTAAACT"	"TPC_2:LowCov"
"CCTGCATGTGCGCTCA"	"TPC_2:LowCov"
"CCTGTTGAGGGACCAT"	"TPC_2:LowCov"
"CCTGTTGAGTATAGGT"	"TPC_3:HighMT"
"CCTGTTGCAAAGGTTA"	"TPC_4"
"CCTGTTGGTTGCCTAA"	"TPC_4"
"CCTTCAGCAAAGCACG"	"TPC_3:HighMT"
"CCTTGTGCACGTCGTG"	"TPC_1"
"CCTTGTGGTATGACAA"	"TPC_3:HighMT"
"CCTTGTGGTGTAGGAC"	"TPC_2:LowCov"
"CCTTGTGTCCACGAAT"	"TPC_1"
"CCTTTGGCAATTTCTC"	"TPC_2:LowCov"
"CCTTTGGCACCCAAGC"	"TPC_2:LowCov"
"CCTTTGGCACCGCTAG"	"TPC_6:lowCov"
"CGAAGGAAGAGGTATT"	"TPC_1"
"CGAAGGAAGGGCAATC"	"TPC_4"
"CGAAGTTAGCTGCCTG"	"TPC_2:LowCov"
"CGAAGTTCAAACTAAG"	"TPC_2:LowCov"
"CGAAGTTCATGCGTGC"	"TPC_4"
"CGAAGTTGTAAGGCTG"	"TPC_5"
"CGAATTGCAACGAGGT"	"TPC_2:LowCov"
"CGACAGCAGTAGCATA"	"TPC_3:HighMT"
"CGACAGCCATGATAGA"	"TPC_1"
"CGAGAAGTCGCCAGTG"	"TPC_2:LowCov"
"CGAGAAGTCTCGGGAC"	"TPC_3:HighMT"
"CGAGGAAAGTGCAAAT"	"TPC_2:LowCov"
"CGAGGAAGTGTGATGG"	"TPC_1"
"CGAGGAAGTGTGTCCG"	"TPC_1"
"CGAGGAAGTTTATGCG"	"TPC_1"
"CGAGGAATCGAAATCC"	"TPC_4"
"CGAGGCTCAATGCTCA"	"TPC_3:HighMT"
"CGAGGCTCAGTCGCTG"	"TPC_3:HighMT"
"CGAGGCTGTCTAGATC"	"TPC_1"
"CGAGTGCCAGCTGAGA"	"TPC_2:LowCov"
"CGAGTTAAGCCTCTGG"	"TPC_1"
"CGAGTTAAGTGTGTTC"	"TPC_4"
"CGAGTTACACAGTCGC"	"TPC_1"
"CGAGTTAGTATCTCGA"	"TPC_2:LowCov"
"CGAGTTAGTATGAGGC"	"TPC_2:LowCov"
"CGAGTTAGTGACAGCA"	"TPC_1"
"CGAGTTATCGCGGACT"	"TPC_1"
"CGATCGGGTTATCTTC"	"TPC_2:LowCov"
"CGATCGGTCATTTGCT"	"TPC_5"
"CGATGCGGTGTCCACG"	"TPC_1"
"CGATGCGTCTGGGTCG"	"TPC_3:HighMT"
"CGATGGCAGATCCCAT"	"TPC_5"
"CGATGGCAGGTTCATC"	"TPC_2:LowCov"
"CGATGGCCAAGTTCGT"	"TPC_3:HighMT"
"CGATGGCGTCCATAGT"	"TPC_1"
"CGATGGCGTTATAGAG"	"TPC_4"
"CGATGGCTCCACAAGT"	"TPC_4"
"CGCAGGTCACTAGAGG"	"TPC_5"
"CGCAGGTGTGACTATC"	"TPC_1"
"CGCATAAAGTAGCCAG"	"TPC_5"
"CGCATAAGTATGCTTG"	"TPC_5"
"CGCATAATCCCGATCT"	"TPC_3:HighMT"
"CGCATGGGTTATGACC"	"TPC_4"
"CGCCAGAAGAGGCGGA"	"TPC_4"
"CGCCAGAAGAGGGTGG"	"TPC_4"
"CGCCAGAGTGTGAATA"	"TPC_5"
"CGCCAGATCCTTATCA"	"TPC_1"
"CGCCAGATCGAACCTA"	"TPC_3:HighMT"
"CGCCATTGTACGGGAT"	"TPC_2:LowCov"
"CGCCATTTCACTCACC"	"TPC_2:LowCov"
"CGCGTGACACGGATCC"	"TPC_4"
"CGCGTGACAGGCGAAT"	"TPC_1"
"CGCGTGAGTACCATAC"	"TPC_4"
"CGCGTGATCCGTTGGG"	"TPC_2:LowCov"
"CGCGTGATCGTGGTAT"	"TPC_3:HighMT"
"CGCGTGATCTGTGCAA"	"TPC_2:LowCov"
"CGGAACCCAAATCCCA"	"TPC_2:LowCov"
"CGGAACCGTATGGTAA"	"TPC_1"
"CGGAACCTCACCACAA"	"TPC_2:LowCov"
"CGGAACCTCTAGACAC"	"TPC_1"
"CGGAATTAGCTGACCC"	"TPC_2:LowCov"
"CGGAATTCAGCAGTAG"	"TPC_1"
"CGGAATTGTTAATCGC"	"TPC_1"
"CGGAATTTCGGTCATA"	"TPC_2:LowCov"
"CGGAATTTCGTTCGCT"	"TPC_4"
"CGGACACTCCCATACC"	"TPC_1"
"CGGAGAACAATGAACA"	"TPC_3:HighMT"
"CGGAGAACACAATGTC"	"TPC_5"
"CGGAGAACATGAAGGC"	"TPC_1"
"CGGAGAATCAAGGCTT"	"TPC_2:LowCov"
"CGGCAGTAGTAAATGC"	"TPC_3:HighMT"
"CGGCAGTGTAACAGTA"	"TPC_1"
"CGGCAGTTCGACCATA"	"TPC_1"
"CGGGCATAGTTAGTGA"	"TPC_5"
"CGGGCATCATACCGTA"	"TPC_4"
"CGGGCATTCAAACGTC"	"TPC_1"
"CGGGCATTCGTAGTCA"	"TPC_1"
"CGGGTCAAGGTAAACT"	"TPC_3:HighMT"
"CGGGTCAAGTAACCTC"	"TPC_1"
"CGGGTCATCCGAGATT"	"TPC_1"
"CGGGTCATCCTAGAGT"	"TPC_4"
"CGGGTGTGTGTTCATG"	"TPC_5"
"CGGTCAGCAAGTCCCG"	"TPC_2:LowCov"
"CGGTCAGGTATCGTGT"	"TPC_4"
"CGTAAGTCATACAGAA"	"TPC_3:HighMT"
"CGTAAGTGTATTAAGG"	"TPC_4"
"CGTAATGAGCGACATG"	"TPC_1"
"CGTAATGGTATGAAAC"	"TPC_1"
"CGTAGTACAAACACGG"	"TPC_1"
"CGTAGTACAATGTCAC"	"TPC_1"
"CGTAGTACACCGTCTT"	"TPC_1"
"CGTAGTACATGACAGG"	"TPC_2:LowCov"
"CGTAGTATCACTGGGC"	"TPC_4"
"CGTCAAAAGAGGGTAA"	"TPC_1"
"CGTCAAACAGTACTAC"	"TPC_2:LowCov"
"CGTCAAACATTGAAAG"	"TPC_3:HighMT"
"CGTCAAAGTCCACGCA"	"TPC_1"
"CGTCAAAGTCCGAAAG"	"TPC_5"
"CGTCAAAGTGTATTCG"	"TPC_2:LowCov"
"CGTCAAAGTTTAGAGA"	"TPC_3:HighMT"
"CGTCCATAGATTGACA"	"TPC_1"
"CGTCCATGTGCTAGCC"	"TPC_1"
"CGTGAATCAGCGTTGC"	"TPC_3:HighMT"
"CGTGAATCATCTTAGG"	"TPC_4"
"CGTGAATTCCTTCAGC"	"TPC_2:LowCov"
"CGTGATACATATCTCT"	"TPC_2:LowCov"
"CGTGCTTCACTCTGCT"	"TPC_1"
"CGTGCTTCATCTTTCA"	"TPC_3:HighMT"
"CGTGCTTGTGACAACG"	"TPC_5"
"CGTGCTTGTGGAAATT"	"TPC_1"
"CGTGCTTTCTAGAACC"	"TPC_1"
"CGTGTCTCAAATTGGA"	"TPC_1"
"CGTGTCTGTTGAGTCT"	"TPC_5"
"CGTGTCTTCAATCTCT"	"TPC_6:lowCov"
"CGTTAGAAGATTGGGC"	"TPC_2:LowCov"
"CGTTCTGCACATGAAA"	"TPC_5"
"CGTTCTGGTTAGGGTG"	"TPC_4"
"CGTTCTGTCGTCAACA"	"TPC_2:LowCov"
"CGTTGGGAGGTCACCC"	"TPC_5"
"CGTTGGGTCACTACTT"	"TPC_1"
"CGTTGGGTCGCTTGCT"	"TPC_1"
"CTAACCCAGTGCAACG"	"TPC_1"
"CTAACCCAGTTGGCTT"	"TPC_6:lowCov"
"CTAACCCCAGCTCGGT"	"TPC_4"
"CTAACCCTCCAAGGGA"	"TPC_4"
"CTAACTTGTCAACATC"	"TPC_2:LowCov"
"CTAACTTTCATTTCGT"	"TPC_3:HighMT"
"CTAACTTTCGGAGCAA"	"TPC_2:LowCov"
"CTAAGTGAGACTCATC"	"TPC_2:LowCov"
"CTAAGTGCATGCCGGT"	"TPC_2:LowCov"
"CTACAGAAGCGTTCCG"	"TPC_4"
"CTACAGACAGGTCTCG"	"TPC_3:HighMT"
"CTACATTAGCCATTCA"	"TPC_3:HighMT"
"CTACATTAGCGTGCCT"	"TPC_2:LowCov"
"CTACATTAGGCTATCT"	"TPC_2:LowCov"
"CTACATTCACCAGCCA"	"TPC_2:LowCov"
"CTACATTTCCCGAACG"	"TPC_1"
"CTACCCAAGAGGTCAC"	"TPC_4"
"CTACCCAAGTGGATAT"	"TPC_2:LowCov"
"CTACCCACACTTCCTG"	"TPC_2:LowCov"
"CTACCCATCACTCTTA"	"TPC_5"
"CTACCCATCGGACTTA"	"TPC_3:HighMT"
"CTACCCATCTGGTGCG"	"TPC_2:LowCov"
"CTACCTGCACAGGATG"	"TPC_2:LowCov"
"CTACCTGCACGGGTAA"	"TPC_1"
"CTACCTGGTACCAGAG"	"TPC_4"
"CTACGGGAGTCGGCCT"	"TPC_5"
"CTACGGGGTTACGTAC"	"TPC_1"
"CTACGGGTCATTGCTT"	"TPC_2:LowCov"
"CTACTATTCGGAATGG"	"TPC_2:LowCov"
"CTAGACAGTTCCGCTT"	"TPC_2:LowCov"
"CTAGACATCAGTCATG"	"TPC_2:LowCov"
"CTAGGTAGTCTACACA"	"TPC_1"
"CTAGGTATCACCGGTG"	"TPC_1"
"CTATAGGTCTCTAAGG"	"TPC_5"
"CTATCCGCACATTACG"	"TPC_2:LowCov"
"CTATCCGCATGACAGG"	"TPC_4"
"CTATCCGGTGACTCTA"	"TPC_1"
"CTATCCGTCGAGTGAG"	"TPC_4"
"CTATCTACAACGGGTA"	"TPC_1"
"CTATCTATCGCCTATC"	"TPC_2:LowCov"
"CTCAACCAGATGACAT"	"TPC_1"
"CTCAACCCAATTCACG"	"TPC_1"
"CTCAACCCAGGCAATG"	"TPC_3:HighMT"
"CTCAAGAAGGTTCAGG"	"TPC_6:lowCov"
"CTCAAGAGTTCGGACC"	"TPC_1"
"CTCAAGATCGGCATAT"	"TPC_1"
"CTCAATTCACACCGAC"	"TPC_1"
"CTCACTGAGGTCACAG"	"TPC_2:LowCov"
"CTCACTGAGTGAATAC"	"TPC_1"
"CTCACTGGTCCTATAG"	"TPC_2:LowCov"
"CTCACTGGTGGCTACC"	"TPC_3:HighMT"
"CTCACTGTCATCTACT"	"TPC_3:HighMT"
"CTCAGAAAGAATCCCT"	"TPC_3:HighMT"
"CTCAGAACAGACCTAT"	"TPC_1"
"CTCAGAAGTGAATATG"	"TPC_2:LowCov"
"CTCAGGGAGCCTTTGA"	"TPC_2:LowCov"
"CTCAGGGTCGTGACTA"	"TPC_2:LowCov"
"CTCAGTCAGTACCCTA"	"TPC_1"
"CTCAGTCCACACACTA"	"TPC_5"
"CTCATCGAGCTAAACA"	"TPC_6:lowCov"
"CTCATCGAGGACAAGA"	"TPC_5"
"CTCATCGAGTAGGTTA"	"TPC_1"
"CTCATGCAGCCATTCA"	"TPC_1"
"CTCATGCAGTAATCCC"	"TPC_2:LowCov"
"CTCATGCAGTACTCGT"	"TPC_4"
"CTCATGCCAACCGATT"	"TPC_1"
"CTCATGCTCCTGCTAC"	"TPC_2:LowCov"
"CTCATTACATCCGAGC"	"TPC_2:LowCov"
"CTCCAACAGGCCTAAG"	"TPC_2:LowCov"
"CTCCAACAGTGATTCC"	"TPC_1"
"CTCCAACGTAAGTTGA"	"TPC_2:LowCov"
"CTCCAACTCACTGCTC"	"TPC_4"
"CTCCACACATGACAGG"	"TPC_1"
"CTCCACAGTATGTCAC"	"TPC_3:HighMT"
"CTCCACATCGAGCACC"	"TPC_1"
"CTCCATGGTAGCCCTG"	"TPC_4"
"CTCCATGGTCATCTAG"	"TPC_3:HighMT"
"CTCCATGTCACTTCTA"	"TPC_1"
"CTCCATGTCCCGAGGT"	"TPC_2:LowCov"
"CTCCATGTCCTTCTGG"	"TPC_2:LowCov"
"CTCCCAAGTTTCAGAC"	"TPC_1"
"CTCCCTCCACTGAATC"	"TPC_4"
"CTCCCTCGTAGTCTTG"	"TPC_2:LowCov"
"CTCCCTCGTCATAACC"	"TPC_2:LowCov"
"CTCCCTCTCATTCGTT"	"TPC_2:LowCov"
"CTCCGATAGACGGTCA"	"TPC_2:LowCov"
"CTCCGATCAAGTACCT"	"TPC_3:HighMT"
"CTCCGATCAGCACACC"	"TPC_2:LowCov"
"CTCCTCCAGAAGCCTG"	"TPC_1"
"CTCCTCCTCGAACGCC"	"TPC_2:LowCov"
"CTCCTCCTCGTAGCTA"	"TPC_2:LowCov"
"CTCCTTTCACAGCTTA"	"TPC_1"
"CTCCTTTGTACTAACC"	"TPC_5"
"CTCGAGGCAGGAAGTC"	"TPC_4"
"CTCGAGGTCCTGGTCT"	"TPC_1"
"CTCTCAGCACGACGCT"	"TPC_1"
"CTCTCAGCAGCAAGAC"	"TPC_1"
"CTCTCAGGTACAATAG"	"TPC_1"
"CTCTCAGGTACGTTCA"	"TPC_4"
"CTCTCAGGTGCCGGTT"	"TPC_1"
"CTCTCGACAACCTATG"	"TPC_4"
"CTCTCGAGTGCAACGA"	"TPC_4"
"CTCTCGATCTACGGTA"	"TPC_3:HighMT"
"CTCTGGTCACCGGCTA"	"TPC_5"
"CTGAATGCATCTGCGG"	"TPC_5"
"CTGAGCGAGAAACACT"	"TPC_1"
"CTGAGCGCAAATGGAT"	"TPC_1"
"CTGAGCGCATGACAAA"	"TPC_1"
"CTGAGGCTCCATTCAT"	"TPC_1"
"CTGATCCAGCAATAGT"	"TPC_2:LowCov"
"CTGATCCCAGCTACAT"	"TPC_3:HighMT"
"CTGCAGGCACGCAGTC"	"TPC_5"
"CTGCAGGCAGAATTCC"	"TPC_4"
"CTGCAGGCATAGGTTC"	"TPC_6:lowCov"
"CTGCATCCATAGTCGT"	"TPC_1"
"CTGCCATCACCATATG"	"TPC_1"
"CTGCCATGTCCACATA"	"TPC_2:LowCov"
"CTGCCATTCCGGTTCT"	"TPC_4"
"CTGCCATTCGAAGAAT"	"TPC_3:HighMT"
"CTGCCATTCGTGGGAA"	"TPC_1"
"CTGCCTAGTAACTGCT"	"TPC_1"
"CTGCCTAGTACGAAAT"	"TPC_1"
"CTGCCTATCAACGTGT"	"TPC_1"
"CTGCGAGCATCGGTTA"	"TPC_1"
"CTGCGAGTCTGAATGC"	"TPC_1"
"CTGCTCATCCTGGCTT"	"TPC_5"
"CTGGACGCACTACGGC"	"TPC_1"
"CTGGACGGTAGGCTGA"	"TPC_2:LowCov"
"CTGGCAGAGACTTCCA"	"TPC_1"
"CTGGCAGGTGAAGCGT"	"TPC_2:LowCov"
"CTGGCAGGTGCCCACA"	"TPC_2:LowCov"
"CTGGCAGTCCATTCGC"	"TPC_1"
"CTGGCAGTCGCGGACT"	"TPC_1"
"CTGGTCTAGCATGGGT"	"TPC_4"
"CTGGTCTCAGAGAAAG"	"TPC_2:LowCov"
"CTGGTCTCAGAGAGGG"	"TPC_2:LowCov"
"CTGGTCTCAGCTACAT"	"TPC_2:LowCov"
"CTGGTCTCATAGGTAA"	"TPC_1"
"CTGGTCTGTGTGCTTA"	"TPC_2:LowCov"
"CTGGTCTTCACCATCC"	"TPC_3:HighMT"
"CTGGTCTTCGTTGTGA"	"TPC_3:HighMT"
"CTGTACCCATAATGAG"	"TPC_3:HighMT"
"CTGTACCCATTCTCCG"	"TPC_5"
"CTGTACCGTATCACGT"	"TPC_5"
"CTGTACCTCGCTTTAT"	"TPC_4"
"CTGTAGACACTAGGTT"	"TPC_4"
"CTGTAGACACTGAGTT"	"TPC_1"
"CTGTAGACAGACCAAG"	"TPC_1"
"CTGTAGACAGTAGATA"	"TPC_2:LowCov"
"CTGTAGACATTCATCT"	"TPC_2:LowCov"
"CTGTAGAGTATTGCCA"	"TPC_1"
"CTGTAGAGTCTGTAGT"	"TPC_1"
"CTGTATTCAGCACACC"	"TPC_3:HighMT"
"CTGTCGTAGCAAGCCA"	"TPC_1"
"CTGTGAACATGAATAG"	"TPC_3:HighMT"
"CTGTGAAGTATCGCGC"	"TPC_3:HighMT"
"CTGTGGGTCACCTCTG"	"TPC_4"
"CTTACCGCATTACGGT"	"TPC_2:LowCov"
"CTTACCGGTTGCGGCT"	"TPC_2:LowCov"
"CTTAGGAAGATTACCC"	"TPC_4"
"CTTAGGAGTGCACATT"	"TPC_5"
"CTTAGGATCTTAGCTT"	"TPC_2:LowCov"
"CTTCAATAGAAACACT"	"TPC_1"
"CTTCAATAGAAACTAC"	"TPC_2:LowCov"
"CTTCAATAGCGGACAT"	"TPC_1"
"CTTCAATTCAGATGCT"	"TPC_1"
"CTTCAATTCGCCAATA"	"TPC_2:LowCov"
"CTTCCGACAAAGCACG"	"TPC_1"
"CTTCCGATCCGTCCTA"	"TPC_2:LowCov"
"CTTCCTTAGCCTCGTG"	"TPC_1"
"CTTCCTTCATCCGATA"	"TPC_2:LowCov"
"CTTCCTTCATTGAAGA"	"TPC_3:HighMT"
"CTTCCTTTCTACTGCC"	"TPC_2:LowCov"
"CTTCGGTGTAGGACTG"	"TPC_2:LowCov"
"CTTCGGTGTTAGAGTA"	"TPC_3:HighMT"
"CTTCGGTTCCACTTCG"	"TPC_4"
"CTTCGGTTCGCTGATA"	"TPC_1"
"CTTCTAACAAAGCTCT"	"TPC_1"
"CTTCTAACACAGAGAC"	"TPC_3:HighMT"
"CTTCTAATCAAGTCGT"	"TPC_2:LowCov"
"CTTCTAATCATTACCT"	"TPC_5"
"CTTCTAATCCCATAAG"	"TPC_2:LowCov"
"CTTCTCTTCCTCGATC"	"TPC_2:LowCov"
"CTTCTCTTCTGCATGA"	"TPC_2:LowCov"
"CTTCTCTTCTGGTTGA"	"TPC_1"
"CTTGAGAAGAATCGCG"	"TPC_1"
"CTTGAGAAGCCTGAGA"	"TPC_2:LowCov"
"CTTGATTTCCGCAACG"	"TPC_1"
"CTTGATTTCGACCATA"	"TPC_3:HighMT"
"CTTGATTTCGAGATAA"	"TPC_5"
"CTTGATTTCGGCTGTG"	"TPC_4"
"CTTTCAATCTGTAACG"	"TPC_4"
"CTTTCGGAGGACACTG"	"TPC_1"
"CTTTCGGGTGCCTGAC"	"TPC_1"
"CTTTCGGTCCGAGGCT"	"TPC_4"
"GAAATGAAGCTTCGTA"	"TPC_5"
"GAAATGACAACGGTAG"	"TPC_1"
"GAACACTCAATAACGA"	"TPC_5"
"GAACACTCACGTCTCT"	"TPC_4"
"GAACACTCATTAAAGG"	"TPC_1"
"GAACACTGTGCAACAG"	"TPC_2:LowCov"
"GAACACTGTGCGACAA"	"TPC_1"
"GAACACTTCCTATGGA"	"TPC_2:LowCov"
"GAACGTTGTGTTACTG"	"TPC_1"
"GAACTGTAGGTGCCTC"	"TPC_2:LowCov"
"GAACTGTAGTATTGCC"	"TPC_5"
"GAACTGTAGTCTCTGA"	"TPC_2:LowCov"
"GAACTGTTCATAGACC"	"TPC_3:HighMT"
"GAAGAATCATCGGAGA"	"TPC_1"
"GAAGAATTCCTAGCTC"	"TPC_5"
"GAAGCGACATCCTCAC"	"TPC_1"
"GAAGGACAGCAATAGT"	"TPC_4"
"GAAGGACGTAGAGCTG"	"TPC_1"
"GAAGGACTCGCAATTG"	"TPC_2:LowCov"
"GAAGGACTCGTGTGAT"	"TPC_3:HighMT"
"GAAGTAACAAGTTCCA"	"TPC_2:LowCov"
"GAAGTAACACTGCATA"	"TPC_2:LowCov"
"GAAGTAAGTAGGACCA"	"TPC_1"
"GAAGTAAGTGTCTCCT"	"TPC_2:LowCov"
"GAATAGAGTCTAATCG"	"TPC_2:LowCov"
"GAATAGAGTTCTCACC"	"TPC_1"
"GAATCACAGGGTTAAT"	"TPC_3:HighMT"
"GAATCACCATAGAATG"	"TPC_1"
"GAATCGTGTCATCGCG"	"TPC_2:LowCov"
"GACACGCCACGGGTAA"	"TPC_5"
"GACACGCCAGAACTAA"	"TPC_2:LowCov"
"GACACGCCAGACCAAG"	"TPC_2:LowCov"
"GACACGCCATTGACTG"	"TPC_5"
"GACATCAGTATTGACC"	"TPC_7"
"GACATCAGTCTACGAT"	"TPC_2:LowCov"
"GACCAATTCACCGCTT"	"TPC_4"
"GACCCAGAGCTCCCTT"	"TPC_1"
"GACCCAGAGGTTCTAC"	"TPC_4"
"GACCCAGCATGATCTG"	"TPC_1"
"GACCCTTAGTCTACCA"	"TPC_2:LowCov"
"GACCCTTCACTACCGG"	"TPC_4"
"GACCCTTGTAACACGG"	"TPC_1"
"GACCCTTGTTATGTGC"	"TPC_2:LowCov"
"GACCGTGGTCCGGCAT"	"TPC_1"
"GACCGTGTCTGGGAGA"	"TPC_4"
"GACCTTCAGAATCGCG"	"TPC_1"
"GACCTTCTCGACATTG"	"TPC_4"
"GACGCTGGTCTCACAA"	"TPC_2:LowCov"
"GACGCTGTCAGCTCTC"	"TPC_2:LowCov"
"GACGTTAAGGGCCCTT"	"TPC_3:HighMT"
"GACGTTATCATGCAGT"	"TPC_5"
"GACTATGAGAGTCTTC"	"TPC_7"
"GACTATGAGATCCCAT"	"TPC_3:HighMT"
"GACTATGAGTCCGCGT"	"TPC_5"
"GACTATGCACGCGCTA"	"TPC_3:HighMT"
"GACTCAAAGAGGGTAA"	"TPC_2:LowCov"
"GACTCAAAGATAGCTA"	"TPC_2:LowCov"
"GACTCAAGTGTAAACA"	"TPC_2:LowCov"
"GACTCAATCAGAATAG"	"TPC_3:HighMT"
"GACTCTCGTATTGCCA"	"TPC_2:LowCov"
"GACTGATAGTCGTCTA"	"TPC_2:LowCov"
"GACTGATTCCTTGAAG"	"TPC_2:LowCov"
"GACTTCCAGGCTCTAT"	"TPC_3:HighMT"
"GACTTCCTCCAGTACA"	"TPC_1"
"GAGAAATGTGAGCGAT"	"TPC_3:HighMT"
"GAGAAATTCTCGTCGT"	"TPC_7"
"GAGACCCAGTACAGAT"	"TPC_1"
"GAGACTTAGACAGTCG"	"TPC_2:LowCov"
"GAGACTTAGCGGTAGT"	"TPC_1"
"GAGACTTAGGACACTG"	"TPC_2:LowCov"
"GAGAGGTTCTCATGCC"	"TPC_3:HighMT"
"GAGATGGAGGCGTCCT"	"TPC_3:HighMT"
"GAGATGGGTGGAAATT"	"TPC_3:HighMT"
"GAGCCTGTCATTTGGG"	"TPC_1"
"GAGCTGCAGAACTGAT"	"TPC_1"
"GAGCTGCAGACATCAA"	"TPC_1"
"GAGCTGCCATGGAAGC"	"TPC_2:LowCov"
"GAGGCAAAGTTCATCG"	"TPC_1"
"GAGGCAACACTAACGT"	"TPC_2:LowCov"
"GAGGCCTAGGTTTGAA"	"TPC_2:LowCov"
"GAGGCCTAGTCTCTGA"	"TPC_4"
"GAGGGTAAGGTGAGCT"	"TPC_3:HighMT"
"GAGGGTAGTGGTCCGT"	"TPC_2:LowCov"
"GAGGGTATCCCTCTTT"	"TPC_7"
"GAGGGTATCGACGACC"	"TPC_3:HighMT"
"GAGGGTATCTAGACCA"	"TPC_6:lowCov"
"GAGTCATAGTCGCTAT"	"TPC_2:LowCov"
"GAGTCATCATCCTGTC"	"TPC_5"
"GAGTCATGTTATTCTC"	"TPC_2:LowCov"
"GAGTCATTCAATCAGC"	"TPC_1"
"GAGTCATTCTGCTGAA"	"TPC_2:LowCov"
"GAGTCTACATAATCGC"	"TPC_1"
"GAGTCTAGTATTGCCA"	"TPC_3:HighMT"
"GAGTGAGAGCATGAAT"	"TPC_4"
"GAGTGAGAGGGTAGCT"	"TPC_5"
"GAGTGAGCAAGGAGTC"	"TPC_4"
"GAGTGAGTCTTTCCGG"	"TPC_1"
"GAGTGTTAGACGACGT"	"TPC_5"
"GAGTGTTGTATACGGG"	"TPC_2:LowCov"
"GAGTGTTTCCCAGGAC"	"TPC_3:HighMT"
"GAGTGTTTCGGCAGTC"	"TPC_4"
"GAGTTACAGGATAATC"	"TPC_5"
"GAGTTACCAAGAAACT"	"TPC_3:HighMT"
"GAGTTGTTCTAAGAAG"	"TPC_1"
"GAGTTTGCAGTTAGGG"	"TPC_1"
"GAGTTTGTCTAACACG"	"TPC_1"
"GATAGAATCCTGTTAT"	"TPC_2:LowCov"
"GATAGCTAGTCGAAGC"	"TPC_2:LowCov"
"GATAGCTTCACGATCA"	"TPC_2:LowCov"
"GATCACATCGTTCTAT"	"TPC_2:LowCov"
"GATCAGTAGTGCGACA"	"TPC_1"
"GATCATGTCGGAGTAG"	"TPC_1"
"GATCCCTGTTCTCGTC"	"TPC_4"
"GATCCCTTCAAGCCGC"	"TPC_4"
"GATCCCTTCCCGAGAC"	"TPC_1"
"GATCGTACACTCCACT"	"TPC_2:LowCov"
"GATCGTATCTGGTTGA"	"TPC_6:lowCov"
"GATGACTCAAACGTGG"	"TPC_4"
"GATGACTCAGATACTC"	"TPC_2:LowCov"
"GATGACTCATAGAAAC"	"TPC_4"
"GATGACTTCAGAGTGG"	"TPC_1"
"GATGACTTCGTGCGAC"	"TPC_1"
"GATGAGGCAACACTAC"	"TPC_2:LowCov"
"GATGATCAGAGGACTC"	"TPC_2:LowCov"
"GATGGAGCACCGCTAG"	"TPC_1"
"GATGTTGAGACATCAA"	"TPC_3:HighMT"
"GATGTTGGTAAGCGGT"	"TPC_2:LowCov"
"GATGTTGGTATCGCGC"	"TPC_2:LowCov"
"GATGTTGTCAAGTCGT"	"TPC_1"
"GATGTTGTCTAACACG"	"TPC_1"
"GATTCGACATCGGATT"	"TPC_1"
"GATTCGAGTGACTGAG"	"TPC_1"
"GATTCTTCATAGGCGA"	"TPC_1"
"GATTCTTGTGTCCATA"	"TPC_1"
"GATTGGTCACAAAGCG"	"TPC_5"
"GATTGGTCATAGTCGT"	"TPC_1"
"GATTGGTCATGCAGCC"	"TPC_2:LowCov"
"GATTTCTAGAGCACTG"	"TPC_2:LowCov"
"GATTTCTGTCATCACA"	"TPC_2:LowCov"
"GATTTCTTCAAGCCGC"	"TPC_2:LowCov"
"GCAACATAGGCCTTCG"	"TPC_1"
"GCAACATGTCCTCATC"	"TPC_5"
"GCAACATTCCGTGTCT"	"TPC_4"
"GCACATAAGGTCGAGT"	"TPC_2:LowCov"
"GCACATAAGTTCATGC"	"TPC_1"
"GCACATAGTCCAGGTC"	"TPC_2:LowCov"
"GCACATATCTCTAGGA"	"TPC_1"
"GCACGGTCAATTGTGC"	"TPC_5"
"GCACGTGAGGGAGGCA"	"TPC_2:LowCov"
"GCACGTGTCCGCGGAT"	"TPC_5"
"GCACTAACACATATCG"	"TPC_3:HighMT"
"GCACTAACAGAGATTA"	"TPC_2:LowCov"
"GCACTAAGTGTCACAT"	"TPC_2:LowCov"
"GCAGCCAAGAGGTATT"	"TPC_5"
"GCAGCCACACCAGTAT"	"TPC_1"
"GCAGCCACACTTCATT"	"TPC_5"
"GCAGCCAGTATTGACC"	"TPC_5"
"GCAGCCAGTTGGCCTG"	"TPC_6:lowCov"
"GCAGCCATCGCGTAGC"	"TPC_1"
"GCAGCTGCACTTGTCC"	"TPC_4"
"GCAGCTGCATCCTCAC"	"TPC_1"
"GCAGCTGGTACTGCGC"	"TPC_1"
"GCAGCTGGTTGGGCCT"	"TPC_1"
"GCAGCTGTCATTCACT"	"TPC_4"
"GCAGGCTGTAGGTCAG"	"TPC_1"
"GCAGGCTGTCACAGTT"	"TPC_1"
"GCAGGCTTCCACGGAC"	"TPC_1"
"GCAGTTACATCCAATG"	"TPC_2:LowCov"
"GCAGTTAGTTATTCTC"	"TPC_6:lowCov"
"GCAGTTATCCTACACC"	"TPC_1"
"GCATCGGAGATGAATC"	"TPC_4"
"GCATCGGGTCATACCA"	"TPC_2:LowCov"
"GCATCGGGTTACGGAG"	"TPC_4"
"GCATGATGTAAGGCCA"	"TPC_3:HighMT"
"GCATGATTCCTATTGT"	"TPC_1"
"GCATTAGAGAAGTATC"	"TPC_2:LowCov"
"GCATTAGCAAATGGCG"	"TPC_2:LowCov"
"GCATTAGCAAGCTCTA"	"TPC_3:HighMT"
"GCATTAGTCGTCTCAC"	"TPC_4"
"GCCAACGCAAGGCGTA"	"TPC_3:HighMT"
"GCCAACGGTTGCCTAA"	"TPC_2:LowCov"
"GCCAACGTCTGGCCTT"	"TPC_1"
"GCCAGCAAGACGGATC"	"TPC_1"
"GCCAGCATCAGCCTCT"	"TPC_2:LowCov"
"GCCAGCATCAGTGGGA"	"TPC_2:LowCov"
"GCCAGCATCCGGGACT"	"TPC_5"
"GCCAGCATCTGTCGTC"	"TPC_2:LowCov"
"GCCAGGTCAAACCACT"	"TPC_1"
"GCCAGGTCAGGTCCCA"	"TPC_2:LowCov"
"GCCAGGTCATCACGGC"	"TPC_2:LowCov"
"GCCAGGTGTGCAGATG"	"TPC_2:LowCov"
"GCCAGTGGTTAGTTCG"	"TPC_2:LowCov"
"GCCATGGCAAGTGGGT"	"TPC_2:LowCov"
"GCCATGGGTCATCCGG"	"TPC_3:HighMT"
"GCCATTCAGTCTAGCT"	"TPC_2:LowCov"
"GCCATTCCAACCCGCA"	"TPC_1"
"GCCATTCTCGGTGAAG"	"TPC_1"
"GCCCAGAAGAGCATAT"	"TPC_4"
"GCCCAGAAGGCACGAT"	"TPC_2:LowCov"
"GCCCAGAAGGTTCACT"	"TPC_4"
"GCCCAGAAGTTAACAG"	"TPC_1"
"GCCCAGAGTGTGGACA"	"TPC_1"
"GCCCAGATCTTAAGGC"	"TPC_5"
"GCCCGAAAGATCGACG"	"TPC_1"
"GCCCGAACAAGGGTCA"	"TPC_2:LowCov"
"GCCCGAACAAGTGATA"	"TPC_1"
"GCCCGAAGTACTGACT"	"TPC_1"
"GCCCGAATCGAGCCTG"	"TPC_2:LowCov"
"GCCCGAATCGATTGGT"	"TPC_2:LowCov"
"GCCGATGAGCAGATAT"	"TPC_1"
"GCCGATGGTCGCAGTC"	"TPC_1"
"GCCGATGTCAACCCGG"	"TPC_1"
"GCCGATGTCGCGAAGA"	"TPC_1"
"GCCGTGACAGATCATC"	"TPC_4"
"GCCGTGAGTCATGGCC"	"TPC_5"
"GCCGTGATCGAGAGCA"	"TPC_1"
"GCGAGAATCCACTGGG"	"TPC_2:LowCov"
"GCGAGAATCGGCTCTT"	"TPC_4"
"GCGATCGAGATAGTCA"	"TPC_4"
"GCGATCGAGCCTGAAG"	"TPC_4"
"GCGGAAACAGCTCCTT"	"TPC_2:LowCov"
"GCGGAAACAGGCATTT"	"TPC_1"
"GCGGAAAGTCGCATGC"	"TPC_2:LowCov"
"GCGGATCTCAGACCCG"	"TPC_2:LowCov"
"GCGGATCTCTTTGCTA"	"TPC_2:LowCov"
"GCGTGCAAGATACTGA"	"TPC_1"
"GCGTGCAGTACCCACG"	"TPC_1"
"GCGTTTCAGACCAACG"	"TPC_4"
"GCGTTTCAGATCCCGC"	"TPC_4"
"GCGTTTCTCATTACGG"	"TPC_1"
"GCGTTTCTCCGAGAAG"	"TPC_1"
"GCTACAAGTGCCTGCA"	"TPC_2:LowCov"
"GCTACCTAGTCGGGAT"	"TPC_2:LowCov"
"GCTACCTGTGATATAG"	"TPC_4"
"GCTACCTGTTCGAAGG"	"TPC_1"
"GCTCAAAAGTACAACA"	"TPC_1"
"GCTCAAAGTCTTACAG"	"TPC_1"
"GCTGAATGTTAGCGGA"	"TPC_4"
"GCTGCAGAGCGCCTCA"	"TPC_4"
"GCTGCAGAGTTGCCCG"	"TPC_5"
"GCTGCAGGTGCCCTTT"	"TPC_3:HighMT"
"GCTGGGTAGTGTACAA"	"TPC_1"
"GCTGGGTCAACTGTGT"	"TPC_2:LowCov"
"GCTGGGTTCCCGAATA"	"TPC_1"
"GCTTCACCATGCGTGC"	"TPC_1"
"GCTTCACGTTTGAAAG"	"TPC_6:lowCov"
"GCTTGGGAGAGAGGGC"	"TPC_2:LowCov"
"GCTTGGGAGAGAGTTT"	"TPC_2:LowCov"
"GCTTGGGCAACCGCTG"	"TPC_2:LowCov"
"GCTTGGGCACGACTAT"	"TPC_1"
"GCTTTCGAGACGGAAA"	"TPC_1"
"GCTTTCGAGTAAACGT"	"TPC_1"
"GCTTTCGCAACTGCTA"	"TPC_1"
"GCTTTCGCAGCTACAT"	"TPC_1"
"GCTTTCGCAGTGCGCT"	"TPC_1"
"GGAACCCAGGTGTGAT"	"TPC_6:lowCov"
"GGAACCCAGTAGTGCG"	"TPC_1"
"GGAACCCCAATTGTGC"	"TPC_5"
"GGAACCCCACAACGCC"	"TPC_4"
"GGAACCCGTTGAGAGC"	"TPC_2:LowCov"
"GGAAGTGCAGGTTCCG"	"TPC_1"
"GGAATCTCAAGCGAGT"	"TPC_3:HighMT"
"GGAATCTCAGTCTTCC"	"TPC_1"
"GGAATGGAGTTAGAAC"	"TPC_3:HighMT"
"GGAATGGTCGACTCCT"	"TPC_1"
"GGACGTCAGGTAATCA"	"TPC_1"
"GGAGAACGTGACACGA"	"TPC_2:LowCov"
"GGAGATGAGGCTAACG"	"TPC_1"
"GGAGCAAAGAGCAAGA"	"TPC_1"
"GGAGCAAAGGACGGAG"	"TPC_2:LowCov"
"GGAGCAAGTACTCCCT"	"TPC_3:HighMT"
"GGAGCAATCTATCGTT"	"TPC_1"
"GGAGGATGTTGAGAGC"	"TPC_2:LowCov"
"GGAGGTAAGCTAGCCC"	"TPC_1"
"GGAGGTAAGTTGCGAG"	"TPC_1"
"GGAGGTACAGAAATTG"	"TPC_1"
"GGAGGTAGTTCAAACC"	"TPC_5"
"GGAGGTATCACAGAGG"	"TPC_5"
"GGATCTAAGTTCGGTT"	"TPC_2:LowCov"
"GGATCTATCGCTACAA"	"TPC_2:LowCov"
"GGATGTTAGGGAGATA"	"TPC_5"
"GGCACGTAGGAACTCG"	"TPC_4"
"GGCACGTAGGCTTCCG"	"TPC_2:LowCov"
"GGCACGTGTCTTCATT"	"TPC_4"
"GGCACGTGTTCTCCTG"	"TPC_5"
"GGCACGTTCACAACCA"	"TPC_2:LowCov"
"GGCAGTCAGACATAAC"	"TPC_5"
"GGCAGTCAGACTTCAC"	"TPC_3:HighMT"
"GGCAGTCAGTGATAAC"	"TPC_2:LowCov"
"GGCAGTCTCACATCAG"	"TPC_1"
"GGCAGTCTCGATACGT"	"TPC_5"
"GGCGTCAAGATCCTAC"	"TPC_1"
"GGCGTCACAGGTACGA"	"TPC_4"
"GGCTGTGAGCTAGCCC"	"TPC_4"
"GGCTGTGAGGTGCTTT"	"TPC_7"
"GGCTGTGGTCGAATGG"	"TPC_2:LowCov"
"GGCTGTGGTGAATAAC"	"TPC_4"
"GGCTTGGAGAGTGACC"	"TPC_2:LowCov"
"GGCTTGGCAGCTCGGT"	"TPC_4"
"GGCTTGGGTCTATGAC"	"TPC_3:HighMT"
"GGCTTGGTCTGTGTGA"	"TPC_4"
"GGCTTTCAGGTTCTAC"	"TPC_2:LowCov"
"GGCTTTCCAAGGCTTT"	"TPC_5"
"GGCTTTCGTTCGGACC"	"TPC_1"
"GGGAAGTCACTAGTAC"	"TPC_4"
"GGGAAGTCATCCAACA"	"TPC_1"
"GGGAAGTCATGAAAGT"	"TPC_2:LowCov"
"GGGACAAAGGACAAGA"	"TPC_1"
"GGGACAAAGTCTGCGC"	"TPC_2:LowCov"
"GGGACAATCCCGATCT"	"TPC_3:HighMT"
"GGGACTCCAATCGCCG"	"TPC_1"
"GGGACTCCACGCTGCA"	"TPC_1"
"GGGACTCTCGTGCATA"	"TPC_2:LowCov"
"GGGACTCTCGTGGAAG"	"TPC_1"
"GGGAGATAGGCCGCTT"	"TPC_4"
"GGGAGATGTGCTTCAA"	"TPC_4"
"GGGAGTAAGCGAGTCA"	"TPC_3:HighMT"
"GGGAGTAGTACAGCGA"	"TPC_1"
"GGGAGTAGTATCACCA"	"TPC_1"
"GGGAGTATCGGTATGT"	"TPC_1"
"GGGATCCCAAGCTACT"	"TPC_7"
"GGGATCCCAGGTCAAG"	"TPC_5"
"GGGATGAAGTGGAATT"	"TPC_1"
"GGGATGAGTCCATCTC"	"TPC_1"
"GGGATGAGTTGCATGT"	"TPC_1"
"GGGCCATAGCCGATAG"	"TPC_5"
"GGGCCATAGTGTAGAT"	"TPC_1"
"GGGCTACAGCGAAACC"	"TPC_2:LowCov"
"GGGCTACAGGGCTAAC"	"TPC_2:LowCov"
"GGGCTACCATGTGGTT"	"TPC_5"
"GGGCTCACACACCTTC"	"TPC_1"
"GGGCTCACACATTGTG"	"TPC_1"
"GGGTAGAAGTTACGAA"	"TPC_1"
"GGGTAGACATTGAAGA"	"TPC_2:LowCov"
"GGGTAGAGTATAGGGC"	"TPC_4"
"GGGTAGAGTATGCAAA"	"TPC_1"
"GGGTATTCAAGGTCAG"	"TPC_2:LowCov"
"GGGTATTTCTTTCCGG"	"TPC_1"
"GGGTCACTCACTTTGT"	"TPC_3:HighMT"
"GGGTCACTCCGATCTC"	"TPC_4"
"GGGTCTGCAGGCGTTC"	"TPC_2:LowCov"
"GGGTGAACATAATGCC"	"TPC_4"
"GGGTGAAGTCGTTTCC"	"TPC_1"
"GGGTGAAGTGAGTAAT"	"TPC_4"
"GGGTGTCGTCTGCCTT"	"TPC_3:HighMT"
"GGGTGTCTCCTTCAGC"	"TPC_1"
"GGGTTATAGATAGCAT"	"TPC_4"
"GGGTTATAGCTACTGT"	"TPC_4"
"GGGTTATCACTTGAAC"	"TPC_4"
"GGGTTTACAAGCGCTC"	"TPC_4"
"GGGTTTACACAGTACT"	"TPC_1"
"GGGTTTACACCATTCC"	"TPC_1"
"GGGTTTACATTCGGGC"	"TPC_1"
"GGGTTTATCTTTCCGG"	"TPC_1"
"GGTAACTCAGTAGAGC"	"TPC_1"
"GGTAACTGTGAGATAT"	"TPC_2:LowCov"
"GGTAACTGTTGTGTTG"	"TPC_3:HighMT"
"GGTAACTTCAAGTCTG"	"TPC_3:HighMT"
"GGTAACTTCTTCGACC"	"TPC_2:LowCov"
"GGTAATCCATTGCCTC"	"TPC_1"
"GGTAATCGTAGAATAC"	"TPC_1"
"GGTAATCGTTCGGTCG"	"TPC_1"
"GGTAATCTCGAGCACC"	"TPC_4"
"GGTAATCTCTTGCGCT"	"TPC_1"
"GGTAGAGAGGACACTG"	"TPC_2:LowCov"
"GGTAGAGAGTCATACC"	"TPC_4"
"GGTAGAGCACGACTAT"	"TPC_4"
"GGTAGAGTCAGTCACA"	"TPC_5"
"GGTAGAGTCTTCGATT"	"TPC_5"
"GGTCACGAGGCATTTC"	"TPC_1"
"GGTCACGGTAGGTGCA"	"TPC_2:LowCov"
"GGTCACGGTCGGTGTC"	"TPC_4"
"GGTCTGGAGCGCACAA"	"TPC_2:LowCov"
"GGTCTGGAGGTTCAGG"	"TPC_3:HighMT"
"GGTCTGGAGTATCTGC"	"TPC_1"
"GGTCTGGGTGACCGAA"	"TPC_7"
"GGTCTGGGTTCCGGTG"	"TPC_5"
"GGTCTGGTCATTCTTG"	"TPC_3:HighMT"
"GGTGAAGAGACCTCCG"	"TPC_4"
"GGTGAAGTCGGTCAGC"	"TPC_1"
"GGTGATTAGAAACTGT"	"TPC_3:HighMT"
"GGTGATTCAAGTTCGT"	"TPC_1"
"GGTGATTCACTCCGAG"	"TPC_6:lowCov"
"GGTGATTTCACTTTGT"	"TPC_2:LowCov"
"GGTGGCTTCGGCATCG"	"TPC_3:HighMT"
"GGTGGCTTCTAGACAC"	"TPC_3:HighMT"
"GGTGTCGAGCTTTGTG"	"TPC_1"
"GGTGTTATCGGCACTG"	"TPC_4"
"GGTTAACCAAGGCGTA"	"TPC_2:LowCov"
"GGTTCTCAGTCTGCGC"	"TPC_3:HighMT"
"GGTTGTACAGTGGGTA"	"TPC_6:lowCov"
"GGTTGTACATGTTCAG"	"TPC_2:LowCov"
"GTAACACCAAAGCTCT"	"TPC_2:LowCov"
"GTAACACGTGATTAGA"	"TPC_3:HighMT"
"GTAACACTCTTCCTAA"	"TPC_1"
"GTAACCAAGATACAGT"	"TPC_1"
"GTAACCAGTCCAAGAG"	"TPC_1"
"GTAACCAGTTCGGACC"	"TPC_2:LowCov"
"GTAAGTCAGCGTGCTC"	"TPC_1"
"GTAAGTCCAACCTATG"	"TPC_1"
"GTAAGTCCAGTTCACA"	"TPC_3:HighMT"
"GTAAGTCTCATAGGCT"	"TPC_1"
"GTAATCGCATGACGTT"	"TPC_3:HighMT"
"GTAATGCAGGCCCACT"	"TPC_2:LowCov"
"GTAATGCCATGGCTAT"	"TPC_3:HighMT"
"GTACAACAGGGCAGAG"	"TPC_1"
"GTACAACCAGATTCGT"	"TPC_1"
"GTACAACCATTATGCG"	"TPC_5"
"GTACAACTCACCATCC"	"TPC_2:LowCov"
"GTACAACTCATCGACA"	"TPC_2:LowCov"
"GTACAGTAGCGGGTTA"	"TPC_4"
"GTACAGTAGTATCTGC"	"TPC_1"
"GTACAGTCATGACGAG"	"TPC_2:LowCov"
"GTACAGTGTGAGAGGG"	"TPC_1"
"GTAGAAACATAGGAGC"	"TPC_5"
"GTAGAGGAGAGGGTCT"	"TPC_3:HighMT"
"GTAGAGGCAACTGATC"	"TPC_3:HighMT"
"GTAGAGGCACCAACAT"	"TPC_2:LowCov"
"GTAGAGGGTTTATGCG"	"TPC_4"
"GTAGATCCAGGCACTC"	"TPC_1"
"GTAGATCCATCGCCTT"	"TPC_2:LowCov"
"GTAGATCTCCTCACTG"	"TPC_3:HighMT"
"GTAGCTAAGTGCGACA"	"TPC_4"
"GTAGCTACAACCAGAG"	"TPC_3:HighMT"
"GTAGCTATCCACAAGT"	"TPC_2:LowCov"
"GTAGGAGCAGACATCT"	"TPC_4"
"GTAGGAGCATGGGAAC"	"TPC_2:LowCov"
"GTAGGAGTCGACCCAG"	"TPC_1"
"GTAGGTTCACTCTAGA"	"TPC_2:LowCov"
"GTAGTACAGGCTATCT"	"TPC_2:LowCov"
"GTAGTACCAGGTGAGT"	"TPC_1"
"GTAGTACGTGAGTAAT"	"TPC_4"
"GTAGTACTCATGCCGG"	"TPC_2:LowCov"
"GTATTGGAGCGTACAG"	"TPC_1"
"GTATTGGAGCTACTGT"	"TPC_3:HighMT"
"GTATTGGCAGAGTCAG"	"TPC_1"
"GTATTGGGTCGGTGAA"	"TPC_1"
"GTATTGGGTGATAGAT"	"TPC_2:LowCov"
"GTATTTCCAGGATGAC"	"TPC_2:LowCov"
"GTATTTCCATCATTTC"	"TPC_5"
"GTATTTCGTCGTACAT"	"TPC_1"
"GTATTTCTCCTCACGT"	"TPC_1"
"GTCAAACAGAGCTTTC"	"TPC_3:HighMT"
"GTCAAACAGATGCAGC"	"TPC_1"
"GTCAAACGTGCGGCTT"	"TPC_2:LowCov"
"GTCAAGTAGTCCCGAC"	"TPC_2:LowCov"
"GTCAAGTGTTCGAAGG"	"TPC_2:LowCov"
"GTCACGGAGAACTGAT"	"TPC_1"
"GTCACGGAGCAACAAT"	"TPC_5"
"GTCACGGAGCCTCAAT"	"TPC_1"
"GTCACTCGTTATGGTC"	"TPC_1"
"GTCAGCGAGGAACTCG"	"TPC_1"
"GTCAGCGAGGAAGTAG"	"TPC_1"
"GTCAGCGTCTTCTAAC"	"TPC_3:HighMT"
"GTCATCCAGTCAGGGT"	"TPC_2:LowCov"
"GTCATCCGTGCCTGCA"	"TPC_2:LowCov"
"GTCATCCGTGTTGCCG"	"TPC_2:LowCov"
"GTCATCCGTTGTTTGG"	"TPC_1"
"GTCATGAAGACCTCCG"	"TPC_1"
"GTCATGACACATTGTG"	"TPC_1"
"GTCATGAGTCGGATTT"	"TPC_3:HighMT"
"GTCATGATCTACGGTA"	"TPC_1"
"GTCATTTAGATCACCT"	"TPC_7"
"GTCATTTAGGAGCTGT"	"TPC_1"
"GTCATTTCAAGTACCT"	"TPC_1"
"GTCATTTCACACCTAA"	"TPC_1"
"GTCATTTCAGCTAACT"	"TPC_2:LowCov"
"GTCATTTTCGCTGATA"	"TPC_1"
"GTCCTCACAGTCTGGC"	"TPC_4"
"GTCCTCATCTCATTGT"	"TPC_1"
"GTCGAATCACAGAGAC"	"TPC_5"
"GTCGAATTCCTGTTAT"	"TPC_2:LowCov"
"GTCGCGAAGTGTACCT"	"TPC_4"
"GTCGCGACATGACTTG"	"TPC_2:LowCov"
"GTCGTAAGTCAAGGCA"	"TPC_1"
"GTCGTAATCCTTCACG"	"TPC_1"
"GTCGTTCCAAACACGG"	"TPC_2:LowCov"
"GTCGTTCGTTGCCGCA"	"TPC_5"
"GTCTACCAGACGGTCA"	"TPC_1"
"GTCTACCGTACACTCA"	"TPC_2:LowCov"
"GTCTACCGTCTACATG"	"TPC_5"
"GTCTAGAAGACTCTTG"	"TPC_1"
"GTCTAGAAGCGTCTGC"	"TPC_3:HighMT"
"GTCTAGAAGTAACCTC"	"TPC_1"
"GTCTAGACAATCACGT"	"TPC_1"
"GTCTAGACAGTTAAAG"	"TPC_1"
"GTCTAGAGTGGATTTC"	"TPC_1"
"GTCTAGAGTTAAGGAT"	"TPC_6:lowCov"
"GTCTCACAGCGCACAA"	"TPC_2:LowCov"
"GTCTCACAGGAGACCT"	"TPC_1"
"GTCTCACCATACTGAC"	"TPC_1"
"GTCTCACTCAAGGTGG"	"TPC_5"
"GTCTGTCCAGTGTGCC"	"TPC_5"
"GTCTGTCCATCAGCGC"	"TPC_2:LowCov"
"GTCTGTCTCTTCCTAA"	"TPC_3:HighMT"
"GTCTTTAAGACGTCGA"	"TPC_5"
"GTCTTTACAGACCGCT"	"TPC_2:LowCov"
"GTCTTTATCCATTGGA"	"TPC_2:LowCov"
"GTCTTTATCGTAACCA"	"TPC_3:HighMT"
"GTGACGCAGCTGAGCA"	"TPC_1"
"GTGACGCCACTTGAGT"	"TPC_1"
"GTGACGCGTTAGGACG"	"TPC_1"
"GTGACGCTCCAACACA"	"TPC_3:HighMT"
"GTGACGCTCCGTCCTA"	"TPC_1"
"GTGACGCTCTAACGCA"	"TPC_2:LowCov"
"GTGACGCTCTCACCCA"	"TPC_1"
"GTGAGCCGTGCCCGTA"	"TPC_1"
"GTGAGCCTCAACCGAT"	"TPC_5"
"GTGAGGAGTCTAGGTT"	"TPC_1"
"GTGAGGATCACGAGGA"	"TPC_2:LowCov"
"GTGAGGATCCTAAGTG"	"TPC_2:LowCov"
"GTGAGTTAGCACGGAT"	"TPC_4"
"GTGAGTTCAAAGCTAA"	"TPC_2:LowCov"
"GTGAGTTCAACACGAG"	"TPC_3:HighMT"
"GTGAGTTTCGCTTAAG"	"TPC_3:HighMT"
"GTGAGTTTCTTTGATC"	"TPC_2:LowCov"
"GTGATGTAGATCGGTG"	"TPC_1"
"GTGATGTAGTGCACAG"	"TPC_1"
"GTGCACGAGAAACACT"	"TPC_2:LowCov"
"GTGCACGTCAAGATAG"	"TPC_2:LowCov"
"GTGCAGCAGCGGGTAT"	"TPC_1"
"GTGCAGCAGGGCGAAG"	"TPC_2:LowCov"
"GTGCGTGCACCAGACC"	"TPC_5"
"GTGCGTGCACCTTCCA"	"TPC_1"
"GTGCGTGCAGAGGACT"	"TPC_5"
"GTGCTGGAGACTTCCA"	"TPC_1"
"GTGCTGGTCTCATGCC"	"TPC_2:LowCov"
"GTGCTTCTCATTATCC"	"TPC_1"
"GTGGAAGCAACATCGT"	"TPC_1"
"GTGGAAGCAGCACGAA"	"TPC_2:LowCov"
"GTGGAAGTCCGATAGT"	"TPC_2:LowCov"
"GTGGAGAAGCTCTTCC"	"TPC_2:LowCov"
"GTGGAGACACTTACAG"	"TPC_1"
"GTGGAGAGTATCGAGG"	"TPC_1"
"GTGGAGAGTCAAGTTC"	"TPC_4"
"GTGGCGTCACGAAAGC"	"TPC_2:LowCov"
"GTGGCGTTCAAGTAAG"	"TPC_5"
"GTGGGAACAGCATGCC"	"TPC_2:LowCov"
"GTGGGAAGTCGCTTGG"	"TPC_2:LowCov"
"GTGGGAAGTGGAGAAA"	"TPC_2:LowCov"
"GTGGTTAAGATCCAAA"	"TPC_2:LowCov"
"GTGGTTACATAACCCA"	"TPC_2:LowCov"
"GTGGTTACATTGACAC"	"TPC_2:LowCov"
"GTGGTTATCCAAGCCG"	"TPC_1"
"GTGTAACAGTCATAGA"	"TPC_1"
"GTGTAACCACAGCTGC"	"TPC_2:LowCov"
"GTGTAACGTAAGCTCT"	"TPC_2:LowCov"
"GTGTAACGTGTTCGAT"	"TPC_5"
"GTGTAACTCCTTATAC"	"TPC_2:LowCov"
"GTGTCCTAGAGGGCGA"	"TPC_2:LowCov"
"GTGTCCTTCGATACGT"	"TPC_3:HighMT"
"GTGTGATCAGGTTTAC"	"TPC_5"
"GTGTGGCAGCTGCGAA"	"TPC_2:LowCov"
"GTGTGGCAGTAGAATC"	"TPC_2:LowCov"
"GTGTGGCGTTAGTTCG"	"TPC_1"
"GTGTTAGCAGAGGCTA"	"TPC_4"
"GTGTTAGGTGCAGTGA"	"TPC_2:LowCov"
"GTGTTCCGTAGAAACT"	"TPC_1"
"GTGTTCCGTGTATTGC"	"TPC_5"
"GTGTTCCTCTCTTGCG"	"TPC_4"
"GTTACAGCACAGCTTA"	"TPC_1"
"GTTACAGGTAGCGATG"	"TPC_1"
"GTTACAGGTCGATTTG"	"TPC_1"
"GTTACAGTCTGCGGCA"	"TPC_2:LowCov"
"GTTACGACACAACATC"	"TPC_2:LowCov"
"GTTACGACAGTGTGCC"	"TPC_4"
"GTTAGACGTTTACTGG"	"TPC_1"
"GTTAGTGCATGACAGG"	"TPC_1"
"GTTAGTGGTGTGGTCC"	"TPC_2:LowCov"
"GTTATGGCACCGTCGA"	"TPC_2:LowCov"
"GTTATGGCAGTAGAGC"	"TPC_1"
"GTTATGGGTGTACAGG"	"TPC_4"
"GTTATGGTCGATACTG"	"TPC_2:LowCov"
"GTTCATTAGGCTTAAA"	"TPC_4"
"GTTCATTAGTTGGCTT"	"TPC_2:LowCov"
"GTTCATTCACTAAACC"	"TPC_1"
"GTTCATTGTGGTCTGC"	"TPC_6:lowCov"
"GTTCCGTCATTGAAGA"	"TPC_2:LowCov"
"GTTCCGTGTACCACGC"	"TPC_2:LowCov"
"GTTCCGTGTTGATGTC"	"TPC_2:LowCov"
"GTTCCGTGTTGGATCT"	"TPC_3:HighMT"
"GTTCGCTTCACCCATC"	"TPC_3:HighMT"
"GTTCTATCACCCAATA"	"TPC_3:HighMT"
"GTTCTATCAGTAACAA"	"TPC_1"
"GTTCTATGTGCTGTCG"	"TPC_1"
"GTTGAACGTTGGCCGT"	"TPC_1"
"GTTGAACTCGACGTCG"	"TPC_3:HighMT"
"GTTGCGGCAATGTCAC"	"TPC_1"
"GTTGCGGGTACCGTGC"	"TPC_5"
"GTTGTAGAGAGTCAGC"	"TPC_1"
"GTTGTAGGTATAATGG"	"TPC_2:LowCov"
"GTTGTAGGTGTCACAT"	"TPC_1"
"GTTGTCCGTCCAGGTC"	"TPC_3:HighMT"
"GTTGTGATCTCGGTAA"	"TPC_2:LowCov"
"GTTTACTGTGTTTACG"	"TPC_3:HighMT"
"GTTTGGACATCTTTCA"	"TPC_5"
"TAACACGCAACACACT"	"TPC_3:HighMT"
"TAACCAGAGCCGTTAT"	"TPC_2:LowCov"
"TAACCAGGTGGGCTCT"	"TPC_1"
"TAACCAGTCACCACAA"	"TPC_2:LowCov"
"TAACCAGTCCGTGGGT"	"TPC_1"
"TAACGACAGCCGTTGC"	"TPC_1"
"TAACGACAGGCTGTAG"	"TPC_3:HighMT"
"TAACGACAGTTTGTCG"	"TPC_1"
"TAACTTCAGTAGCTCT"	"TPC_4"
"TAAGCACGTAATGATG"	"TPC_2:LowCov"
"TAAGCACTCGGCAGTC"	"TPC_4"
"TAAGCCACATAATCCG"	"TPC_2:LowCov"
"TAAGCCATCATCGCCT"	"TPC_2:LowCov"
"TAAGCCATCGGTTCAA"	"TPC_1"
"TAAGCGTCACAACATC"	"TPC_4"
"TAAGCGTCATAATGCC"	"TPC_1"
"TAAGTCGCACATTCTT"	"TPC_1"
"TAAGTCGGTAAGTAGT"	"TPC_1"
"TAAGTCGTCACTAGCA"	"TPC_1"
"TAAGTCGTCTTAGTTC"	"TPC_4"
"TAATCTCGTCTGCATA"	"TPC_5"
"TAATCTCTCAAACTGC"	"TPC_4"
"TAATTCCAGCGCCTCA"	"TPC_2:LowCov"
"TAATTCCCAGTAGGAC"	"TPC_5"
"TACAACGAGAGCACTG"	"TPC_2:LowCov"
"TACAACGAGCCACTCG"	"TPC_2:LowCov"
"TACAACGCAAGCGAAC"	"TPC_1"
"TACAACGCAGAGACTG"	"TPC_7"
"TACAACGGTATTCCGA"	"TPC_4"
"TACAACGGTGCCGTTG"	"TPC_1"
"TACAACGTCCGGGACT"	"TPC_1"
"TACACCCGTGGTAATA"	"TPC_1"
"TACACCCTCAGACAAA"	"TPC_2:LowCov"
"TACAGGTAGCGTCAAG"	"TPC_5"
"TACAGGTAGTATGGCG"	"TPC_2:LowCov"
"TACAGGTGTCGCGTCA"	"TPC_1"
"TACATTCCAATCCTAG"	"TPC_2:LowCov"
"TACATTCCATATTCGG"	"TPC_2:LowCov"
"TACATTCGTAATTGGA"	"TPC_2:LowCov"
"TACATTCTCCTACGAA"	"TPC_7"
"TACCCACCAACACACT"	"TPC_1"
"TACCCACCACGCACCA"	"TPC_1"
"TACCCACCACTAGGTT"	"TPC_2:LowCov"
"TACCCGTTCGCTATTT"	"TPC_5"
"TACCGAAAGGCACGAT"	"TPC_4"
"TACCGAAGTTTAAGGA"	"TPC_1"
"TACCGAATCTGCGGCA"	"TPC_3:HighMT"
"TACCGGGCACAAGCTT"	"TPC_1"
"TACCGGGTCGCGTCGA"	"TPC_1"
"TACCTCGGTCAACACT"	"TPC_5"
"TACCTCGGTCTCTCTG"	"TPC_5"
"TACCTCGTCACTCCGT"	"TPC_1"
"TACCTCGTCTACCCAC"	"TPC_1"
"TACCTGCCAACGGTAG"	"TPC_5"
"TACCTGCGTACAGTCT"	"TPC_4"
"TACGCTCCAGAGGCTA"	"TPC_2:LowCov"
"TACGCTCGTTCTCGCT"	"TPC_1"
"TACGGGCCATACTTTC"	"TPC_3:HighMT"
"TACGGGCGTCTGTGTA"	"TPC_4"
"TACGGGCTCGTAGGGA"	"TPC_1"
"TACGGTAAGTGGCCTC"	"TPC_1"
"TACGGTACATGCGGTC"	"TPC_1"
"TACGGTAGTGGCTTGC"	"TPC_3:HighMT"
"TACGTCCAGGAGGCAG"	"TPC_1"
"TACGTCCCAAACGAGC"	"TPC_1"
"TACGTCCCACGCTGCA"	"TPC_5"
"TACGTCCGTAGGTACG"	"TPC_2:LowCov"
"TACGTCCTCATGGCCG"	"TPC_1"
"TACTTACAGAACCCGA"	"TPC_2:LowCov"
"TACTTACCAGCCGTCA"	"TPC_2:LowCov"
"TACTTACCAGGCACTC"	"TPC_1"
"TACTTACCATCAGCAT"	"TPC_2:LowCov"
"TACTTACGTATTCTCT"	"TPC_5"
"TACTTACTCACCTTGC"	"TPC_1"
"TACTTCAGTGCAATAA"	"TPC_1"
"TACTTCAGTGCTAGCC"	"TPC_2:LowCov"
"TACTTGTAGAGTTCGG"	"TPC_1"
"TACTTGTAGGAACTAT"	"TPC_3:HighMT"
"TACTTGTCACACGCCA"	"TPC_1"
"TACTTGTGTGGTATGG"	"TPC_3:HighMT"
"TACTTGTTCGTAACTG"	"TPC_1"
"TAGACCAAGTCTGGAG"	"TPC_1"
"TAGACCATCCGATCGG"	"TPC_5"
"TAGACTGAGGCTAAAT"	"TPC_5"
"TAGACTGAGGGATCAC"	"TPC_4"
"TAGAGTCAGCATACTC"	"TPC_1"
"TAGAGTCGTACCGGAA"	"TPC_2:LowCov"
"TAGATCGAGTAATACG"	"TPC_4"
"TAGATCGCACCGTGGT"	"TPC_5"
"TAGATCGTCGGCCTTT"	"TPC_1"
"TAGCACAGTACCGTCG"	"TPC_3:HighMT"
"TAGCACATCATCTACT"	"TPC_5"
"TAGGAGGAGGCCCACT"	"TPC_1"
"TAGGAGGCAAAGAACT"	"TPC_1"
"TAGGAGGCAATTCTTC"	"TPC_4"
"TAGGAGGGTAGATTGA"	"TPC_2:LowCov"
"TAGGAGGGTATGGTAA"	"TPC_5"
"TAGGGTTAGGTCATCT"	"TPC_2:LowCov"
"TAGGGTTAGTATGAGT"	"TPC_1"
"TAGGGTTGTTGGCCGT"	"TPC_1"
"TAGGGTTTCGAGTCTA"	"TPC_2:LowCov"
"TAGGTACCACGCCAGT"	"TPC_1"
"TAGGTTGAGAGCCTGA"	"TPC_2:LowCov"
"TAGGTTGTCTTTCGAT"	"TPC_4"
"TAGTGCAGTAGACGGT"	"TPC_1"
"TAGTGCAGTTTCGGCG"	"TPC_2:LowCov"
"TATACCTCAGAACTAA"	"TPC_3:HighMT"
"TATATCCAGCTCGAAG"	"TPC_3:HighMT"
"TATATCCAGTGCTAGG"	"TPC_5"
"TATATCCCAACGAGGT"	"TPC_2:LowCov"
"TATATCCGTCTGCGCA"	"TPC_2:LowCov"
"TATATCCGTGCCTATA"	"TPC_2:LowCov"
"TATCAGGCACGGCACT"	"TPC_5"
"TATCAGGCATGCAGCC"	"TPC_2:LowCov"
"TATCAGGGTAGGCTCC"	"TPC_2:LowCov"
"TATCAGGGTGACAGCA"	"TPC_1"
"TATCAGGGTTATCCAG"	"TPC_2:LowCov"
"TATCAGGTCGTTCAGA"	"TPC_4"
"TATCCTAGTGATAGTA"	"TPC_1"
"TATCCTAGTTGGACTT"	"TPC_5"
"TATCGCCAGACGGATC"	"TPC_2:LowCov"
"TATCGCCAGTATAGGT"	"TPC_1"
"TATCGCCCATGACTGT"	"TPC_5"
"TATCGCCGTTGGCCTG"	"TPC_1"
"TATCGCCTCAACTGGT"	"TPC_3:HighMT"
"TATCTGTCAGAACTAA"	"TPC_2:LowCov"
"TATCTGTCATCGGATT"	"TPC_3:HighMT"
"TATCTGTTCTTGAGCA"	"TPC_3:HighMT"
"TATCTTGCACTCCCTA"	"TPC_1"
"TATCTTGGTCTACACA"	"TPC_2:LowCov"
"TATGTTCAGCATTGTC"	"TPC_3:HighMT"
"TATGTTCTCGACGCTG"	"TPC_6:lowCov"
"TATTCCAGTACCAGAG"	"TPC_3:HighMT"
"TATTGCTAGTGTTGAA"	"TPC_6:lowCov"
"TATTGGGAGTTGCGCC"	"TPC_1"
"TATTGGGCACAACGCC"	"TPC_2:LowCov"
"TATTGGGCAGCCCAGT"	"TPC_4"
"TATTTCGAGAACAGGA"	"TPC_2:LowCov"
"TATTTCGGTATGTCTG"	"TPC_1"
"TATTTCGTCTTTGCTA"	"TPC_2:LowCov"
"TCAAGACAGAGGTATT"	"TPC_2:LowCov"
"TCAAGACGTACAAAGT"	"TPC_3:HighMT"
"TCAAGACGTTAGTTCG"	"TPC_2:LowCov"
"TCAAGCAAGAAGTCTA"	"TPC_2:LowCov"
"TCAAGCAAGATTGCGG"	"TPC_2:LowCov"
"TCAAGCAAGTATCTGC"	"TPC_1"
"TCAAGCACAATACGAA"	"TPC_1"
"TCAAGCACAGACATCT"	"TPC_5"
"TCAAGCAGTCTTCAAG"	"TPC_2:LowCov"
"TCAAGCATCCATTCGC"	"TPC_5"
"TCAAGCATCGCGATCG"	"TPC_2:LowCov"
"TCAAGTGAGGGAGTGG"	"TPC_7"
"TCAAGTGCAAGCCATT"	"TPC_4"
"TCAATTCGTGCCCAGT"	"TPC_5"
"TCAATTCTCCTCAGGG"	"TPC_1"
"TCACAAGAGTCTAGAA"	"TPC_4"
"TCACAAGTCTTCCTAA"	"TPC_4"
"TCACACCCAGCGTAGA"	"TPC_1"
"TCACACCGTGGAAATT"	"TPC_2:LowCov"
"TCACACCTCAAGATAG"	"TPC_2:LowCov"
"TCACACCTCGACGCGT"	"TPC_1"
"TCACATTAGACGCATG"	"TPC_3:HighMT"
"TCACATTAGAGTTGTA"	"TPC_3:HighMT"
"TCACATTGTGACTATC"	"TPC_2:LowCov"
"TCACGCTTCCCTTCCC"	"TPC_1"
"TCACGCTTCTGCTGAA"	"TPC_3:HighMT"
"TCACGGGCAACCAGAG"	"TPC_4"
"TCACGGGCAATGAGCG"	"TPC_5"
"TCACTCGAGTGGTGAC"	"TPC_2:LowCov"
"TCACTCGCAGCTGTAT"	"TPC_1"
"TCACTCGGTCCAAATC"	"TPC_3:HighMT"
"TCAGCAACAGCTGTGC"	"TPC_3:HighMT"
"TCAGCCTAGATGGCAC"	"TPC_2:LowCov"
"TCAGCCTGTGAGATAT"	"TPC_2:LowCov"
"TCAGCCTTCAAACGAA"	"TPC_1"
"TCAGCCTTCCCATTTA"	"TPC_2:LowCov"
"TCAGGGCAGCCTCATA"	"TPC_2:LowCov"
"TCAGGGCAGTTGTCAC"	"TPC_2:LowCov"
"TCAGGTACAATGTTGC"	"TPC_1"
"TCAGGTATCAGTCAGT"	"TPC_2:LowCov"
"TCAGTCCAGCCTTTCC"	"TPC_2:LowCov"
"TCAGTGATCCTGCTAC"	"TPC_2:LowCov"
"TCAGTTTCATCTCAAG"	"TPC_2:LowCov"
"TCAGTTTGTGGTATGG"	"TPC_2:LowCov"
"TCATACTAGGCTAACG"	"TPC_3:HighMT"
"TCATATCCACCAGCGT"	"TPC_3:HighMT"
"TCATATCCACCTCTAC"	"TPC_1"
"TCATATCCAGACAATA"	"TPC_1"
"TCATATCCATCTATCT"	"TPC_2:LowCov"
"TCATATCGTGCTTCAA"	"TPC_1"
"TCATCATAGATCCTAC"	"TPC_2:LowCov"
"TCATCATAGGCCTTGC"	"TPC_1"
"TCATCATCACAATGTC"	"TPC_2:LowCov"
"TCATCATCAGTTAGAA"	"TPC_3:HighMT"
"TCATCATTCGTTCTAT"	"TPC_5"
"TCATCATTCTGGACTA"	"TPC_3:HighMT"
"TCATCCGCATTGAGGG"	"TPC_4"
"TCATGAGAGAGTTGCG"	"TPC_1"
"TCATGAGTCATTGGTG"	"TPC_2:LowCov"
"TCATGAGTCCTGTTAT"	"TPC_4"
"TCATGCCAGGCGCTCT"	"TPC_3:HighMT"
"TCATGCCTCAAACCTG"	"TPC_2:LowCov"
"TCATGCCTCCTGGGTG"	"TPC_1"
"TCATGCCTCGGCATCG"	"TPC_2:LowCov"
"TCATGGACAGCTGTAT"	"TPC_1"
"TCATGGATCGTCAAAC"	"TPC_2:LowCov"
"TCATGTTCAGGTCTCG"	"TPC_4"
"TCATGTTGTATGTCAC"	"TPC_5"
"TCATTACCAAGTGTCT"	"TPC_2:LowCov"
"TCATTACCAATTCACG"	"TPC_3:HighMT"
"TCATTACCACGTATAC"	"TPC_1"
"TCATTACCATACCAGT"	"TPC_5"
"TCATTACCATGGCCCA"	"TPC_2:LowCov"
"TCATTACGTACTAAGA"	"TPC_2:LowCov"
"TCATTACTCCGACATA"	"TPC_4"
"TCATTCAGTGAGGCAT"	"TPC_2:LowCov"
"TCATTGTGTGAAAGTT"	"TPC_5"
"TCATTGTTCATGCCCT"	"TPC_3:HighMT"
"TCATTTGAGAAGCTCG"	"TPC_4"
"TCATTTGGTAAGTTAG"	"TPC_3:HighMT"
"TCATTTGTCCCGAACG"	"TPC_1"
"TCCACCAAGCCTCATA"	"TPC_2:LowCov"
"TCCACCAGTCGTAATC"	"TPC_1"
"TCCACGTCACATGAAA"	"TPC_2:LowCov"
"TCCACGTGTGGTCTGC"	"TPC_1"
"TCCAGAAAGACCATAA"	"TPC_3:HighMT"
"TCCAGAAAGCCGATCC"	"TPC_4"
"TCCAGAAAGTTGTAGA"	"TPC_1"
"TCCAGAACAAGAGGTC"	"TPC_6:lowCov"
"TCCAGAACATACCGTA"	"TPC_1"
"TCCAGAATCTAAGCCA"	"TPC_1"
"TCCAGAATCTAGTGAC"	"TPC_1"
"TCCATCGGTTATAGCC"	"TPC_4"
"TCCATCGTCGGAATTC"	"TPC_1"
"TCCATCGTCTCATAGG"	"TPC_2:LowCov"
"TCCATGCAGGTCACCC"	"TPC_2:LowCov"
"TCCATGCCATCGCTAA"	"TPC_2:LowCov"
"TCCATGCGTACGATTC"	"TPC_1"
"TCCCACAAGCAGCACA"	"TPC_3:HighMT"
"TCCCACAAGGTGATCG"	"TPC_3:HighMT"
"TCCCACACACAAGCCC"	"TPC_5"
"TCCCACACAGTCCCGA"	"TPC_1"
"TCCCACACATTCGATG"	"TPC_5"
"TCCCACAGTCCGAAAG"	"TPC_2:LowCov"
"TCCCAGTCAGAAACCG"	"TPC_2:LowCov"
"TCCCAGTCAGGAATCG"	"TPC_5"
"TCCCATGGTCCTACAA"	"TPC_5"
"TCCCATGTCCTACAAG"	"TPC_5"
"TCCGAAATCCAGTTCC"	"TPC_2:LowCov"
"TCCGATCAGAAAGCGA"	"TPC_2:LowCov"
"TCCGATCAGAATTTGG"	"TPC_3:HighMT"
"TCCGATCAGCTCGCAC"	"TPC_1"
"TCCGATCCAGGACAGT"	"TPC_6:lowCov"
"TCCGGGAAGTGTTCCA"	"TPC_2:LowCov"
"TCCGGGACAGTAGATA"	"TPC_5"
"TCCGGGATCATTGAGC"	"TPC_1"
"TCCGTGTGTGCAACAG"	"TPC_4"
"TCCGTGTTCACCATCC"	"TPC_7"
"TCCGTGTTCGTTCGCT"	"TPC_6:lowCov"
"TCCTAATCATCGGATT"	"TPC_1"
"TCCTAATGTCATAACC"	"TPC_2:LowCov"
"TCCTCCCAGGTGAGAA"	"TPC_1"
"TCCTCCCTCCAATCCC"	"TPC_1"
"TCCTCGAAGTTGCTCA"	"TPC_2:LowCov"
"TCCTCGACAACGTTAC"	"TPC_1"
"TCCTCGACATGGGAAC"	"TPC_1"
"TCCTCTTAGCACACCC"	"TPC_1"
"TCCTCTTCAAAGGCTG"	"TPC_5"
"TCCTCTTGTAACGGTG"	"TPC_3:HighMT"
"TCCTCTTGTGGTCTTA"	"TPC_3:HighMT"
"TCCTGCAAGATCCCAT"	"TPC_2:LowCov"
"TCCTGCAAGATGGTAT"	"TPC_2:LowCov"
"TCCTGCAAGGCACGAT"	"TPC_2:LowCov"
"TCCTGCACAGCACGAA"	"TPC_3:HighMT"
"TCCTGCACATATACCG"	"TPC_1"
"TCCTTCTAGCTACAAA"	"TPC_3:HighMT"
"TCCTTCTAGGACAGCT"	"TPC_2:LowCov"
"TCCTTCTCAATACGCT"	"TPC_2:LowCov"
"TCCTTCTCAATCAGCT"	"TPC_5"
"TCCTTTCAGTATCTGC"	"TPC_2:LowCov"
"TCCTTTCTCGACCATA"	"TPC_3:HighMT"
"TCCTTTCTCTCGGCTT"	"TPC_6:lowCov"
"TCCTTTCTCTGCCTCA"	"TPC_2:LowCov"
"TCGAACACATCAGCTA"	"TPC_2:LowCov"
"TCGAACACATGTTACG"	"TPC_6:lowCov"
"TCGAACAGTAGATTGA"	"TPC_5"
"TCGAAGTAGGGCTGAT"	"TPC_1"
"TCGAAGTGTCAAAGTA"	"TPC_2:LowCov"
"TCGAAGTTCGGTCGAC"	"TPC_1"
"TCGACCTAGGATACGC"	"TPC_3:HighMT"
"TCGACCTGTAGTTACC"	"TPC_3:HighMT"
"TCGATTTCAATAACGA"	"TPC_1"
"TCGCACTAGTGCTACT"	"TPC_1"
"TCGCACTCATAGCTGT"	"TPC_3:HighMT"
"TCGCACTTCGCGAAGA"	"TPC_2:LowCov"
"TCGCACTTCTCATAGG"	"TPC_2:LowCov"
"TCGCAGGCAACGACTT"	"TPC_2:LowCov"
"TCGCAGGGTGTTCGTA"	"TPC_2:LowCov"
"TCGCTCAGTAGGCTGA"	"TPC_4"
"TCGCTTGAGACGCAGT"	"TPC_1"
"TCGCTTGAGTTGCGCC"	"TPC_2:LowCov"
"TCGCTTGTCCTTATGT"	"TPC_5"
"TCGGATAAGAAATGGG"	"TPC_5"
"TCGGATAAGGCAGCTA"	"TPC_2:LowCov"
"TCGGATACAATCTGCA"	"TPC_5"
"TCGGATACACTACACA"	"TPC_2:LowCov"
"TCGGATAGTATTCTCT"	"TPC_4"
"TCGGATAGTGGATGAC"	"TPC_2:LowCov"
"TCGGATATCTTACGTT"	"TPC_1"
"TCGGGACCAACACTAC"	"TPC_2:LowCov"
"TCGGGACTCAGGAAAT"	"TPC_5"
"TCGGGCAAGGACAGCT"	"TPC_3:HighMT"
"TCGGGCATCGGACTGC"	"TPC_4"
"TCGGGTGGTAGACAAT"	"TPC_2:LowCov"
"TCGGGTGGTGGTTTAC"	"TPC_1"
"TCGGGTGTCATAGAGA"	"TPC_3:HighMT"
"TCGGTCTAGGGACAGG"	"TPC_1"
"TCGGTCTAGTTCCGGC"	"TPC_4"
"TCGGTCTTCAATGCAC"	"TPC_4"
"TCGGTCTTCTTCGTAT"	"TPC_5"
"TCGTCCAAGGAGAATG"	"TPC_1"
"TCGTCCACAGGTGACA"	"TPC_1"
"TCGTCCAGTTGACGGA"	"TPC_1"
"TCGTCCATCGGTGTAT"	"TPC_1"
"TCGTCCATCTCTGCCA"	"TPC_5"
"TCGTGCTAGACCATAA"	"TPC_4"
"TCGTGCTCAGCAGTAG"	"TPC_1"
"TCGTGCTTCTCTTAAC"	"TPC_1"
"TCTAACTGTAGCTCGC"	"TPC_7"
"TCTAACTGTTTCCAAG"	"TPC_7"
"TCTAACTGTTTCCATT"	"TPC_1"
"TCTACATAGACGATAT"	"TPC_2:LowCov"
"TCTACATAGTTCGCAT"	"TPC_5"
"TCTACATTCATTGAGC"	"TPC_2:LowCov"
"TCTACCGAGACCAAGC"	"TPC_4"
"TCTACCGGTGGCGTAA"	"TPC_2:LowCov"
"TCTATACGTGCGTCGT"	"TPC_3:HighMT"
"TCTATACTCCACACAA"	"TPC_3:HighMT"
"TCTATCACACGCTTAA"	"TPC_4"
"TCTATCAGTTAGGAGC"	"TPC_1"
"TCTATCATCGAAGCCC"	"TPC_3:HighMT"
"TCTCACGTCGCCGATG"	"TPC_2:LowCov"
"TCTCAGCAGAGGCGTT"	"TPC_2:LowCov"
"TCTCAGCCACTCTGCT"	"TPC_5"
"TCTCAGCGTACAAACA"	"TPC_1"
"TCTCAGCTCTCTTGCG"	"TPC_1"
"TCTCAGCTCTGTACAG"	"TPC_3:HighMT"
"TCTCTGGTCAATCTCT"	"TPC_6:lowCov"
"TCTCTGGTCCGTGGGT"	"TPC_3:HighMT"
"TCTGCCACAACCAACT"	"TPC_1"
"TCTGCCACACTGCTTC"	"TPC_4"
"TCTGCCAGTAACCAGG"	"TPC_2:LowCov"
"TCTGCCATCCCTCTCC"	"TPC_4"
"TCTGGCTAGCCTGTCG"	"TPC_1"
"TCTGGCTCAAGGCAAC"	"TPC_1"
"TCTGGCTCACAACGCC"	"TPC_4"
"TCTGGCTCACCTCTGT"	"TPC_5"
"TCTGGCTCACGCCACA"	"TPC_1"
"TCTGGCTCAGACTCTA"	"TPC_1"
"TCTGGCTTCACGGTCG"	"TPC_4"
"TCTGGCTTCCTCGCAT"	"TPC_3:HighMT"
"TCTGGCTTCTGAGCAT"	"TPC_1"
"TCTGTCGCAGAGGTTG"	"TPC_2:LowCov"
"TCTGTCGCATGACAGG"	"TPC_3:HighMT"
"TCTGTCGTCACGGTCG"	"TPC_4"
"TCTTAGTCAGCCGTCA"	"TPC_1"
"TCTTAGTGTCGAGCAA"	"TPC_2:LowCov"
"TCTTAGTGTCTAATCG"	"TPC_2:LowCov"
"TCTTAGTGTTCTCCCA"	"TPC_2:LowCov"
"TCTTAGTTCGATCCCT"	"TPC_4"
"TCTTAGTTCGGCTTGG"	"TPC_3:HighMT"
"TCTTCCTAGCACCAGA"	"TPC_3:HighMT"
"TCTTCCTCAGGATGAC"	"TPC_1"
"TCTTCCTCATTCTGTT"	"TPC_3:HighMT"
"TCTTCCTGTGTCTTAG"	"TPC_3:HighMT"
"TCTTGCGTCCGGCAAC"	"TPC_1"
"TCTTTGAAGGTTACCT"	"TPC_1"
"TCTTTGACAACATACC"	"TPC_3:HighMT"
"TCTTTGACAGCGACCT"	"TPC_3:HighMT"
"TGAACGTAGGTTAAAC"	"TPC_2:LowCov"
"TGAACGTCAGTCTTCC"	"TPC_5"
"TGAATCGAGGCTCAAG"	"TPC_4"
"TGAATCGCATTGTAGC"	"TPC_1"
"TGAATCGGTAGTTCCA"	"TPC_1"
"TGAATGCAGCGACTAG"	"TPC_1"
"TGAATGCAGGTGCAGT"	"TPC_2:LowCov"
"TGACAGTCAAGCACAG"	"TPC_4"
"TGACAGTCACGGCGTT"	"TPC_4"
"TGACAGTCAGCGGTTC"	"TPC_2:LowCov"
"TGACAGTCATCCGCGA"	"TPC_2:LowCov"
"TGACAGTTCATACAGC"	"TPC_2:LowCov"
"TGACAGTTCCACTGGG"	"TPC_2:LowCov"
"TGACCCTCAACAGATA"	"TPC_1"
"TGACCCTCACTGAATC"	"TPC_1"
"TGACCCTCATAGATGA"	"TPC_3:HighMT"
"TGACCCTCATCGGAGA"	"TPC_2:LowCov"
"TGACCCTTCACTGCTC"	"TPC_3:HighMT"
"TGACCCTTCATGTCAG"	"TPC_1"
"TGACCCTTCGCCTAGG"	"TPC_1"
"TGACCCTTCTCCGCAT"	"TPC_3:HighMT"
"TGACCCTTCTCTGCCA"	"TPC_2:LowCov"
"TGACGCGCAAAGCTAA"	"TPC_2:LowCov"
"TGACGCGCAAGCAGGT"	"TPC_2:LowCov"
"TGACGCGCAATAGTAG"	"TPC_1"
"TGACGCGCAGAGTGAC"	"TPC_2:LowCov"
"TGACGCGTCCTACAAG"	"TPC_1"
"TGACTCCAGGTTCTTG"	"TPC_2:LowCov"
"TGACTCCTCCTACCGT"	"TPC_6:lowCov"
"TGAGCATAGAACCCGA"	"TPC_2:LowCov"
"TGAGCATAGATAGTCA"	"TPC_2:LowCov"
"TGAGCATTCTCCCTAG"	"TPC_2:LowCov"
"TGAGCGCCAACAAGAT"	"TPC_1"
"TGAGCGCCAGCACACC"	"TPC_1"
"TGAGCGCGTAGTCGGA"	"TPC_3:HighMT"
"TGAGGAGGTTGGAGAC"	"TPC_2:LowCov"
"TGAGGGAGTAGAGCTG"	"TPC_1"
"TGAGGTTAGCGCCGTT"	"TPC_3:HighMT"
"TGAGGTTCAATCCAGT"	"TPC_4"
"TGAGGTTCAGACGATG"	"TPC_5"
"TGAGGTTTCGCTTACC"	"TPC_4"
"TGAGTCAAGCACGTCC"	"TPC_5"
"TGAGTCATCAGGTAAA"	"TPC_1"
"TGAGTCATCCGATCTC"	"TPC_7"
"TGATCAGCACCAGGTC"	"TPC_1"
"TGATCTTCAGAGACTG"	"TPC_5"
"TGATCTTGTAGCTTAC"	"TPC_2:LowCov"
"TGATCTTGTCGCGGTT"	"TPC_1"
"TGATCTTGTCGTTGGC"	"TPC_1"
"TGATGCACACGGGTAA"	"TPC_4"
"TGATGCACAGCCCAGT"	"TPC_1"
"TGATGCACAGCGCTTG"	"TPC_2:LowCov"
"TGATGCAGTGCATTTG"	"TPC_1"
"TGATGCATCTGGCTGG"	"TPC_1"
"TGATGGTAGAGCCGAT"	"TPC_4"
"TGATGGTCAATTGCCA"	"TPC_2:LowCov"
"TGATGGTGTCGCGGTT"	"TPC_4"
"TGATGGTTCTTCCTAA"	"TPC_3:HighMT"
"TGATTCTCACAGTCAT"	"TPC_5"
"TGATTCTCACCAGGTC"	"TPC_2:LowCov"
"TGATTTCGTTATTCCT"	"TPC_5"
"TGATTTCGTTGCGGAA"	"TPC_1"
"TGATTTCTCCCGTTGT"	"TPC_2:LowCov"
"TGATTTCTCCGCGATG"	"TPC_1"
"TGCACGGCACGTCTCT"	"TPC_2:LowCov"
"TGCACGGGTACTTGTG"	"TPC_2:LowCov"
"TGCAGATGTTTGCCGG"	"TPC_1"
"TGCAGATTCCATACTT"	"TPC_2:LowCov"
"TGCAGGCAGTAGCAAT"	"TPC_1"
"TGCAGGCCACAAGCCC"	"TPC_4"
"TGCAGGCCAGGATTCT"	"TPC_1"
"TGCAGGCGTGTCTAAC"	"TPC_1"
"TGCAGTAGTCTACAGT"	"TPC_1"
"TGCAGTAGTGCCGGTT"	"TPC_3:HighMT"
"TGCATCCAGACGAGCT"	"TPC_1"
"TGCATCCCAAGGACAC"	"TPC_2:LowCov"
"TGCATCCTCCGGCTTT"	"TPC_2:LowCov"
"TGCATCCTCCTCCACA"	"TPC_2:LowCov"
"TGCATGACAGGTTACT"	"TPC_2:LowCov"
"TGCATGAGTGACGTCC"	"TPC_5"
"TGCATGAGTGATTAGA"	"TPC_2:LowCov"
"TGCATGATCCACCCTA"	"TPC_3:HighMT"
"TGCCGAGAGAGAGAAC"	"TPC_2:LowCov"
"TGCCGAGCATAATGCC"	"TPC_1"
"TGCCGAGTCAATCTCT"	"TPC_2:LowCov"
"TGCGATAAGTTGTCGT"	"TPC_2:LowCov"
"TGCGATACAGAATCGG"	"TPC_1"
"TGCGATACATGACGAG"	"TPC_5"
"TGCGATATCATTTGCT"	"TPC_1"
"TGCGGCAAGACCGTTT"	"TPC_4"
"TGCGGGTCACATATCG"	"TPC_4"
"TGCGGGTCAGCAGAAC"	"TPC_1"
"TGCTCGTAGGGATCGT"	"TPC_1"
"TGCTCGTTCAGTCCGG"	"TPC_3:HighMT"
"TGCTCGTTCCATCCGT"	"TPC_2:LowCov"
"TGCTCGTTCGTAGGAG"	"TPC_3:HighMT"
"TGCTGAAAGACGAGCT"	"TPC_2:LowCov"
"TGCTGAACAGATACTC"	"TPC_1"
"TGCTGAAGTACTGCCG"	"TPC_6:lowCov"
"TGCTGAATCAGCCTTC"	"TPC_2:LowCov"
"TGCTGAATCCTCTAGC"	"TPC_1"
"TGCTTCGAGACCCGCT"	"TPC_1"
"TGCTTCGCACACCGCA"	"TPC_4"
"TGCTTGCCAGAGTAAT"	"TPC_3:HighMT"
"TGCTTGCGTGTCTCCT"	"TPC_4"
"TGCTTGCGTTCGGACC"	"TPC_1"
"TGCTTGCTCGTCCATC"	"TPC_5"
"TGGAACTAGCACACAG"	"TPC_1"
"TGGAACTTCGGACCAC"	"TPC_4"
"TGGAGAGCAGGACTTT"	"TPC_2:LowCov"
"TGGAGAGCATAGAGGC"	"TPC_4"
"TGGAGAGGTATGAAGT"	"TPC_2:LowCov"
"TGGAGAGGTTCGGTTA"	"TPC_1"
"TGGAGAGGTTGCACGC"	"TPC_1"
"TGGAGAGTCCGACAGC"	"TPC_5"
"TGGAGAGTCTCTCGAC"	"TPC_2:LowCov"
"TGGAGGAAGTAGTCAA"	"TPC_2:LowCov"
"TGGAGGATCCATTCGC"	"TPC_4"
"TGGATCAAGGAACTCG"	"TPC_1"
"TGGATCAGTGGACAGT"	"TPC_5"
"TGGATCATCACTTCTA"	"TPC_3:HighMT"
"TGGATGTGTGGACCAA"	"TPC_2:LowCov"
"TGGATGTTCTGCTAGA"	"TPC_2:LowCov"
"TGGCGTGGTGGGAGAG"	"TPC_2:LowCov"
"TGGGAAGGTCTAACGT"	"TPC_1"
"TGGGAAGTCAATCGGT"	"TPC_2:LowCov"
"TGGGAGAAGCATCGAG"	"TPC_5"
"TGGGATTGTAGGTACG"	"TPC_4"
"TGGGATTGTCAGGTGA"	"TPC_5"
"TGGGATTTCACGGTCG"	"TPC_3:HighMT"
"TGGGATTTCAGGAACG"	"TPC_2:LowCov"
"TGGGCGTAGACCCGCT"	"TPC_1"
"TGGGCGTCAATTCGTG"	"TPC_2:LowCov"
"TGGGCGTGTGTTCATG"	"TPC_1"
"TGGGCTGCAGCTGCCA"	"TPC_3:HighMT"
"TGGGCTGGTGTAGCAG"	"TPC_1"
"TGGGTTACAAAGTGTA"	"TPC_3:HighMT"
"TGGGTTATCCGTCAAA"	"TPC_1"
"TGGTACAAGCTCCCTT"	"TPC_2:LowCov"
"TGGTACAAGTGAGCCA"	"TPC_2:LowCov"
"TGGTACAGTGGAATGC"	"TPC_2:LowCov"
"TGGTACAGTTCGGGTC"	"TPC_1"
"TGGTACATCTCAACGA"	"TPC_7"
"TGGTAGTCAGAGAGGG"	"TPC_5"
"TGGTAGTCAGTTACCA"	"TPC_5"
"TGGTAGTTCATGGAGG"	"TPC_2:LowCov"
"TGGTGATGTCTCACGG"	"TPC_1"
"TGGTTAGAGAGAATCT"	"TPC_5"
"TGGTTAGAGGACAAGA"	"TPC_2:LowCov"
"TGGTTAGCACAAAGTA"	"TPC_1"
"TGGTTAGCACTTCAGA"	"TPC_2:LowCov"
"TGGTTAGGTTAATCGC"	"TPC_1"
"TGGTTAGGTTTCGGCG"	"TPC_6:lowCov"
"TGGTTAGTCTAAGCGT"	"TPC_4"
"TGTAACGCACACGTGC"	"TPC_2:LowCov"
"TGTAACGCACCCATAA"	"TPC_4"
"TGTAACGCAGCACACC"	"TPC_3:HighMT"
"TGTAACGCATCTCATT"	"TPC_3:HighMT"
"TGTAAGCAGTTGCGAG"	"TPC_2:LowCov"
"TGTAAGCTCCATGAGT"	"TPC_1"
"TGTACAGAGGATATAC"	"TPC_5"
"TGTACAGAGTGCGCTC"	"TPC_1"
"TGTACAGGTTGCAAGG"	"TPC_2:LowCov"
"TGTAGACAGAAGGATG"	"TPC_7"
"TGTAGACCACACCGAC"	"TPC_5"
"TGTAGACGTCATAGTC"	"TPC_1"
"TGTAGACGTTCCTACC"	"TPC_4"
"TGTAGACTCGAAGTGG"	"TPC_5"
"TGTCAGACAAAGCTAA"	"TPC_2:LowCov"
"TGTCAGACAACCAATC"	"TPC_4"
"TGTCAGACAAGCGAAC"	"TPC_6:lowCov"
"TGTCAGATCTTCGTAT"	"TPC_3:HighMT"
"TGTCCACCATGTTACG"	"TPC_1"
"TGTCCACTCGGTATGT"	"TPC_5"
"TGTCCCAAGCACTCTA"	"TPC_1"
"TGTCCCAAGCTAATCC"	"TPC_6:lowCov"
"TGTCCCACAATTGTGC"	"TPC_1"
"TGTCCCATCAGGACGA"	"TPC_1"
"TGTCCCATCTGTTCAT"	"TPC_3:HighMT"
"TGTCCTGAGGTAATCA"	"TPC_2:LowCov"
"TGTCCTGCACTATGTG"	"TPC_5"
"TGTGAGTAGAGTAACT"	"TPC_1"
"TGTGAGTAGATTCGAA"	"TPC_1"
"TGTGAGTAGGAAGTAG"	"TPC_1"
"TGTGAGTGTAACGTTC"	"TPC_1"
"TGTGAGTGTCCACTTC"	"TPC_1"
"TGTGCGGAGCCACTCG"	"TPC_4"
"TGTGCGGCACCTCGTT"	"TPC_4"
"TGTGCGGCAGGCTTGC"	"TPC_2:LowCov"
"TGTGCGGGTAGTGCGA"	"TPC_5"
"TGTGCGGTCCGGGACT"	"TPC_1"
"TGTGGCGAGAGCCATG"	"TPC_1"
"TGTGGCGAGGGCCTCT"	"TPC_1"
"TGTGGCGTCGTGACTA"	"TPC_4"
"TGTGTGACAAATTAGG"	"TPC_4"
"TGTGTGACATACCGTA"	"TPC_4"
"TGTGTGAGTCAAGTTC"	"TPC_1"
"TGTGTGATCGCCTTGT"	"TPC_3:HighMT"
"TGTTCATCAGCAGTCC"	"TPC_3:HighMT"
"TGTTCCGGTCCTCCTA"	"TPC_1"
"TGTTCTAAGAGTGTTA"	"TPC_7"
"TGTTCTATCAACCTTT"	"TPC_5"
"TGTTCTATCTTACGTT"	"TPC_1"
"TGTTTGTAGAAGTATC"	"TPC_1"
"TGTTTGTAGGCCCAAA"	"TPC_4"
"TGTTTGTAGTGCAAAT"	"TPC_2:LowCov"
"TGTTTGTGTGTTATCG"	"TPC_2:LowCov"
"TTAATCCGTGCAACAG"	"TPC_4"
"TTAATCCTCCAAGCTA"	"TPC_5"
"TTACAGGAGCGCTGAA"	"TPC_2:LowCov"
"TTACAGGCACCAATTG"	"TPC_3:HighMT"
"TTACAGGTCAGGAAAT"	"TPC_2:LowCov"
"TTACCATAGGTTCATC"	"TPC_2:LowCov"
"TTACCATCAATCGCAT"	"TPC_1"
"TTACCATTCATTGGTG"	"TPC_5"
"TTACCGCAGTCACTGT"	"TPC_1"
"TTACCGCAGTCTAGAA"	"TPC_1"
"TTACCGCAGTTCTCTT"	"TPC_6:lowCov"
"TTACGCCCAAGCGAGT"	"TPC_5"
"TTACGCCCACTGCATA"	"TPC_1"
"TTACGCCGTAGAGTTA"	"TPC_3:HighMT"
"TTACGCCGTGCATACT"	"TPC_5"
"TTACGCCTCGCGTGCA"	"TPC_1"
"TTACGTTCACTACAGT"	"TPC_2:LowCov"
"TTACGTTCAGATTTCG"	"TPC_5"
"TTACTGTTCCTAGCTC"	"TPC_1"
"TTAGGCAGTGCTGATT"	"TPC_4"
"TTAGGGTAGCGTTAGG"	"TPC_2:LowCov"
"TTAGGGTAGGGCAACT"	"TPC_1"
"TTAGGGTAGTTCTCTT"	"TPC_3:HighMT"
"TTAGTCTAGGAGAGGC"	"TPC_4"
"TTAGTCTCAACTCGAT"	"TPC_4"
"TTAGTCTCAGGCCCTA"	"TPC_1"
"TTAGTCTGTAGGTACG"	"TPC_4"
"TTAGTCTGTCCACAGC"	"TPC_1"
"TTATTGCCATTCAGGT"	"TPC_1"
"TTATTGCTCACTGTCC"	"TPC_2:LowCov"
"TTCAATCGTAGACAGC"	"TPC_2:LowCov"
"TTCAATCTCGAACGCC"	"TPC_2:LowCov"
"TTCAATCTCGGCGATC"	"TPC_2:LowCov"
"TTCACCGCAAGCACCC"	"TPC_2:LowCov"
"TTCACCGTCTCATGCC"	"TPC_2:LowCov"
"TTCACGCTCAGTCATG"	"TPC_2:LowCov"
"TTCACGCTCTCCGTGT"	"TPC_2:LowCov"
"TTCACGCTCTGTTCAT"	"TPC_1"
"TTCAGGAAGGATACAT"	"TPC_2:LowCov"
"TTCAGGACAACAGATA"	"TPC_3:HighMT"
"TTCAGGAGTTACGTAC"	"TPC_5"
"TTCAGGAGTTGTTGTG"	"TPC_5"
"TTCATGTAGGGCAACT"	"TPC_5"
"TTCATGTAGTAGTCAA"	"TPC_1"
"TTCATGTGTGATGGCA"	"TPC_1"
"TTCATTGAGTACTCGT"	"TPC_2:LowCov"
"TTCATTGGTTTCACTT"	"TPC_5"
"TTCATTGTCTTCCACG"	"TPC_2:LowCov"
"TTCCAATTCCTACCGT"	"TPC_6:lowCov"
"TTCCACGAGCTAAGTA"	"TPC_2:LowCov"
"TTCCACGCATAATCCG"	"TPC_1"
"TTCCGGTCAACCGATT"	"TPC_1"
"TTCCGGTCAAGCCTGC"	"TPC_5"
"TTCCGGTTCCAGCAAT"	"TPC_2:LowCov"
"TTCCGTGAGGCTATCT"	"TPC_3:HighMT"
"TTCCGTGCAAATGATG"	"TPC_3:HighMT"
"TTCCGTGCACCCTATC"	"TPC_1"
"TTCCGTGTCGAGAGAC"	"TPC_5"
"TTCCTAAAGGTAAACT"	"TPC_2:LowCov"
"TTCCTAACATCGATGT"	"TPC_2:LowCov"
"TTCCTAAGTCCAACGC"	"TPC_5"
"TTCCTAAGTCTAGGCC"	"TPC_1"
"TTCCTAAGTGTATTGC"	"TPC_3:HighMT"
"TTCCTAATCTGTCAGA"	"TPC_4"
"TTCCTCTCACATATGC"	"TPC_1"
"TTCCTCTGTCGTCATA"	"TPC_1"
"TTCCTCTGTTCTATCT"	"TPC_5"
"TTCCTCTTCTTGTGCC"	"TPC_6:lowCov"
"TTCCTTCAGTTGCCCG"	"TPC_1"
"TTCCTTCCAGGTGAGT"	"TPC_3:HighMT"
"TTCCTTCCATCAGTCA"	"TPC_3:HighMT"
"TTCCTTCGTTAAACAG"	"TPC_1"
"TTCCTTCGTTGCCAAT"	"TPC_1"
"TTCGATTCATAATGAG"	"TPC_4"
"TTCGATTTCATTCCTA"	"TPC_1"
"TTCGCTGAGATGAACT"	"TPC_2:LowCov"
"TTCGCTGTCCTGCTAC"	"TPC_7"
"TTCGGTCAGTTCTACG"	"TPC_5"
"TTCTAACTCTCGTCAC"	"TPC_2:LowCov"
"TTCTAGTAGAAGCCTG"	"TPC_4"
"TTCTAGTAGACCGTTT"	"TPC_2:LowCov"
"TTCTAGTGTTGTGTTG"	"TPC_1"
"TTCTAGTTCATCAGTG"	"TPC_1"
"TTCTCTCAGACAACAT"	"TPC_1"
"TTCTCTCGTAGAGTTA"	"TPC_2:LowCov"
"TTCTCTCGTTGGTAGG"	"TPC_2:LowCov"
"TTCTCTCTCAAACTGC"	"TPC_2:LowCov"
"TTCTCTCTCAGCTGTA"	"TPC_2:LowCov"
"TTCTGTAAGGTAGGCT"	"TPC_5"
"TTCTTCCCAGCGGTTC"	"TPC_1"
"TTCTTCCGTGTGTGGA"	"TPC_1"
"TTCTTGACATAATCGC"	"TPC_1"
"TTCTTGACATGCCATA"	"TPC_3:HighMT"
"TTGAACGCAGCTCCTT"	"TPC_2:LowCov"
"TTGAACGCAGGTATGG"	"TPC_1"
"TTGACCCCAGCTCTGG"	"TPC_2:LowCov"
"TTGACCCGTGGCCCAT"	"TPC_2:LowCov"
"TTGACCCTCATCTGTT"	"TPC_2:LowCov"
"TTGACCCTCTGTACAG"	"TPC_2:LowCov"
"TTGAGTGAGAAATTCG"	"TPC_2:LowCov"
"TTGAGTGCATGCCATA"	"TPC_5"
"TTGAGTGGTGGAACCA"	"TPC_3:HighMT"
"TTGAGTGGTTCGGTAT"	"TPC_1"
"TTGATGGCAAGACAAT"	"TPC_3:HighMT"
"TTGATGGCACTGATTG"	"TPC_5"
"TTGATGGTCCCTCTAG"	"TPC_1"
"TTGATGGTCGAACCTA"	"TPC_2:LowCov"
"TTGCATTAGACCATTC"	"TPC_1"
"TTGCATTAGGAATTAC"	"TPC_1"
"TTGCCTGAGATTCGCT"	"TPC_1"
"TTGCCTGGTCAAAGCG"	"TPC_2:LowCov"
"TTGCCTGTCTAGACCA"	"TPC_2:LowCov"
"TTGCGTCAGCCGGATA"	"TPC_3:HighMT"
"TTGCGTCCATCATTTC"	"TPC_4"
"TTGCGTCTCATGCGGC"	"TPC_2:LowCov"
"TTGCTGCAGAAACTAC"	"TPC_2:LowCov"
"TTGCTGCAGACCGTTT"	"TPC_4"
"TTGCTGCCAATGAACA"	"TPC_1"
"TTGCTGCTCGATGCAT"	"TPC_2:LowCov"
"TTGGATGAGTACCGGA"	"TPC_4"
"TTGGATGCACCTGATA"	"TPC_4"
"TTGGATGCAGTGGCTC"	"TPC_1"
"TTGGATGGTTGTAGCT"	"TPC_4"
"TTGGGATCAGACTGCC"	"TPC_6:lowCov"
"TTGGGCGCACAGCTTA"	"TPC_4"
"TTGGGCGTCAAGAGTA"	"TPC_1"
"TTGGGTAAGTGACACG"	"TPC_5"
"TTGGGTAGTTGTAGCT"	"TPC_4"
"TTGGTTTAGGTTATAG"	"TPC_1"
"TTGGTTTAGTTGCCTA"	"TPC_1"
"TTGGTTTGTCTCACGG"	"TPC_4"
"TTGGTTTTCAAACCTG"	"TPC_1"
"TTGGTTTTCAGTGTCA"	"TPC_2:LowCov"
"TTGTGGAAGTTGGCTT"	"TPC_1"
"TTGTGGACACTGCATA"	"TPC_3:HighMT"
"TTGTGGATCCGGCAAC"	"TPC_1"
"TTGTGTTCAGAGATGC"	"TPC_3:HighMT"
"TTGTTCAAGCTGCCTG"	"TPC_1"
"TTGTTCAAGTCCCGAC"	"TPC_1"
"TTGTTCACAACGCATT"	"TPC_1"
"TTGTTCAGTATAGGGC"	"TPC_1"
"TTGTTGTCAGCGACAA"	"TPC_5"
"TTGTTGTTCATCCTAT"	"TPC_3:HighMT"
"TTGTTGTTCATGCCCT"	"TPC_3:HighMT"
"TTGTTGTTCTAGACCA"	"TPC_2:LowCov"
"TTGTTTGAGACTGAGC"	"TPC_2:LowCov"
"TTGTTTGCACGGCCAT"	"TPC_1"
"TTGTTTGCAGCGACAA"	"TPC_1"
"TTGTTTGTCAGTGTTG"	"TPC_4"
"TTTACGTCACTCCACT"	"TPC_3:HighMT"
"TTTACGTTCCGATCTC"	"TPC_4"
"TTTACTGAGAAAGTCT"	"TPC_5"
"TTTACTGAGGAAAGGT"	"TPC_2:LowCov"
"TTTACTGCACAGTGTT"	"TPC_4"
"TTTACTGCATTGCCGG"	"TPC_3:HighMT"
"TTTAGTCCACACCTTC"	"TPC_5"
"TTTAGTCGTTCCGTTC"	"TPC_3:HighMT"
"TTTAGTCTCCAAAGGG"	"TPC_1"
"TTTATGCCAAGTGCTT"	"TPC_2:LowCov"
"TTTCACAAGAGCACTG"	"TPC_1"
"TTTCACAAGGGTTAAT"	"TPC_1"
"TTTCACACAATTCTCT"	"TPC_4"
"TTTCACACAGCCTACG"	"TPC_1"
"TTTCACACATGATAGA"	"TPC_1"
"TTTCACACATGCCATA"	"TPC_3:HighMT"
"TTTCACATCTGTTCAT"	"TPC_2:LowCov"
"TTTCAGTAGGGAGGAC"	"TPC_1"
"TTTCAGTCAGACAAAT"	"TPC_4"
"TTTCAGTCAGGTAGTG"	"TPC_2:LowCov"
"TTTCAGTCATAGATGA"	"TPC_1"
"TTTCATGCATGACACT"	"TPC_1"
"TTTCATGTCCTATTGT"	"TPC_1"
"TTTCCTCAGGAACGAA"	"TPC_1"
"TTTCCTCGTTTACTTC"	"TPC_3:HighMT"
"TTTCGATCACGGTGCT"	"TPC_1"
"TTTCGATCATGTCAGT"	"TPC_2:LowCov"
"TTTCGATTCGAAGTGG"	"TPC_2:LowCov"
"TTTGACTCAGTCTTCC"	"TPC_4"
"TTTGATCCACGGTAGA"	"TPC_1"
"TTTGATCGTCTGTCAA"	"TPC_1"
"TTTGATCTCGCGAAGA"	"TPC_1"
"TTTGGAGCAGCACGAA"	"TPC_3:HighMT"
"TTTGGTTAGTAAAGCT"	"TPC_2:LowCov"
"TTTGGTTCAACAGTGG"	"TPC_2:LowCov"
"TTTGTTGCAAACCGGA"	"TPC_5"
"TTTGTTGGTAGCTTAC"	"TPC_2:LowCov"
"TTTGTTGTCCGTAATG"	"TPC_1"
