""	"Ident"
"AAACCCAGTCACTGAT"	"Cyst.PT_1"
"AAACCCAGTCTGTAAC"	"EC"
"AAACGAAAGCGAGTCA"	"Cyst.TAL_2"
"AAACGAACACCGGCTA"	"Cyst.PT_1"
"AAACGAACAGACACAG"	"Cyst.PC"
"AAACGAACAGGCTCTG"	"Cyst.ATL"
"AAACGAACATCCTATT"	"Mac"
"AAACGAAGTGCAGGAT"	"Cyst.TAL_1"
"AAACGAATCAATCAGC"	"Cyst.PT_1"
"AAACGAATCCATTCAT"	"Unk_1"
"AAACGAATCTGCCCTA"	"Cyst.TAL_1"
"AAACGCTGTATTGACC"	"Cyst.PC"
"AAACGCTGTTTCTATC"	"Cyst.PC"
"AAACGCTTCGACACCG"	"Cyst.PT_1"
"AAAGAACAGGCTCTCG"	"Cyst.PT_1"
"AAAGAACAGGTTGCCC"	"Cyst.PT_3"
"AAAGAACCACCGCTAG"	"Cyst.TAL_2"
"AAAGAACGTCAGGTGA"	"Cyst.PT_2"
"AAAGAACGTCGCTCGA"	"Cyst.TAL_1"
"AAAGAACGTCTCAGAT"	"Cyst.TAL_2"
"AAAGAACGTGGGCTCT"	"Cyst.PT_3"
"AAAGAACGTGTCTTGA"	"Cyst.PT_2"
"AAAGAACTCAAGCTTG"	"Cyst.PT_1"
"AAAGAACTCCATCGTC"	"Cyst.TAL_1"
"AAAGAACTCTAGTGAC"	"vSMC"
"AAAGGATTCATAGGCT"	"Cyst.TAL_2"
"AAAGGATTCCGAGTGC"	"Mac"
"AAAGGATTCGAAGCCC"	"Cyst.PT_1"
"AAAGGGCAGGGAGTGG"	"Cyst.PT_1"
"AAAGGGCAGGGCATGT"	"Cyst.PT_1"
"AAAGGGCCAACCCTCT"	"Cyst.PT_1"
"AAAGGGCGTAATGCTC"	"Cyst.PT_1"
"AAAGGGCTCATCCCGT"	"Cyst.PT_1"
"AAAGGGCTCCTTACCG"	"Cyst.PT_2"
"AAAGGGCTCTTACACT"	"Cyst.PT_1"
"AAAGGTAAGCCGATTT"	"Cyst.TAL_1"
"AAAGGTACACCAGGTC"	"Mac"
"AAAGGTACACTGAGTT"	"Fibroblast"
"AAAGGTACATCCTGTC"	"Cyst.PC"
"AAAGGTACATCGCTAA"	"Cyst.TAL_1"
"AAAGGTATCGTGGCTG"	"Cyst.PT_3"
"AAAGGTATCTCCCATG"	"Cyst.TAL_2"
"AAAGTCCAGAAAGTCT"	"Cyst.PT_1"
"AAAGTCCAGTAGTCTC"	"Podocytes"
"AAAGTCCGTCCGCAGT"	"Cyst.PT_2"
"AAAGTCCTCGTCGCTT"	"Cyst.PT_1"
"AAAGTCCTCTCGTGAA"	"Cyst.PT_2"
"AAAGTGAAGTAAGGGA"	"Cyst.PT_2"
"AAAGTGACAGGCTCTG"	"Cyst.TAL_2"
"AAAGTGAGTAGACAAT"	"Cyst.PT_1"
"AAAGTGAGTCAATCTG"	"EC"
"AAAGTGAGTGTTCATG"	"Cyst.TAL_2"
"AAAGTGATCGCCGAGT"	"Cyst.PT_1"
"AAAGTGATCTCGGCTT"	"Cyst.PT_2"
"AAATGGACAGTTCTAG"	"Cyst.PT_1"
"AAATGGATCATACGGT"	"Cyst.PT_1"
"AACAAAGAGCACTAGG"	"Cyst.PT_2"
"AACAAAGGTCAACCTA"	"Cyst.PT_2"
"AACAACCAGAGTGACC"	":LowQual"
"AACAACCAGCATTGTC"	"EC"
"AACAACCCATGACTGT"	"Cyst.ATL"
"AACAACCGTCGCCACA"	"T-cell"
"AACAACCGTGCCTTCT"	"Cyst.PT_2"
"AACAACCGTTCATCTT"	"Cyst.PT_1"
"AACAAGAAGTGCTCAT"	"Cyst.TAL_2"
"AACAAGAAGTGGTTCT"	"Cyst.TAL_2"
"AACAAGACATTGGATC"	"Cyst.TAL_2"
"AACAAGAGTGCCGTAC"	"Cyst.TAL_1"
"AACAAGAGTGGGCTTC"	"Cyst.PT_3"
"AACAAGAGTGTGAATA"	"Cyst.PT_2"
"AACAAGATCGGCTGGT"	"Cyst.TAL_1"
"AACAAGATCTTCTCAA"	"Cyst.PT_1"
"AACACACAGAATAACC"	"Fibroblast"
"AACACACCATCATTGG"	"Cyst.TAL_1"
"AACACACGTCATAAAG"	"Cyst.TAL_2"
"AACACACGTCTCAGGC"	"Cyst.PT_1"
"AACACACGTGATAGAT"	"Cyst.TAL_1"
"AACAGGGAGAGAATCT"	"Podocytes"
"AACAGGGCAAGACGAC"	"EC"
"AACAGGGCAGGTCAAG"	"Cyst.PT_2"
"AACAGGGTCATCTATC"	"Mac"
"AACAGGGTCCACTGAA"	"Cyst.PT_2"
"AACAGGGTCCCGTTGT"	"Cyst.TAL_1"
"AACAGGGTCCCTTCCC"	"Fibroblast"
"AACAGGGTCGCCATAA"	":LowQual"
"AACCAACCAATTTCGG"	"Cyst.TAL_2"
"AACCAACCATATGCGT"	"Cyst.IC-A1"
"AACCAACGTGATGGCA"	"vSMC"
"AACCAACGTGGATACG"	"Mac"
"AACCAACGTGTAGTGG"	"Cyst.PT_1"
"AACCAACTCTCGCAGG"	"Cyst.PT_2"
"AACCACATCGCTGTCT"	"Cyst.PT_1"
"AACCATGAGACAGCGT"	"Cyst.PT_2"
"AACCATGAGGTTACCT"	"Cyst.PT_2"
"AACCATGGTGCTCCGA"	"Fibroblast"
"AACCATGGTGGGTCAA"	"Cyst.TAL_1"
"AACCATGTCACCGGTG"	"Cyst.PT_3"
"AACCATGTCAGTCCGG"	"Cyst.TAL_1"
"AACCCAAGTCAACGCC"	"Cyst.TAL_2"
"AACCCAAGTTCGGGTC"	"Cyst.PT_1"
"AACCCAAGTTGTGTTG"	"Cyst.PT_3"
"AACCCAATCCGATCGG"	"Cyst.TAL_1"
"AACCCAATCCGCGAGT"	"Cyst.TAL_2"
"AACCCAATCCTCCACA"	"Cyst.PT_2"
"AACCCAATCGTTCTCG"	"T-cell"
"AACCTGAAGATCCCAT"	"Podocytes"
"AACCTGACATCTAACG"	"Cyst.PT_2"
"AACCTGAGTAGTCGGA"	"Cyst.PT_2"
"AACCTGATCAACCCGG"	"Cyst.PT_1"
"AACCTGATCATAGACC"	"Cyst.PT_1"
"AACCTGATCTCACGAA"	"Fibroblast"
"AACCTTTAGACCCGCT"	"Cyst.PT_3"
"AACCTTTAGCGTGAGT"	"Cyst.PT_1"
"AACCTTTCACAGAGAC"	"Cyst.PT_3"
"AACCTTTCACCCTTGT"	"Cyst.TAL_2"
"AACCTTTCAGCAGACA"	"Cyst.TAL_2"
"AACCTTTCATAGAATG"	"Fibroblast"
"AACCTTTGTGCTCTTC"	"Cyst.PT_2"
"AACCTTTTCACTCTTA"	"Podocytes"
"AACCTTTTCCATAGAC"	"Cyst.PT_1"
"AACGAAAAGCTGCCTG"	"Cyst.PT_1"
"AACGAAACACCACATA"	"vSMC"
"AACGAAACACCAGTAT"	"Cyst.PT_1"
"AACGAAATCCCGTTCA"	"Cyst.PC"
"AACGGGAAGAAATTGC"	"Cyst.PT_1"
"AACGGGACAAATCAAG"	"Cyst.PT_2"
"AACGGGACAACGGCCT"	"Cyst.PC"
"AACGGGACACGTCGGT"	"vSMC"
"AACGGGAGTCTGTAGT"	"vSMC"
"AACGGGAGTTCCAAAC"	"Cyst.PT_3"
"AACGGGATCAAACGTC"	"Cyst.TAL_1"
"AACGGGATCGAACACT"	"Fibroblast"
"AACGTCAAGAGTCGAC"	"Cyst.TAL_1"
"AACGTCAAGATTGATG"	"vSMC"
"AACGTCAAGCAGAAAG"	"Podocytes"
"AACGTCAAGGGCGAAG"	"Cyst.PT_2"
"AACGTCACAATGGCCC"	"Fibroblast"
"AACGTCACATGAATAG"	"Cyst.PT_1"
"AACGTCAGTCATCGGC"	"Cyst.PT_2"
"AACGTCAGTCTTGAGT"	"vSMC"
"AACGTCAGTTTACGTG"	"Cyst.PT_3"
"AACGTCATCAACTCTT"	"Fibroblast"
"AACTTCTAGAACTTCC"	"Cyst.PT_2"
"AACTTCTAGCTGTTCA"	"vSMC"
"AACTTCTGTCGTACAT"	"Cyst.PT_2"
"AACTTCTGTGACTAAA"	"Cyst.PT_2"
"AACTTCTTCCAAATGC"	"Cyst.PT_1"
"AAGAACACATGTTTGG"	"Cyst.PT_1"
"AAGAACAGTAACGCGA"	"Cyst.TAL_1"
"AAGAACATCAAATGAG"	"Cyst.PT_1"
"AAGAACATCCTGTTAT"	"vSMC"
"AAGACAAAGCACGTCC"	"Cyst.PT_3"
"AAGACAACAGTCGTTA"	"Fibroblast"
"AAGACAAGTCACGCTG"	"vSMC"
"AAGACTCGTTGTCCCT"	"Mac"
"AAGACTCTCGAATGCT"	"Cyst.TAL_1"
"AAGATAGCAAACACGG"	"Cyst.PC"
"AAGATAGGTGAGATAT"	"Cyst.TAL_2"
"AAGATAGGTTCGTTCC"	"EC"
"AAGATAGTCGATGCAT"	"Cyst.TAL_2"
"AAGCATCCAAGAGTTA"	"Cyst.TAL_1"
"AAGCATCGTGTCATTG"	"Cyst.PT_2"
"AAGCATCTCGGCTATA"	"Cyst.PT_1"
"AAGCATCTCGTTGCCT"	"Cyst.PT_3"
"AAGCATCTCTCCGATC"	"Cyst.PC"
"AAGCCATAGTTCTCTT"	"Cyst.PT_2"
"AAGCCATCAATTGCCA"	"Fibroblast"
"AAGCCATCATGACGTT"	"Cyst.TAL_1"
"AAGCCATTCCGAAATC"	"Mac"
"AAGCCATTCTCTGAGA"	"Cyst.PT_1"
"AAGCGAGAGCCAACCC"	"Cyst.TAL_2"
"AAGCGAGAGTAGTCTC"	"Cyst.PT_1"
"AAGCGAGCACCTCAGG"	"Cyst.TAL_1"
"AAGCGAGCAGGTGTTT"	":LowQual"
"AAGCGAGGTGTCCGTG"	":LowQual"
"AAGCGAGGTTAGGGAC"	"Cyst.PT_2"
"AAGCGTTAGCCATGCC"	"Cyst.TAL_2"
"AAGCGTTAGCTGGCTC"	"Cyst.TAL_2"
"AAGCGTTCACTATCGA"	"Cyst.PC"
"AAGCGTTCATCTAACG"	"Cyst.PC"
"AAGCGTTGTCCGGTCA"	"Cyst.PT_1"
"AAGCGTTGTCGATTTG"	"vSMC"
"AAGCGTTGTGGATCGA"	"Cyst.PT_2"
"AAGCGTTTCAGGACGA"	"Cyst.TAL_2"
"AAGCGTTTCGTTAGAC"	"Cyst.PT_1"
"AAGGAATCAGCGGTTC"	"Cyst.PT_3"
"AAGGAATGTCAATGGG"	"Podocytes"
"AAGGAATGTCTGCATA"	"vSMC"
"AAGGAATGTTCAGCTA"	"Cyst.PT_2"
"AAGGAATGTTCTTAGG"	"Cyst.PT_2"
"AAGGAATTCGATGCAT"	"Cyst.TAL_2"
"AAGGAATTCGGTCTGG"	"Cyst.PT_1"
"AAGGTAACATCCGTTC"	"Cyst.TAL_1"
"AAGGTAAGTTCTAACG"	"Cyst.TAL_1"
"AAGGTAAGTTGGACTT"	"Cyst.PT_2"
"AAGTACCCAACAAGTA"	"Cyst.TAL_1"
"AAGTACCGTCCACAGC"	"Cyst.PT_3"
"AAGTACCGTGACTCGC"	"Cyst.PT_3"
"AAGTACCGTTTCAGAC"	"Cyst.PT_1"
"AAGTACCTCAGAGCGA"	"Cyst.TAL_1"
"AAGTCGTAGCTCCCTT"	"Mac"
"AAGTCGTAGGGTTGCA"	"Cyst.PT_2"
"AAGTCGTCATGATGCT"	"Cyst.TAL_2"
"AAGTCGTGTAAGATCA"	"Cyst.PT_3"
"AAGTCGTGTCGCACGT"	"Cyst.PT_2"
"AAGTCGTGTTGCTAGT"	"EC"
"AAGTGAACATGTGGTT"	"Cyst.TAL_1"
"AAGTGAATCGGCTTCT"	"Cyst.TAL_1"
"AAGTGAATCTCAACCC"	"Cyst.IC-A1"
"AAGTTCGCAGCGAGTA"	"Cyst.PT_3"
"AAGTTCGGTGGACTAG"	"Cyst.TAL_1"
"AAGTTCGGTGTTTACG"	"Cyst.TAL_2"
"AAGTTCGGTTGTGGAG"	"Cyst.TAL_1"
"AAGTTCGTCCGTGCGA"	"EC"
"AATAGAGCACGACCTG"	"Mac"
"AATAGAGCAGAGGGTT"	"Cyst.IC-A1"
"AATAGAGTCATCGGGC"	"Cyst.PT_3"
"AATCACGAGAATGTTG"	"Cyst.PT_3"
"AATCACGCAACTAGAA"	"Cyst.TAL_2"
"AATCACGCACAGTGAG"	"Cyst.TAL_1"
"AATCACGCAGAGTGAC"	"Podocytes"
"AATCACGGTGGTATGG"	"Podocytes"
"AATCACGTCTGGCCAG"	"Cyst.PT_2"
"AATCGACGTCGCTGCA"	"Cyst.TAL_2"
"AATCGACTCATGCTAG"	"Cyst.PT_2"
"AATCGACTCGCTTACC"	"vSMC"
"AATCGTGAGAGGTTAT"	"Cyst.PT_2"
"AATCGTGAGGTCGCCT"	"Cyst.PT_3"
"AATCGTGCAATGTGGG"	"Cyst.TAL_2"
"AATCGTGCAGAAACCG"	"Cyst.PT_1"
"AATCGTGCAGAAGCGT"	"Cyst.PT_2"
"AATCGTGTCGCAATTG"	"Cyst.PT_1"
"AATGAAGAGCCTCTCT"	"Cyst.TAL_1"
"AATGAAGAGCCTGAAG"	"Cyst.TAL_1"
"AATGAAGAGCTTTCTT"	"Cyst.TAL_1"
"AATGAAGCACAGAAGC"	"vSMC"
"AATGAAGCACGCAAAG"	"Cyst.PT_3"
"AATGAAGCACGCTGCA"	"Cyst.PC"
"AATGAAGCAGGACTAG"	"Cyst.ATL"
"AATGAAGCATCTGTTT"	"Cyst.PT_3"
"AATGAAGGTGATTCAC"	"Cyst.PT_1"
"AATGAAGTCATGCTAG"	"Cyst.PT_1"
"AATGAAGTCATTACGG"	"Cyst.PT_3"
"AATGAAGTCCTTTAGT"	"Cyst.PT_1"
"AATGAAGTCTTGGAAC"	"Cyst.TAL_2"
"AATGACCAGCCTCAAT"	"Podocytes"
"AATGACCAGCGAGTAC"	"Cyst.PT_2"
"AATGACCCAGCAAGAC"	"Cyst.TAL_2"
"AATGACCCATGTCAGT"	"Cyst.TAL_1"
"AATGACCGTTCGTACA"	"Cyst.TAL_1"
"AATGACCTCGGAACTT"	"Cyst.PT_2"
"AATGACCTCGGTCACG"	"Cyst.PT_3"
"AATGACCTCGTTAGTG"	"Cyst.PT_2"
"AATGCCAAGACCTCAT"	"Cyst.PT_1"
"AATGCCAAGCAAATCA"	"Cyst.PC"
"AATGCCAAGCCAAGTG"	"Cyst.PC"
"AATGCCACACACCAGC"	"Cyst.PT_1"
"AATGCCACAGACCAAG"	"Cyst.PT_1"
"AATGCCACAGAGGGTT"	"Cyst.TAL_1"
"AATGCCACATCATTGG"	"Cyst.TAL_1"
"AATGCCAGTACGATGG"	"Cyst.PT_2"
"AATGCCAGTGGCTTGC"	"Cyst.PT_2"
"AATGCCATCAACACGT"	"Cyst.PC"
"AATGCCATCGCTACGG"	"Cyst.TAL_2"
"AATGGAAAGGAGAGGC"	"Unk_2"
"AATGGAAAGGTCCAGA"	"Cyst.TAL_2"
"AATGGAACAAGAATGT"	"Podocytes"
"AATGGAAGTGTCATCA"	"EC"
"AATGGAAGTTAGGGTG"	"Cyst.PC"
"AATGGAAGTTCCATTT"	"Cyst.TAL_2"
"AATGGAATCACACCGG"	"Cyst.TAL_2"
"AATGGAATCGCTACAA"	"Podocytes"
"AATGGCTAGCCAGTAG"	"Cyst.TAL_2"
"AATGGCTCACTGTCCT"	"Unk_1"
"AATGGCTGTAAGATAC"	"Cyst.PT_2"
"AATGGCTTCCCACAGG"	"Cyst.PT_2"
"AATTCCTAGGGAGTGG"	"Cyst.PT_1"
"AATTCCTCAAGATGGC"	"Fibroblast"
"AATTCCTGTACTAAGA"	"Cyst.TAL_2"
"AATTCCTGTCGAATTC"	"Cyst.PT_1"
"AATTCCTGTGACCTGC"	"Cyst.PT_1"
"AATTCCTGTGTATCCA"	"Cyst.PT_1"
"AATTCCTTCCCTCATG"	"EC"
"AATTCCTTCCGTTGGG"	"Cyst.TAL_2"
"AATTTCCAGGTATAGT"	"Cyst.TAL_2"
"AATTTCCCAAGACCTT"	"Cyst.PT_2"
"AATTTCCCAATCCTAG"	"T-cell"
"AATTTCCGTGACTAAA"	"vSMC"
"ACAAAGAAGCTGCGAA"	"Cyst.PT_1"
"ACAAAGAAGGTTTGAA"	"Cyst.PT_1"
"ACAAAGATCATGAGGG"	"Cyst.PT_1"
"ACAAAGATCGACGTCG"	"Cyst.PT_1"
"ACAACCAAGTAGACAT"	"Cyst.PT_2"
"ACAACCACAAATGGAT"	"Cyst.PT_2"
"ACAACCAGTAGCTAAA"	"Cyst.PT_2"
"ACAACCAGTTCAATCG"	"Cyst.PT_1"
"ACAACCATCACGTCCT"	"Cyst.TAL_1"
"ACAACCATCGGAGTGA"	"Cyst.IC-A1"
"ACAAGCTAGCGTGCCT"	"Cyst.PT_2"
"ACAAGCTAGGATACGC"	"Cyst.TAL_2"
"ACAAGCTCAACGACTT"	"Cyst.TAL_1"
"ACAAGCTCAGGATCTT"	"Cyst.PT_3"
"ACAAGCTGTACTGACT"	"Cyst.PC"
"ACAAGCTGTTCCGCGA"	"Cyst.PT_2"
"ACACAGTCATCATCTT"	"Fibroblast"
"ACACAGTGTATCGTAC"	"Cyst.PT_1"
"ACACAGTGTCCGTACG"	"Cyst.TAL_1"
"ACACAGTGTGCATACT"	"Cyst.PT_1"
"ACACAGTTCTTAAGGC"	"Cyst.PT_3"
"ACACCAAGTCGTGTTA"	"Cyst.PC"
"ACACCAATCCAGTTCC"	"Cyst.TAL_1"
"ACACGCGAGTCACGCC"	"Cyst.TAL_1"
"ACACGCGCAGGTATGG"	"Cyst.TAL_2"
"ACACTGACACTATGTG"	"Cyst.TAL_2"
"ACACTGAGTAGAAACT"	"Cyst.PT_1"
"ACACTGAGTTCTGAGT"	"Unk_1"
"ACACTGAGTTGGTGTT"	"Cyst.PT_1"
"ACACTGATCGGTCGAC"	"vSMC"
"ACACTGATCTGCCTCA"	"Cyst.PT_2"
"ACAGAAACAACAGATA"	"Cyst.PT_3"
"ACAGAAAGTACCCGCA"	"Cyst.PT_3"
"ACAGAAAGTATCGTAC"	"Cyst.PC"
"ACAGAAATCAGTGGGA"	"Cyst.PT_1"
"ACAGAAATCCAATCCC"	"Cyst.PT_1"
"ACAGAAATCCGAGGCT"	"Cyst.TAL_1"
"ACAGCCGAGCATGATA"	"Unk_2"
"ACAGCCGAGCCTCTCT"	"Cyst.PT_1"
"ACAGCCGAGCTCCACG"	"Cyst.PT_1"
"ACAGCCGCATCCTCAC"	"Cyst.PT_1"
"ACAGCCGCATCTGGGC"	"Cyst.PT_1"
"ACAGCCGGTAGAGGAA"	"Cyst.TAL_2"
"ACAGCCGGTATCGGTT"	"Cyst.PT_1"
"ACAGCCGGTGGCTTAT"	"Cyst.TAL_1"
"ACAGCCGTCATGGTAC"	"Cyst.TAL_2"
"ACAGCCGTCTAGGCCG"	"Cyst.TAL_1"
"ACAGCCGTCTTAATCC"	"EC"
"ACAGGGAAGCTGGCTC"	"Cyst.PT_2"
"ACAGGGACATCCGTTC"	"Cyst.PT_2"
"ACAGGGACATTAAAGG"	"Cyst.PT_1"
"ACAGGGATCACTACGA"	"Cyst.TAL_1"
"ACAGGGATCTTCCCGA"	"Podocytes"
"ACATCCCCACATTCTT"	"Cyst.TAL_2"
"ACATCCCGTATGGAAT"	"EC"
"ACATCCCTCAAGTCGT"	"Cyst.PT_2"
"ACATCCCTCAAGTCTG"	"Cyst.PT_1"
"ACATCCCTCATTGAGC"	"Cyst.PT_1"
"ACATCCCTCGGTAGAG"	"Podocytes"
"ACATCCCTCGGTTAGT"	"Cyst.TAL_1"
"ACATCGAAGCATGGGT"	"Cyst.TAL_1"
"ACATCGAAGCTGGTGA"	"Cyst.PC"
"ACATCGAAGGGTACAC"	"EC"
"ACATCGAGTACAGTAA"	"T-cell"
"ACATCGAGTTGGAGGT"	"Cyst.TAL_2"
"ACATGCAAGCCTCAAT"	"Cyst.PT_1"
"ACATGCACAGCTATTG"	"Cyst.PT_1"
"ACATGCAGTTGACTAC"	"Cyst.PT_1"
"ACATGCATCCTACCAC"	"Cyst.TAL_1"
"ACATTTCAGACATAAC"	"Cyst.PT_1"
"ACATTTCAGCACGGAT"	"Cyst.PT_2"
"ACATTTCAGCCAAGTG"	"Cyst.PC"
"ACATTTCAGGCTTTCA"	"T-cell"
"ACATTTCCACCATATG"	"vSMC"
"ACATTTCGTAATTGGA"	"Cyst.PT_1"
"ACATTTCGTCAAGCGA"	"Cyst.PC"
"ACATTTCGTTCATCTT"	"Cyst.PT_2"
"ACATTTCTCAAACTGC"	"Cyst.PT_1"
"ACATTTCTCGGTCTGG"	"Cyst.TAL_2"
"ACATTTCTCTTAGTTC"	"Cyst.PT_3"
"ACCAAACAGCACTAGG"	"Cyst.PT_1"
"ACCAAACAGTGTACCT"	"vSMC"
"ACCAAACCATGCAGCC"	"Cyst.PT_3"
"ACCAAACCATGGCACC"	"Cyst.PT_2"
"ACCAAACGTAGTTACC"	"Cyst.TAL_2"
"ACCAAACGTATCTCGA"	"Cyst.PT_3"
"ACCAAACGTTAAGACA"	"Cyst.PT_2"
"ACCAAACTCAAGGACG"	"Cyst.TAL_2"
"ACCAAACTCGGCCTTT"	"Cyst.PT_3"
"ACCAAACTCTCCTACG"	"Cyst.PT_2"
"ACCAAACTCTGTCGTC"	"Cyst.PT_2"
"ACCAACAAGATACCAA"	"Cyst.PT_2"
"ACCAACAGTCCAAAGG"	"Cyst.PT_3"
"ACCAACATCAAGCCCG"	"Cyst.PT_1"
"ACCACAAAGAGCATAT"	"Cyst.PT_2"
"ACCACAAAGCGGTATG"	"Cyst.TAL_1"
"ACCATTTAGCGCCGTT"	"Cyst.PT_1"
"ACCCAAAAGCACTCGC"	"Cyst.TAL_2"
"ACCCAAACAGACCCGT"	"Unk_2"
"ACCCAAACATATACCG"	"Cyst.PT_1"
"ACCCAAACATCGGAAG"	"Cyst.TAL_1"
"ACCCAAAGTGTTCCTC"	"Fibroblast"
"ACCCAAATCGACGCTG"	"Cyst.PT_1"
"ACCCAAATCTCGAGTA"	"Fibroblast"
"ACCCTCACAACTCGTA"	"Cyst.PT_2"
"ACCCTCACAGACACAG"	"Cyst.ATL"
"ACCCTCATCCACGGGT"	"Cyst.TAL_1"
"ACCCTCATCGCGTAGC"	"Cyst.PT_2"
"ACCCTCATCTATCGTT"	"Cyst.TAL_2"
"ACCCTTGAGCTCCACG"	"Cyst.PT_1"
"ACCCTTGCACTTCATT"	"Cyst.IC-A1"
"ACCCTTGCAGAAATCA"	"Cyst.TAL_1"
"ACCCTTGCAGGAATAT"	"Cyst.PC"
"ACCCTTGGTGGAAATT"	"Cyst.TAL_2"
"ACCCTTGGTTCTCGCT"	"Cyst.PT_3"
"ACCCTTGTCACCACAA"	"Cyst.TAL_2"
"ACCGTTCCAAGCGCTC"	"Cyst.PT_2"
"ACCGTTCCAATCGAAA"	"Cyst.PT_1"
"ACCGTTCCATCCGAAT"	"Cyst.PT_2"
"ACCGTTCCATGAGTAA"	"Cyst.PT_2"
"ACCGTTCGTATTTCTC"	"Cyst.PT_2"
"ACCGTTCGTGGAGGTT"	"T-cell"
"ACCGTTCTCCGTAATG"	"Cyst.PT_1"
"ACCTACCCAATCGCAT"	"Cyst.PT_3"
"ACCTACCCATCCTTGC"	"Cyst.TAL_2"
"ACCTACCGTATCAAGA"	"Cyst.TAL_1"
"ACCTACCGTGGATACG"	"Unk_2"
"ACCTACCTCCGTGCGA"	"Cyst.TAL_2"
"ACCTGAAAGAACCCGA"	"Cyst.TAL_1"
"ACCTGAACAACGGCTC"	"Cyst.PT_1"
"ACCTGAAGTAGTACGG"	"Fibroblast"
"ACCTGAAGTCGATGCC"	"Cyst.PT_2"
"ACCTGTCAGCCGGAAT"	"vSMC"
"ACCTGTCCAGGAAGTC"	"Cyst.PT_1"
"ACCTGTCGTTCTAACG"	"Cyst.PT_3"
"ACCTGTCGTTGCCATA"	"Cyst.PT_1"
"ACGATCAAGAGGTGCT"	"Cyst.TAL_1"
"ACGATCAAGATCACCT"	"Cyst.TAL_2"
"ACGATCAAGCACACCC"	"Cyst.TAL_2"
"ACGATCAAGCATCCTA"	"Unk_1"
"ACGATCAAGGTAATCA"	"Cyst.PT_1"
"ACGATCACAACTCGAT"	"Cyst.PT_1"
"ACGATCAGTGAACTAA"	"Cyst.PT_1"
"ACGATCATCATTCGTT"	"Cyst.TAL_2"
"ACGATCATCCCAAGCG"	"Cyst.IC-A1"
"ACGATCATCCTTGACC"	"Cyst.PC"
"ACGATGTAGTCTCCTC"	"Cyst.PC"
"ACGATGTCAAGAGTTA"	"Cyst.TAL_2"
"ACGATGTCAATTGAAG"	"Cyst.TAL_1"
"ACGATGTGTAGCTGTT"	"Fibroblast"
"ACGCACGCAACCTAAC"	"Cyst.TAL_1"
"ACGCACGCACCTGCTT"	"Cyst.TAL_2"
"ACGCACGCAGCTGAAG"	"Cyst.PT_2"
"ACGCACGCAGTATGAA"	"EC"
"ACGCACGCATATCTGG"	"Cyst.PT_3"
"ACGCACGGTAGGCTGA"	"EC"
"ACGCACGGTATACGGG"	"Cyst.PC"
"ACGCACGGTATTGGCT"	"Mac"
"ACGCACGGTTTCGCTC"	"Cyst.PT_1"
"ACGCACGGTTTCTATC"	"Cyst.PC"
"ACGCACGTCCGGCTTT"	"Cyst.PT_1"
"ACGCACGTCTTGTTAC"	"Cyst.PT_2"
"ACGGAAGCACAACCGC"	"Cyst.PT_1"
"ACGGAAGGTAAGTCAA"	"Cyst.PT_2"
"ACGGAAGGTGCGACAA"	"Cyst.PT_2"
"ACGGGTCAGCGCCTCA"	":LowQual"
"ACGGGTCCACGGCCAT"	"Cyst.PT_2"
"ACGGGTCGTCTTGAAC"	"vSMC"
"ACGGGTCGTTTCAGAC"	"Cyst.PT_1"
"ACGGGTCTCGCTATTT"	"Cyst.PC"
"ACGGTCGAGAAGAGCA"	"Cyst.PT_1"
"ACGGTCGCAACGAGGT"	"Cyst.PT_2"
"ACGGTCGCACTGCGTG"	"Cyst.PT_1"
"ACGGTCGGTGTTCGAT"	"Cyst.PT_2"
"ACGGTCGTCGGTGTAT"	"vSMC"
"ACGGTTAAGGCCTGCT"	"Cyst.PC"
"ACGGTTAAGGTGAGAA"	"Cyst.TAL_1"
"ACGGTTAAGTTCCTGA"	"Cyst.PT_1"
"ACGGTTACAGGTCAGA"	"Cyst.TAL_2"
"ACGGTTACATCCGTGG"	"Cyst.PT_3"
"ACGGTTAGTCCAGCGT"	"Cyst.TAL_2"
"ACGGTTAGTCCCTCAT"	"Cyst.TAL_1"
"ACGTAACAGCGACTTT"	"INT"
"ACGTAACAGGCTAACG"	"Cyst.PT_2"
"ACGTAACCAAATAAGC"	"vSMC"
"ACGTAACCATAGATCC"	"Cyst.TAL_1"
"ACGTAACGTACTCAAC"	"Fibroblast"
"ACGTAACGTCCCTGAG"	"Cyst.TAL_2"
"ACGTAACGTCCTGGTG"	"vSMC"
"ACGTACAAGACGACTG"	"Cyst.PT_2"
"ACGTACAAGCCTAACT"	"Cyst.PT_1"
"ACGTACACAAACCGGA"	"Cyst.TAL_2"
"ACGTACACAGAGAATT"	"Cyst.TAL_1"
"ACGTACACATGACACT"	"Cyst.TAL_2"
"ACGTACAGTGTACATC"	"Cyst.PT_3"
"ACGTACAGTGTCGATT"	"Cyst.TAL_2"
"ACGTACAGTTCCAAAC"	"Cyst.PT_3"
"ACGTAGTAGAGTTGCG"	"Cyst.TAL_2"
"ACGTAGTCACACTTAG"	"T-cell"
"ACGTAGTCACATTCTT"	"Cyst.TAL_1"
"ACGTAGTGTAGGCAGT"	"Cyst.TAL_2"
"ACGTAGTGTGTGATGG"	"Cyst.PT_1"
"ACGTAGTGTGTTCGTA"	"T-cell"
"ACGTAGTTCTAGTACG"	"Podocytes"
"ACGTAGTTCTCCCTAG"	"Cyst.PT_3"
"ACGTCCTAGTCCCGGT"	"vSMC"
"ACGTCCTCAGATCCTA"	"Cyst.IC-A1"
"ACGTCCTTCCAGCTCT"	"Cyst.TAL_1"
"ACGTTCCAGGCGAAGG"	"Cyst.PT_1"
"ACGTTCCCAGAGATGC"	"Cyst.TAL_2"
"ACGTTCCGTAGATCCT"	"Cyst.PT_2"
"ACGTTCCGTATGAGCG"	"Cyst.IC-A1"
"ACGTTCCGTTAGAAAC"	"Cyst.PT_2"
"ACGTTCCTCATGCGGC"	"Cyst.TAL_2"
"ACTACGAAGGACAGCT"	"Cyst.PT_1"
"ACTACGAAGGAGAGTA"	"Cyst.PT_3"
"ACTACGACACCGCTGA"	"Cyst.PT_2"
"ACTACGACACTTCAGA"	"Fibroblast"
"ACTACGATCAGTCAGT"	"Cyst.PT_1"
"ACTACGATCGCCAACG"	"Cyst.PT_3"
"ACTATCTAGTACTCGT"	"Cyst.TAL_1"
"ACTATCTCAAGGGCAT"	"EC"
"ACTATCTCACGGAAGT"	"Unk_1"
"ACTATCTGTTGCAACT"	"Cyst.PT_1"
"ACTATCTGTTTACCTT"	"Cyst.PT_2"
"ACTATCTTCCATCACC"	"Cyst.TAL_2"
"ACTATGGAGGATATAC"	"Cyst.PT_2"
"ACTATGGCAACTCATG"	"Cyst.PT_3"
"ACTATGGCACCAGCGT"	"Cyst.PC"
"ACTATGGCACTGAATC"	"Cyst.PT_1"
"ACTATGGCATCCGAAT"	"Cyst.TAL_2"
"ACTATGGCATCGATAC"	"EC"
"ACTATGGCATCGCTGG"	"Cyst.PT_1"
"ACTATGGGTGTGCCTG"	"EC"
"ACTATGGGTGTGTGGA"	"Cyst.TAL_2"
"ACTATGGTCCATCACC"	"Cyst.IC-A1"
"ACTATTCAGTCCGTCG"	"Cyst.PT_1"
"ACTATTCCAGGCCCTA"	"Cyst.TAL_2"
"ACTATTCCAGGGCTTC"	"Cyst.PT_1"
"ACTATTCCATCCGAAT"	"Cyst.TAL_1"
"ACTATTCGTAGTCGGA"	"Cyst.TAL_1"
"ACTATTCGTCCTACGG"	"Cyst.PT_1"
"ACTATTCGTGTCCATA"	"Cyst.PT_1"
"ACTATTCGTGTTCGTA"	"Cyst.PT_1"
"ACTATTCTCGACCTAA"	"Cyst.PT_1"
"ACTATTCTCGATGCAT"	"Cyst.PT_2"
"ACTATTCTCTTCTTCC"	"Cyst.PT_1"
"ACTCCCAAGAGTTGCG"	"Cyst.TAL_1"
"ACTCCCAAGCAGTACG"	"Fibroblast"
"ACTCCCACAAAGGGCT"	"Cyst.PT_2"
"ACTCCCAGTCCCTCAT"	"Cyst.TAL_2"
"ACTCCCAGTTGCATCA"	"Cyst.TAL_2"
"ACTCCCAGTTTAGAGA"	"Cyst.PT_2"
"ACTCCCATCAATCTCT"	"Cyst.TAL_1"
"ACTCCCATCCTTATAC"	"Cyst.PT_1"
"ACTCTCGAGTAATACG"	"Unk_2"
"ACTCTCGCAATCTGCA"	"Cyst.PT_3"
"ACTCTCGGTTAATGAG"	"Cyst.PT_1"
"ACTCTCGTCGGTCGAC"	"vSMC"
"ACTGATGAGAATTCAG"	"Cyst.PT_2"
"ACTGATGCAAATTGCC"	"Cyst.PT_1"
"ACTGATGGTGTCATGT"	"Cyst.PT_1"
"ACTGATGTCAAACCTG"	"Fibroblast"
"ACTGATGTCAAGCCAT"	"Mac"
"ACTGATGTCATTTCGT"	"Cyst.PC"
"ACTGATGTCGATCCAA"	"Cyst.TAL_1"
"ACTGCAAAGCCGATTT"	"Cyst.PT_2"
"ACTGCAAAGCCTGTGC"	"Cyst.PT_1"
"ACTGCAAAGCGGACAT"	"Cyst.TAL_2"
"ACTGCAAAGTCGAATA"	"Cyst.PT_3"
"ACTGCAACAACTGCTA"	"Cyst.TAL_2"
"ACTGCAAGTACATACC"	"Cyst.TAL_2"
"ACTGCAAGTGTACGCC"	"Cyst.PT_1"
"ACTGCAATCAACACGT"	"Cyst.TAL_1"
"ACTGCAATCCACACAA"	"Podocytes"
"ACTGCAATCCTCGATC"	"Cyst.PT_1"
"ACTGCAATCGCCTCTA"	"Cyst.PT_1"
"ACTGCAATCGGACTGC"	"Cyst.PT_1"
"ACTGCAATCGTAGGAG"	"Cyst.PT_1"
"ACTGTCCAGACAGTCG"	"Cyst.PT_3"
"ACTGTCCAGCAGTACG"	"Cyst.PT_2"
"ACTGTCCAGCGCACAA"	"Cyst.TAL_1"
"ACTGTCCAGTTTCGAC"	"Cyst.TAL_1"
"ACTGTCCCAATTGTGC"	"EC"
"ACTGTCCGTACCGCGT"	"Cyst.TAL_2"
"ACTGTCCTCCCTCTCC"	"Fibroblast"
"ACTGTCCTCGGTATGT"	"Cyst.TAL_1"
"ACTGTGAAGCGATGAC"	"Cyst.IC-A1"
"ACTGTGAGTGGGACAT"	"Cyst.PT_1"
"ACTGTGAGTTAGTCGT"	"Cyst.PT_1"
"ACTTAGGAGTCCCAAT"	"Cyst.TAL_2"
"ACTTAGGCAACTGATC"	"Cyst.PT_2"
"ACTTAGGCAAGCCCAC"	"Cyst.TAL_2"
"ACTTAGGCACTCACTC"	"Cyst.PT_3"
"ACTTAGGGTAATTAGG"	"Cyst.PT_1"
"ACTTAGGGTATGATCC"	"Cyst.PT_1"
"ACTTAGGGTATGTGTC"	"Unk_1"
"ACTTAGGGTGTTGACT"	"Cyst.PT_1"
"ACTTAGGGTTTCGATG"	"Cyst.PT_2"
"ACTTAGGTCGACCATA"	"Cyst.TAL_2"
"ACTTATCAGAAGCGCT"	"Podocytes"
"ACTTATCGTTCTCCTG"	"Cyst.TAL_1"
"ACTTATCTCAAGTGTC"	"Cyst.PT_1"
"ACTTCCGAGATTAGCA"	"Cyst.PT_1"
"ACTTCCGTCATCGTAG"	"Mac"
"ACTTCGCAGCCGATCC"	"Cyst.TAL_1"
"ACTTCGCGTTTCGATG"	"Cyst.PT_1"
"ACTTTCACACCCTGTT"	"Cyst.PT_1"
"ACTTTCACATGACTAC"	"Cyst.PT_1"
"ACTTTCACATGACTCA"	"Cyst.TAL_1"
"ACTTTCAGTAGAGACC"	"Cyst.PT_3"
"ACTTTCAGTTAATCGC"	"Cyst.PT_2"
"ACTTTCATCAAGCCCG"	"Cyst.PC"
"ACTTTCATCGAACCTA"	"Cyst.TAL_1"
"ACTTTCATCTTCCTAA"	"Cyst.PT_1"
"ACTTTGTCAGAGGCAT"	"EC"
"ACTTTGTTCCGCGAGT"	"Mac"
"AGAAATGCAACTCCAA"	"Cyst.PT_1"
"AGAAATGCAGAACCGA"	"Cyst.PT_1"
"AGAAATGGTAGATTAG"	"Cyst.PT_2"
"AGAAATGGTAGGACCA"	"Fibroblast"
"AGAAATGGTGAGTAGC"	"Cyst.TAL_1"
"AGAAATGGTTACACAC"	"Cyst.PC"
"AGAAATGGTTGGACTT"	"Cyst.PT_2"
"AGAAATGTCAGACCTA"	"Cyst.PT_1"
"AGAAATGTCATCGCAA"	"Cyst.PT_2"
"AGAACAAAGCCTCGTG"	"vSMC"
"AGAACAAAGTAAGGGA"	"Cyst.PT_1"
"AGAACAACAATTCGTG"	"Cyst.PC"
"AGAACAACAGGAGACT"	"Cyst.TAL_1"
"AGAACAAGTCGAACAG"	"Cyst.PT_3"
"AGAACAATCGGAAACG"	"Cyst.PT_2"
"AGAACCTAGCCTCGTG"	"Cyst.PT_2"
"AGAACCTCACTATCCC"	"Cyst.PT_1"
"AGAACCTCATAACTCG"	"Cyst.PT_2"
"AGAAGCGAGCATTTGC"	"Cyst.PC"
"AGAAGCGTCTTGGGCG"	"Cyst.PT_2"
"AGAAGTAAGCACACCC"	"EC"
"AGAAGTACAAGAGCTG"	"Unk_1"
"AGAAGTAGTATGCGGA"	"Cyst.PT_2"
"AGAAGTATCGGTGTTA"	"Cyst.PT_3"
"AGAAGTATCGTCCATC"	"vSMC"
"AGACAAAAGACGTCCC"	"Cyst.PT_1"
"AGACAAAAGTAACGAT"	"Cyst.PT_1"
"AGACAAACAACTTCTT"	"Cyst.PT_3"
"AGACAAAGTGGTAATA"	"Cyst.PT_1"
"AGACAAATCCTACGAA"	"Cyst.TAL_1"
"AGACAAATCGTTATCT"	"Fibroblast"
"AGACACTCACGTTGGC"	"Cyst.PT_3"
"AGACACTGTAGCTCGC"	"Cyst.PC"
"AGACACTGTCTCGCGA"	"vSMC"
"AGACACTTCACACCGG"	"Cyst.TAL_1"
"AGACACTTCATGGATC"	"Cyst.PT_1"
"AGACACTTCCGACAGC"	"Cyst.PC"
"AGACAGGAGATGAAGG"	"Cyst.TAL_1"
"AGACAGGAGCAGAAAG"	"Cyst.TAL_1"
"AGACAGGCAGGCCTGT"	"Cyst.PT_1"
"AGACAGGGTACGACAG"	"Cyst.PT_3"
"AGACAGGGTCAGCTTA"	"EC"
"AGACAGGTCTTCGACC"	"Fibroblast"
"AGACCATAGAGAGCAA"	"Cyst.PT_1"
"AGACCATAGTTAACAG"	"Cyst.PC"
"AGACCATCACATACTG"	"EC"
"AGACCATGTCATTCCC"	"Cyst.PT_2"
"AGACCCGAGCTGCCTG"	"Cyst.PT_2"
"AGACCCGGTAGTTACC"	"Cyst.PT_2"
"AGACCCGTCAAGGACG"	"Cyst.TAL_1"
"AGACTCAAGCGGTATG"	"Cyst.TAL_1"
"AGACTCACACGTCATA"	"Fibroblast"
"AGACTCACACGTCGGT"	"Cyst.PT_2"
"AGACTCACAGTAGGAC"	"T-cell"
"AGACTCATCGGTCTGG"	"Fibroblast"
"AGAGAATAGAGCAGCT"	"Cyst.PT_1"
"AGAGAATAGATACATG"	"Fibroblast"
"AGAGAATAGCTGAAAT"	"Cyst.ATL"
"AGAGAATAGGGAGGCA"	"Cyst.PC"
"AGAGAATAGGTAATCA"	"Cyst.PT_3"
"AGAGAATCAAATGCGG"	"Podocytes"
"AGAGAATCACAAGCTT"	"Cyst.PT_1"
"AGAGAATCACTGTGAT"	"Fibroblast"
"AGAGAATGTCCGTACG"	"vSMC"
"AGAGAGCAGGTTATAG"	"Cyst.TAL_1"
"AGAGAGCGTAGCTGAG"	"Cyst.TAL_1"
"AGAGAGCTCCTTCTGG"	"Cyst.PT_1"
"AGAGAGCTCGGCTTGG"	"Cyst.TAL_2"
"AGAGAGCTCGTTCTCG"	"Cyst.PC"
"AGAGCAGAGAGTCGAC"	"Podocytes"
"AGAGCAGCACCTATCC"	"EC"
"AGAGCAGCAGCTCGGT"	"Cyst.PT_2"
"AGAGCAGGTCAATGGG"	"Unk_2"
"AGAGCAGTCGCATAGT"	"Cyst.PT_1"
"AGAGCAGTCTACCCAC"	"Cyst.TAL_1"
"AGAGCCCAGGTAATCA"	"Cyst.PT_3"
"AGAGCCCCAACACACT"	"Cyst.PT_2"
"AGAGCCCCAGCCTACG"	"Fibroblast"
"AGAGCCCGTGTGGACA"	"Cyst.PT_1"
"AGATAGACACGTACAT"	"Cyst.PT_1"
"AGATAGACAGCGAGTA"	"Cyst.TAL_1"
"AGATAGAGTCGATTCA"	"Cyst.PT_2"
"AGATAGATCCAACTGA"	"Cyst.PT_3"
"AGATAGATCCATCTAT"	"Cyst.PT_1"
"AGATCCAAGGAAACGA"	"Cyst.PT_1"
"AGATCCAGTCCTGTTC"	"Cyst.PT_1"
"AGATCCAGTTCCGTTC"	"Mac"
"AGATCCATCAATCGGT"	"Cyst.PT_3"
"AGATCCATCCTTATAC"	"Cyst.TAL_1"
"AGATCGTAGACCGCCT"	"Cyst.PT_1"
"AGATCGTAGGGCAGAG"	"Unk_1"
"AGATCGTCATGACACT"	"Cyst.PT_3"
"AGATCGTGTGATGAAT"	"Cyst.PT_3"
"AGATCGTTCGTTTACT"	"Cyst.PT_1"
"AGATGAACACTCCGGA"	"Cyst.PT_2"
"AGATGAAGTGGCCCAT"	"Cyst.PT_2"
"AGATGCTCATAGAGGC"	"Cyst.IC-A1"
"AGATGCTGTCATACCA"	"Cyst.PT_1"
"AGATGCTGTCCGAAAG"	"Cyst.PC"
"AGATGCTGTCCGCAGT"	"Cyst.TAL_1"
"AGATGCTGTTGGAGGT"	"Cyst.PT_2"
"AGATGCTTCGAGAGCA"	"T-cell"
"AGATGCTTCTAGAGCT"	"Cyst.PT_1"
"AGATGCTTCTCTCCGA"	"Cyst.TAL_1"
"AGATGCTTCTCTGGTC"	"Cyst.TAL_2"
"AGATGCTTCTTCCCAG"	"Cyst.PT_3"
"AGCATCAAGGACCCAA"	"Cyst.PT_1"
"AGCATCAAGGCGAACT"	"Cyst.TAL_2"
"AGCATCAAGGTGGCTA"	"Cyst.PT_3"
"AGCATCACAGTACTAC"	"Cyst.TAL_2"
"AGCATCACATGTTCAG"	"Cyst.PT_1"
"AGCATCACATTGCAAC"	"Cyst.PC"
"AGCATCAGTCAAAGTA"	"Cyst.PT_3"
"AGCCAATAGACCAGAC"	"Cyst.TAL_1"
"AGCCAATCACTCCCTA"	"Cyst.PC"
"AGCCAATTCACCTACC"	"EC"
"AGCCAATTCAGGACAG"	"Fibroblast"
"AGCCAATTCCAGCTCT"	"Cyst.TAL_1"
"AGCCAATTCCTACGAA"	"Unk_1"
"AGCCAATTCTCTCAAT"	"Podocytes"
"AGCCACGAGATGCCGA"	"Cyst.PT_1"
"AGCCACGAGCCTCTTC"	"vSMC"
"AGCCACGCAGTTGTTG"	"Cyst.TAL_1"
"AGCCACGCATAGGAGC"	"Cyst.PT_3"
"AGCCAGCAGGACGCTA"	"Cyst.TAL_2"
"AGCCAGCAGGCTAACG"	"Cyst.PT_1"
"AGCCAGCAGTGGTGAC"	"EC"
"AGCCAGCAGTTGGAAT"	"Cyst.PT_1"
"AGCCAGCCAAGACCGA"	"Cyst.TAL_1"
"AGCCAGCCAGAGTTGG"	"Cyst.PT_1"
"AGCCAGCCAGTCAGCC"	"Cyst.PT_3"
"AGCCAGCGTCAAGCCC"	":LowQual"
"AGCCAGCGTGGAACAC"	"Mac"
"AGCCAGCGTGTCCAAT"	"Cyst.PT_3"
"AGCCAGCTCACTAGCA"	":LowQual"
"AGCGATTCACTGGATT"	"Cyst.PT_2"
"AGCGATTGTGTGTCCG"	"Cyst.PT_2"
"AGCGATTTCATACAGC"	"Cyst.PT_1"
"AGCGCCACACCGTCTT"	"Cyst.PT_2"
"AGCGCCACATGCAGCC"	"Cyst.TAL_2"
"AGCGCCAGTCCAAATC"	"Cyst.PT_3"
"AGCGCCAGTGAATTGA"	"Fibroblast"
"AGCGCCATCTCGCCTA"	"Fibroblast"
"AGCGCTGAGCCTCTGG"	"Fibroblast"
"AGCGCTGCACACACGC"	"Cyst.PT_1"
"AGCGTATAGAGTCAGC"	"Cyst.PT_2"
"AGCGTATAGATACAGT"	"Cyst.TAL_1"
"AGCGTATAGATGCTAA"	"Cyst.TAL_1"
"AGCGTATAGGTTCACT"	"Cyst.PT_1"
"AGCGTATAGTGAACAT"	"Cyst.PT_2"
"AGCGTATCAATCTCGA"	"Cyst.PT_2"
"AGCGTATGTAGTAAGT"	"Cyst.PT_1"
"AGCGTATGTTACAGCT"	"Podocytes"
"AGCGTATTCGAGTGAG"	"T-cell"
"AGCGTATTCGGTAAGG"	"Cyst.PT_1"
"AGCTACAAGAGTGGCT"	"Cyst.TAL_2"
"AGCTACAAGGCCTAAG"	"Cyst.PT_3"
"AGCTACACACGCGTGT"	"EC"
"AGCTACACATAGCTGT"	"Cyst.PT_1"
"AGCTACACATGGCTGC"	"Cyst.PT_3"
"AGCTACATCGGTTAGT"	":LowQual"
"AGCTCAAGTCTACATG"	"Cyst.PT_1"
"AGCTTCCAGTCTCTGA"	"Cyst.PT_1"
"AGCTTCCCACACACTA"	"Cyst.PT_2"
"AGCTTCCCAGAGGGTT"	"Cyst.PT_1"
"AGCTTCCGTAAGACCG"	"Cyst.PT_2"
"AGCTTCCGTCCTCATC"	"Cyst.TAL_2"
"AGCTTCCTCATTGTTC"	"Cyst.TAL_2"
"AGGAAATAGCGTTGTT"	"Cyst.PT_3"
"AGGAAATCACCAACAT"	"Cyst.PT_2"
"AGGAAATTCAAGTGGG"	"Cyst.PC"
"AGGAATAAGGTGGCTA"	"Cyst.TAL_1"
"AGGAATACACCATTCC"	"EC"
"AGGAATAGTCCTGGGT"	"Cyst.PC"
"AGGAATATCCCGAACG"	"Podocytes"
"AGGAATATCTGAGCAT"	"Cyst.PT_3"
"AGGACGAAGGCATCGA"	"Cyst.TAL_2"
"AGGACGAAGGCCTAAG"	"Cyst.PT_3"
"AGGACGAGTAACAGTA"	"Cyst.PT_3"
"AGGACGAGTATCGATC"	"Cyst.PC"
"AGGACGAGTCGCATCG"	"Cyst.PT_2"
"AGGACGATCACTCTTA"	"Cyst.TAL_1"
"AGGACTTAGTGAACAT"	"Cyst.PT_2"
"AGGACTTAGTGATAAC"	"Cyst.TAL_2"
"AGGACTTGTTCAAGGG"	"Cyst.ATL"
"AGGACTTGTTCTAACG"	"Cyst.PT_3"
"AGGACTTTCCTTTAGT"	"EC"
"AGGACTTTCGCATTGA"	"EC"
"AGGACTTTCTACACTT"	"Cyst.TAL_1"
"AGGACTTTCTCGAACA"	"Cyst.PT_1"
"AGGAGGTAGCTCTTCC"	"Cyst.PT_1"
"AGGAGGTAGTCATTGC"	"Cyst.PT_2"
"AGGAGGTCATGAAGCG"	"Mac"
"AGGAGGTGTCCTCATC"	"Cyst.PT_1"
"AGGATAAGTATCGTGT"	"Cyst.TAL_1"
"AGGATAATCTACCCAC"	"Cyst.PT_1"
"AGGATCTAGATACAGT"	"Cyst.PT_1"
"AGGATCTAGATTGAGT"	"Cyst.PC"
"AGGATCTCAAACTCGT"	"Cyst.PT_2"
"AGGATCTCAGCATGCC"	"EC"
"AGGATCTCAGCTCCTT"	"Cyst.TAL_2"
"AGGATCTCAGTTAAAG"	"Cyst.PT_2"
"AGGATCTCATCGGAAG"	"Cyst.PT_2"
"AGGATCTGTGCCTACG"	"Cyst.PC"
"AGGATCTGTGGTCTAT"	"Cyst.PT_3"
"AGGATCTTCCGTTTCG"	"Cyst.TAL_2"
"AGGATCTTCTTACTGT"	"Cyst.TAL_2"
"AGGCATTCAACTCGAT"	"Cyst.PT_1"
"AGGCATTTCAAGGACG"	"Cyst.PT_2"
"AGGCCACAGGTGGGTT"	"vSMC"
"AGGCCACTCGACCAAT"	"Cyst.TAL_2"
"AGGCTGCAGCACCCAC"	"Cyst.PC"
"AGGCTGCAGGTCTTTG"	"Cyst.TAL_2"
"AGGCTGCAGTAACCTC"	"Cyst.TAL_1"
"AGGCTGCAGTAGGGTC"	"Cyst.TAL_1"
"AGGCTGCGTCGGTAAG"	"Cyst.TAL_1"
"AGGCTGCGTCTCGGAC"	"Cyst.TAL_2"
"AGGCTGCGTGTAGTGG"	"Cyst.PT_2"
"AGGCTGCGTGTTAACC"	"T-cell"
"AGGCTGCTCGCCTTTG"	"Fibroblast"
"AGGGAGTCATCCTAAG"	"Podocytes"
"AGGGAGTCATCGATAC"	"Cyst.TAL_1"
"AGGGAGTTCATGAGGG"	"Cyst.PT_1"
"AGGGAGTTCCTTTGAT"	"T-cell"
"AGGGCCTGTGACTGAG"	"Cyst.PT_1"
"AGGGCTCAGAAACTGT"	"Cyst.PT_2"
"AGGGCTCAGGTGCGAT"	"Cyst.PT_3"
"AGGGCTCCACCTAAAC"	"Cyst.PT_3"
"AGGGCTCTCGGCTGAC"	"Cyst.TAL_2"
"AGGGCTCTCGTGGAAG"	"Cyst.TAL_2"
"AGGGTCCAGGCATCAG"	"Cyst.PT_1"
"AGGGTCCCAACCGATT"	"Cyst.PT_2"
"AGGGTCCCAAGTGCTT"	"Unk_2"
"AGGGTCCCATATTCGG"	"Cyst.PT_1"
"AGGGTCCCATCTGTTT"	"Cyst.TAL_2"
"AGGGTCCGTCGGTAAG"	"Cyst.PT_1"
"AGGGTCCTCAGCTTCC"	"Cyst.PC"
"AGGGTGACAAGTCGTT"	":LowQual"
"AGGGTGACAGCACAGA"	"Cyst.PT_3"
"AGGGTTTAGTCGAAGC"	"Cyst.TAL_1"
"AGGGTTTCAAAGGGCT"	"T-cell"
"AGGGTTTCATGGATCT"	"Cyst.ATL"
"AGGGTTTGTACGACTT"	"Cyst.TAL_2"
"AGGGTTTGTAGCCAGA"	"Cyst.PT_2"
"AGGGTTTGTCACGTGC"	"Cyst.PT_1"
"AGGGTTTGTGTCGATT"	"Cyst.PT_1"
"AGGGTTTTCTAGTCAG"	"Cyst.PT_2"
"AGGTAGGAGGGCAGTT"	"Cyst.PT_2"
"AGGTAGGCAACTTCTT"	"vSMC"
"AGGTAGGCATGTCGTA"	"Cyst.TAL_1"
"AGGTAGGGTATGGTTC"	"Cyst.TAL_1"
"AGGTAGGTCCGGCTTT"	"Cyst.TAL_2"
"AGGTCATAGACCAACG"	"Cyst.PT_2"
"AGGTCATAGCTCATAC"	"Cyst.TAL_1"
"AGGTCATCACAGAAGC"	"Cyst.PT_1"
"AGGTCATGTCGGATTT"	"Cyst.TAL_1"
"AGGTCATGTTGGCCGT"	"Cyst.TAL_2"
"AGGTCATTCACTGAAC"	"Cyst.PT_2"
"AGGTCATTCAGTCCGG"	"Cyst.PT_3"
"AGGTCTAAGAAATTCG"	"Podocytes"
"AGGTCTAAGACTGTTC"	"Mac"
"AGGTCTAAGCAATAAC"	"Cyst.IC-A1"
"AGGTCTACAACGAGGT"	":LowQual"
"AGGTCTACATAGAATG"	"Cyst.TAL_1"
"AGGTCTACATAGGCGA"	"Unk_2"
"AGGTCTAGTGCATTAC"	"Cyst.PT_1"
"AGGTCTATCAACCCGG"	"Cyst.TAL_1"
"AGGTCTATCGACGCTG"	"Cyst.PT_3"
"AGGTCTATCGTCCTTG"	"Cyst.PC"
"AGGTGTTAGCATCCTA"	"Cyst.TAL_1"
"AGGTGTTAGGAAAGAC"	"Cyst.PT_3"
"AGGTGTTGTGAACTAA"	"Cyst.PT_1"
"AGGTGTTGTGTCCGTG"	"Cyst.TAL_1"
"AGGTGTTTCTAGAACC"	"Cyst.TAL_2"
"AGGTGTTTCTCGTCAC"	"Cyst.PT_2"
"AGGTTACAGAGGATGA"	"Cyst.TAL_1"
"AGGTTACAGCGTTACT"	"Unk_1"
"AGGTTACAGTAACCTC"	"Cyst.TAL_2"
"AGGTTACCACTTCAGA"	":LowQual"
"AGGTTACGTCATAAAG"	"Cyst.PC"
"AGGTTACTCTAGGAAA"	"Cyst.PT_3"
"AGGTTACTCTTTCGAT"	"Cyst.TAL_2"
"AGGTTGTAGGCGAACT"	"Cyst.TAL_2"
"AGGTTGTCATTGACAC"	"Cyst.TAL_2"
"AGGTTGTTCTATCGTT"	"Cyst.PT_1"
"AGTAACCGTAGACGGT"	"Podocytes"
"AGTAACCGTATACCTG"	"Cyst.TAL_1"
"AGTAACCGTCCCTAAA"	"Podocytes"
"AGTAACCGTGACCGAA"	"Podocytes"
"AGTAACCGTTTGAAAG"	"Cyst.PT_3"
"AGTAACCTCGGAGCAA"	"Fibroblast"
"AGTAACCTCTTCCTAA"	"Cyst.TAL_2"
"AGTACCAAGGTCATAA"	"EC"
"AGTACCAAGTCTCCTC"	"Cyst.TAL_2"
"AGTACCACATACCATG"	"Cyst.PT_1"
"AGTACCACATCCGCGA"	"Cyst.PT_1"
"AGTACCAGTTCAAACC"	"Cyst.PT_1"
"AGTACCATCATTCGTT"	"Cyst.TAL_1"
"AGTACTGAGTAGACCG"	"Unk_1"
"AGTACTGCAGATACTC"	"Cyst.PT_1"
"AGTACTGGTCGTGGAA"	"vSMC"
"AGTACTGTCCATCCGT"	"Cyst.PT_1"
"AGTACTGTCGTTGTAG"	"Cyst.PT_1"
"AGTAGCTCAAAGTATG"	"Cyst.PT_2"
"AGTAGTCAGATTAGTG"	"Cyst.PT_1"
"AGTAGTCAGCTTTCCC"	"Cyst.PT_2"
"AGTAGTCCAAATGGCG"	"Cyst.TAL_1"
"AGTAGTCCACGATAGG"	"Cyst.PT_1"
"AGTAGTCGTCATGACT"	"Cyst.PT_1"
"AGTAGTCGTCTAACGT"	"EC"
"AGTAGTCGTGGCTACC"	"Cyst.TAL_2"
"AGTAGTCTCGAAGCAG"	"Cyst.PT_1"
"AGTCAACCAAGGACAC"	"Cyst.PT_1"
"AGTCAACCACCTGTCT"	"Cyst.TAL_1"
"AGTCAACTCACCTTAT"	"Cyst.PT_1"
"AGTCACAAGCGTGTTT"	"Cyst.PT_2"
"AGTCACAAGTGCGACA"	"Cyst.TAL_1"
"AGTCACACAAATTGCC"	"Cyst.TAL_2"
"AGTCACACAAGTGACG"	"Cyst.PT_2"
"AGTCACACAATCGCGC"	"Cyst.TAL_2"
"AGTCACACACCCTTGT"	"Cyst.PT_2"
"AGTCACACAGTCGTTA"	"Cyst.TAL_2"
"AGTCACAGTAGCTGCC"	"Cyst.TAL_1"
"AGTCACAGTTTGGCTA"	"Cyst.PC"
"AGTCATGAGGCGCTCT"	"Cyst.PT_1"
"AGTCATGAGTCGCGAA"	"Cyst.PT_3"
"AGTCATGAGTTCCATG"	"Cyst.PT_2"
"AGTCATGCAGCCCACA"	"Cyst.PT_1"
"AGTCATGCATCATTTC"	"Cyst.PT_1"
"AGTCTCCAGCCGTCGT"	"Unk_1"
"AGTCTCCAGGTGCTTT"	"Cyst.PT_2"
"AGTCTCCGTAGCTGCC"	"Cyst.PT_3"
"AGTCTCCGTCTACATG"	"Cyst.PT_2"
"AGTCTCCGTTTACCAG"	"Cyst.TAL_2"
"AGTCTCCGTTTCGTAG"	"Cyst.PT_1"
"AGTCTCCTCATCCTGC"	"Cyst.PT_1"
"AGTCTCCTCCATGCAA"	"Cyst.TAL_2"
"AGTGACTCAGAGACTG"	"Cyst.PT_1"
"AGTGACTCAGGACAGT"	"Cyst.PT_3"
"AGTGACTGTCGCATGC"	"Cyst.PT_2"
"AGTGACTGTTCTAACG"	"Cyst.PT_1"
"AGTGACTTCATTCTTG"	"Unk_1"
"AGTGACTTCGCCCAGA"	"Cyst.IC-A1"
"AGTGACTTCGTCCTCA"	"Cyst.PT_1"
"AGTGACTTCTGGGCGT"	"Cyst.PT_2"
"AGTGATCAGGTTTACC"	"Cyst.PT_1"
"AGTGATCCAAGAATAC"	"Cyst.PT_1"
"AGTGATCCATTCTTCA"	"Fibroblast"
"AGTGATCGTGAACCGA"	"Cyst.TAL_2"
"AGTGATCGTGACAACG"	"Cyst.PC"
"AGTGATCTCTAATTCC"	"Cyst.IC-A1"
"AGTGCCGAGATACGAT"	"Cyst.PT_2"
"AGTGCCGAGATTAGAC"	"Cyst.PT_2"
"AGTGCCGAGGACTAAT"	"Cyst.PT_1"
"AGTGCCGAGGGCATGT"	"Cyst.PT_1"
"AGTGCCGCAGGCCCTA"	"Cyst.PT_1"
"AGTGCCGGTGGTTTAC"	"Cyst.PC"
"AGTGCCGGTGTCGCTG"	"vSMC"
"AGTGCCGTCCGAGCTG"	"Cyst.TAL_2"
"AGTGTTGAGACGAAGA"	"Cyst.PT_1"
"AGTGTTGAGTTGAATG"	"Cyst.TAL_2"
"AGTGTTGCAACTTCTT"	"Cyst.TAL_1"
"AGTGTTGCACAACCGC"	"Cyst.TAL_2"
"AGTGTTGGTACGGCAA"	"Cyst.TAL_2"
"AGTGTTGGTCACTTAG"	"Unk_1"
"AGTGTTGGTCGAAACG"	"Cyst.TAL_2"
"AGTGTTGTCATAGCAC"	":LowQual"
"AGTTAGCAGGCATTTC"	"Cyst.PT_2"
"AGTTAGCAGTTCCATG"	"Cyst.PT_2"
"AGTTAGCCAGACCCGT"	"Cyst.PT_1"
"AGTTAGCGTCAAAGCG"	"Cyst.PC"
"AGTTAGCGTGGCTAGA"	"vSMC"
"AGTTAGCGTGTGCCTG"	"Cyst.TAL_2"
"AGTTAGCTCCATAGGT"	"Cyst.PT_2"
"AGTTCCCCAATCTCTT"	"Cyst.PT_1"
"AGTTCCCGTCGAACAG"	"Fibroblast"
"AGTTCCCGTGCATTTG"	"Cyst.PT_3"
"AGTTCCCTCAGCTGTA"	"Fibroblast"
"AGTTCGAAGACATAAC"	"Cyst.PT_1"
"AGTTCGAAGCTGTTCA"	"Cyst.TAL_1"
"AGTTCGAAGGATGGCT"	"Cyst.PT_2"
"AGTTCGACAACTGGTT"	"Cyst.PT_2"
"AGTTCGACATGGAGAC"	"Cyst.PT_2"
"AGTTCGAGTTCCATTT"	"Cyst.TAL_1"
"AGTTCGAGTTCGGACC"	"Cyst.PC"
"AGTTCGATCAAAGGAT"	"Cyst.PT_2"
"ATACCGAAGTGACACG"	"Cyst.PT_2"
"ATACCGACACTCTGCT"	"Cyst.TAL_1"
"ATACCGACAGCGAGTA"	"Cyst.PT_1"
"ATACCGACAGTCTGGC"	"Fibroblast"
"ATACCGAGTGCCTTTC"	"vSMC"
"ATACCGATCCCAGGAC"	"Cyst.PT_2"
"ATACCGATCTATCCAT"	"Cyst.PT_1"
"ATACCTTTCATTTGCT"	"Cyst.PT_1"
"ATACTTCAGATGTAGT"	"Cyst.PT_1"
"ATACTTCAGCGTCAGA"	"Cyst.PT_1"
"ATACTTCAGGGATCTG"	"Cyst.PT_1"
"ATACTTCGTGACTGTT"	"T-cell"
"ATACTTCTCACGTCCT"	"Cyst.PT_1"
"ATACTTCTCAGCCCAG"	"Cyst.PT_1"
"ATACTTCTCATTACGG"	"Cyst.TAL_1"
"ATACTTCTCCATGAGT"	"Cyst.TAL_2"
"ATACTTCTCGAACCAT"	"Cyst.PT_3"
"ATACTTCTCGCCCAGA"	"T-cell"
"ATAGACCAGCATCCCG"	"Cyst.PT_1"
"ATAGACCCAGGTTCAT"	"Cyst.PT_1"
"ATAGACCGTCCGGCAT"	"Cyst.TAL_2"
"ATAGACCGTCTTCCGT"	"Cyst.PT_2"
"ATAGACCTCGGCCTTT"	"Cyst.PT_3"
"ATAGACCTCTCTATAC"	"Cyst.TAL_1"
"ATAGAGACAAGTTCGT"	"Cyst.TAL_1"
"ATAGAGACACTGGATT"	"Cyst.PT_1"
"ATAGAGACAGTTCCAA"	"T-cell"
"ATAGAGACATCCGCGA"	"Cyst.TAL_1"
"ATAGAGAGTGCTTATG"	"INT"
"ATAGAGAGTTTGAAAG"	"Cyst.PT_3"
"ATAGAGATCAGCGTCG"	"Unk_2"
"ATAGAGATCGACGCGT"	"Cyst.PT_3"
"ATAGAGATCTGTAACG"	"Cyst.PC"
"ATAGGCTAGACCATAA"	"Cyst.PT_1"
"ATAGGCTAGTCCGTCG"	"Cyst.PT_1"
"ATAGGCTAGTTGGCGA"	"EC"
"ATAGGCTCAAATGAAC"	"Cyst.PT_1"
"ATAGGCTGTAGTTACC"	"Cyst.PT_1"
"ATAGGCTGTGACAGCA"	"Cyst.PT_2"
"ATAGGCTTCGCATTAG"	"Fibroblast"
"ATAGGCTTCTGTGCTC"	"Cyst.PT_3"
"ATATCCTAGCCGTAAG"	"Cyst.TAL_1"
"ATATCCTCACAGAGAC"	"Cyst.PT_3"
"ATATCCTGTACGAAAT"	"Cyst.PT_2"
"ATATCCTGTTCGAACT"	"Cyst.PT_2"
"ATCACAGAGACTCAAA"	"T-cell"
"ATCACAGAGCATAGGC"	"Cyst.PT_1"
"ATCACAGAGCGTTCCG"	"INT"
"ATCACAGAGGGATCTG"	"Cyst.PT_2"
"ATCACAGGTACGGGAT"	"Cyst.PC"
"ATCACAGGTCTTGAAC"	"Cyst.PT_3"
"ATCACAGGTTGGAGGT"	":LowQual"
"ATCACAGTCCGTGTAA"	"Cyst.TAL_1"
"ATCACGACAGATTAAG"	"Cyst.PT_2"
"ATCACGAGTGCTCCGA"	"Cyst.PT_1"
"ATCACGATCAAACGTC"	"Fibroblast"
"ATCACTTAGCGTGTCC"	"Cyst.TAL_1"
"ATCACTTAGTCACTGT"	"Cyst.PC"
"ATCACTTCACAAATAG"	"Cyst.TAL_2"
"ATCACTTGTCTACGAT"	"Cyst.TAL_2"
"ATCACTTGTGCCGGTT"	"Cyst.PT_1"
"ATCACTTTCGAACGGA"	"Cyst.PT_1"
"ATCAGGTCAAACGAGC"	"Cyst.TAL_2"
"ATCAGGTCAAGTTGGG"	"vSMC"
"ATCAGGTCAGCTGTAT"	"Cyst.PT_3"
"ATCAGGTCAGGATGAC"	"Mac"
"ATCAGGTCAGTGAGCA"	"vSMC"
"ATCAGGTGTTCTTGTT"	"Cyst.PT_1"
"ATCAGGTGTTGCTTGA"	"Cyst.TAL_1"
"ATCAGGTGTTGGATCT"	"Cyst.PT_1"
"ATCAGGTTCAAGGAGC"	"Cyst.PT_1"
"ATCAGGTTCTGTTCAT"	"Cyst.PT_1"
"ATCATTCCAACGTAAA"	"Cyst.PT_2"
"ATCATTCCAAGGCTTT"	"Cyst.PT_3"
"ATCATTCTCGCCTCTA"	"Cyst.ATL"
"ATCATTCTCTGTCCGT"	"Cyst.PT_3"
"ATCATTCTCTTCGACC"	"Cyst.PT_2"
"ATCCACCAGCTCCGAC"	"Cyst.PT_1"
"ATCCACCCACAGAGAC"	"Cyst.PT_3"
"ATCCACCCAGTCCGTG"	"Cyst.TAL_2"
"ATCCACCCATGTACGT"	"Cyst.PT_2"
"ATCCACCGTACTAAGA"	"EC"
"ATCCACCTCGGTCTGG"	"Cyst.PT_1"
"ATCCACCTCTTTGGAG"	"Cyst.TAL_2"
"ATCCATTAGATCGCTT"	"Cyst.TAL_1"
"ATCCATTAGGACTATA"	"Fibroblast"
"ATCCATTCACAAATGA"	"Cyst.PT_1"
"ATCCATTCAGATAAAC"	"Fibroblast"
"ATCCATTGTCCTCAGG"	"Cyst.TAL_2"
"ATCCATTGTGGCTTAT"	"Cyst.TAL_1"
"ATCCATTTCAGCCTTC"	"Cyst.PT_1"
"ATCCATTTCCTGCCAT"	"Cyst.PT_1"
"ATCCCTGAGGAATCGC"	"Cyst.PT_2"
"ATCCCTGCAACTGCTA"	"Cyst.PT_1"
"ATCCCTGCACATTCGA"	"Mac"
"ATCCCTGCAGTCGGAA"	"Cyst.PT_1"
"ATCCCTGGTCAACGCC"	"Cyst.PT_2"
"ATCCCTGGTGCCTATA"	"EC"
"ATCCCTGTCTTACGGA"	"Cyst.TAL_2"
"ATCCGTCCACCAGCCA"	"Cyst.TAL_1"
"ATCCGTCCATCGCTGG"	"EC"
"ATCCGTCGTCCTGAAT"	"Cyst.TAL_1"
"ATCCGTCGTGAATGAT"	"Cyst.TAL_1"
"ATCCTATAGACTACCT"	"Cyst.PT_3"
"ATCCTATAGAGACAAG"	"Cyst.PT_3"
"ATCCTATAGCTCACTA"	"Cyst.PT_2"
"ATCCTATAGTTCCAGT"	"Cyst.PT_1"
"ATCCTATCACTACCCT"	"Podocytes"
"ATCCTATGTTATAGCC"	"Cyst.PT_1"
"ATCCTATTCCCGAATA"	"Cyst.PT_3"
"ATCCTATTCGCTCATC"	"Cyst.PT_1"
"ATCCTATTCTGAGAAA"	"Cyst.PT_1"
"ATCGATGAGCTTCTAG"	"Cyst.PT_3"
"ATCGATGAGGGTCTTT"	"Cyst.PC"
"ATCGATGGTAGTATAG"	"Cyst.PC"
"ATCGATGGTCGTATTG"	"Cyst.PT_3"
"ATCGATGGTGCCTTCT"	"Cyst.TAL_2"
"ATCGATGTCGACCCAG"	"Cyst.PT_1"
"ATCGATGTCTGTCGTC"	"Cyst.PT_2"
"ATCGATGTCTTGAGCA"	"Podocytes"
"ATCGCCTAGGCCCAAA"	"Cyst.PT_1"
"ATCGCCTCAAATTAGG"	"Cyst.PT_3"
"ATCGCCTCACATGAAA"	"Cyst.PC"
"ATCGCCTGTAGGCTCC"	"Cyst.PT_1"
"ATCGCCTGTATCAGGG"	"EC"
"ATCGCCTGTGTATTCG"	"Cyst.TAL_1"
"ATCGCCTGTTAAGCAA"	"Cyst.PT_2"
"ATCGCCTGTTCCTTGC"	"Podocytes"
"ATCGCCTTCCCTTGTG"	"Cyst.PT_1"
"ATCGGATAGCGTGAAC"	"Cyst.PT_1"
"ATCGGATAGCTTTGTG"	"Cyst.PT_3"
"ATCGGATAGGTTGTTC"	"Cyst.PT_1"
"ATCGGATCAAGCAATA"	"vSMC"
"ATCGGATCAATCTAGC"	"Cyst.TAL_2"
"ATCGGATCACCGAATT"	"Cyst.PT_1"
"ATCGGATCATTACTCT"	":LowQual"
"ATCGGATGTAACGCGA"	"Cyst.PT_1"
"ATCGGATTCCAAGCTA"	"Cyst.PC"
"ATCGGCGCAGCAGTGA"	"Unk_1"
"ATCGGCGGTAAGTTAG"	"Cyst.PT_1"
"ATCGGCGGTGCCGAAA"	"Cyst.PT_3"
"ATCGGCGGTTCCCACT"	"Cyst.PT_1"
"ATCGTAGAGAACTTCC"	"Cyst.PT_1"
"ATCGTAGCACCTATCC"	"Cyst.PT_3"
"ATCGTAGCATAAGCGG"	"Cyst.PC"
"ATCGTAGTCATCCTGC"	"Cyst.PT_1"
"ATCGTAGTCCTTGACC"	"Cyst.TAL_1"
"ATCGTAGTCTTACGGA"	"Cyst.PT_1"
"ATCGTCCAGTCGAATA"	"Fibroblast"
"ATCGTCCCATCATCTT"	"Cyst.PT_2"
"ATCGTCCGTAGCTGCC"	"Cyst.TAL_1"
"ATCGTCCTCATCAGTG"	"Cyst.PT_1"
"ATCGTGAAGAGTTCGG"	"Cyst.PT_2"
"ATCGTGACAATGAACA"	"Cyst.PT_2"
"ATCGTGACACATACTG"	"Cyst.TAL_2"
"ATCGTGACACGCGTCA"	"Cyst.PT_1"
"ATCGTGACATCGCCTT"	"Cyst.PT_1"
"ATCGTGACATCTTAGG"	"Cyst.TAL_1"
"ATCGTGAGTTTCGGCG"	"Cyst.TAL_1"
"ATCGTGATCATTCGGA"	"Cyst.PT_3"
"ATCGTGATCTACTCAT"	"Cyst.PT_2"
"ATCGTGATCTGCTTAT"	"Cyst.PT_2"
"ATCGTGATCTGTCCCA"	"Cyst.PT_1"
"ATCTCTAAGGGCTAAC"	"EC"
"ATCTCTATCAAAGGTA"	"Cyst.PT_1"
"ATCTCTATCTTGTGCC"	"Cyst.PT_2"
"ATCTTCAAGAGCCGTA"	"Cyst.PT_3"
"ATCTTCAAGATAGTCA"	"Cyst.ATL"
"ATCTTCAAGTTGCTCA"	"vSMC"
"ATCTTCACACTAGAGG"	"Cyst.PT_1"
"ATCTTCAGTATCAGGG"	"Cyst.PT_1"
"ATCTTCAGTCCTATAG"	"Cyst.TAL_1"
"ATCTTCATCTACTATC"	"Cyst.PT_3"
"ATCTTCATCTACTTCA"	"Cyst.PT_3"
"ATGAAAGAGCTTAAGA"	"Cyst.PT_2"
"ATGAAAGAGGTATCTC"	"Cyst.PT_2"
"ATGAAAGCAAGGCGTA"	"Cyst.IC-A1"
"ATGAAAGCACGCCACA"	"Cyst.PT_3"
"ATGAAAGGTCATCACA"	"Cyst.TAL_2"
"ATGAAAGTCGACGCGT"	"Podocytes"
"ATGACCAAGACAACAT"	"Cyst.TAL_2"
"ATGACCAAGAGAGCGG"	"Cyst.PC"
"ATGACCAAGAGGTTTA"	"Cyst.PC"
"ATGACCAAGTAGCATA"	"Cyst.TAL_1"
"ATGACCAAGTTGAAAC"	"vSMC"
"ATGACCACACGACAGA"	"Fibroblast"
"ATGACCAGTAAGAACT"	"Cyst.PT_1"
"ATGACCAGTCACCCTT"	"Cyst.PT_1"
"ATGACCAGTTTAGACC"	"Cyst.PT_1"
"ATGACCATCGCAATTG"	"Cyst.TAL_2"
"ATGAGGGAGACTAAGT"	"Cyst.TAL_1"
"ATGAGGGAGCAAGGAA"	"Cyst.PT_1"
"ATGAGGGCAAAGCTAA"	"Cyst.TAL_2"
"ATGAGGGTCACCATCC"	"Unk_1"
"ATGAGGGTCACGGTCG"	"Cyst.TAL_1"
"ATGAGGGTCTCAATCT"	"Cyst.TAL_1"
"ATGAGGGTCTCATTGT"	"Cyst.PC"
"ATGAGTCCAGCAGTCC"	"EC"
"ATGAGTCCATCCTGTC"	"Cyst.PT_1"
"ATGAGTCGTTCTAAGC"	"Cyst.PC"
"ATGAGTCTCAGCGCGT"	"Cyst.PT_2"
"ATGAGTCTCATGACAC"	"Cyst.PT_3"
"ATGAGTCTCGTTCCCA"	"Cyst.PT_2"
"ATGATCGAGCAAGCCA"	"Cyst.IC-A1"
"ATGATCGAGTTACGAA"	"Cyst.PT_1"
"ATGATCGCAACTAGAA"	"Cyst.PT_1"
"ATGATCGGTCCTACAA"	"Cyst.TAL_2"
"ATGATCGGTCCTTTGC"	"Fibroblast"
"ATGATCGGTGTTCCAA"	"Cyst.TAL_2"
"ATGATCGGTTATGTCG"	"Cyst.TAL_1"
"ATGCATGAGCGTGAAC"	"Cyst.TAL_1"
"ATGCATGCAATAGGAT"	"Cyst.PT_1"
"ATGCCTCCAAACACCT"	"Cyst.TAL_1"
"ATGCCTCCAGTGCCTG"	"Fibroblast"
"ATGCCTCGTGTTACAC"	"EC"
"ATGCCTCGTTCGTTCC"	"Cyst.TAL_2"
"ATGCCTCTCATTGGTG"	"Cyst.PT_1"
"ATGCCTCTCCATTTAC"	"vSMC"
"ATGCCTCTCGCAATGT"	"Cyst.PT_2"
"ATGCGATAGACTCATC"	"Cyst.TAL_1"
"ATGCGATAGCCGCTTG"	"Fibroblast"
"ATGCGATAGCGTCTGC"	"Cyst.PT_2"
"ATGCGATAGTCGAATA"	"Cyst.PC"
"ATGCGATGTCTGTAGT"	"Cyst.PC"
"ATGCGATGTGTACAGG"	"Cyst.TAL_2"
"ATGCGATTCAGATGCT"	"Cyst.TAL_1"
"ATGGAGGTCTCCACTG"	"Cyst.PT_3"
"ATGGAGGTCTGCATAG"	"Cyst.PT_1"
"ATGGATCAGTAGGAAG"	"T-cell"
"ATGGGAGCAAAGGCTG"	"Cyst.TAL_2"
"ATGGGAGCAAGCAGGT"	"Cyst.PT_1"
"ATGGGAGCACCAGACC"	"vSMC"
"ATGGGAGTCTGGGCAC"	"Cyst.PT_2"
"ATGGGTTAGAAATCCA"	"Cyst.PT_1"
"ATGGGTTAGTTGAAAC"	"Cyst.PT_1"
"ATGGGTTCAGCTATTG"	"Cyst.TAL_2"
"ATGGGTTCAGGGTCTC"	"Cyst.TAL_2"
"ATGGGTTGTGTCTTGA"	"Cyst.PT_3"
"ATGGGTTGTTGATCGT"	"vSMC"
"ATGGGTTTCGCTAGCG"	"Cyst.TAL_1"
"ATGGTTGCACTGATTG"	"Cyst.IC-A1"
"ATGGTTGGTCTGTTAG"	"Cyst.TAL_1"
"ATGGTTGGTGTGTCGC"	"Cyst.TAL_1"
"ATGTCCCAGTGGCGAT"	"Cyst.TAL_2"
"ATGTCCCCAAATGGAT"	"Cyst.PT_3"
"ATGTCCCGTAGATCGG"	"Cyst.TAL_2"
"ATGTCCCGTCCGCAGT"	"Cyst.PT_1"
"ATGTCCCGTGGTCTAT"	"Cyst.PT_1"
"ATGTCCCTCATTTCCA"	"Cyst.ATL"
"ATGTCCCTCGGTAAGG"	"EC"
"ATGTCTTCACTTGTCC"	"Cyst.PT_1"
"ATGTCTTGTAGCTTTG"	"Cyst.PT_1"
"ATGTCTTGTATCGTGT"	"Cyst.PT_3"
"ATGTCTTGTCTGTCCT"	"Cyst.PT_1"
"ATGTCTTTCACTTGTT"	"Cyst.PT_3"
"ATGTCTTTCTAGTGAC"	"Cyst.PT_3"
"ATTACCTAGAGAGCGG"	"Cyst.TAL_2"
"ATTACCTAGCAAGTCG"	"Cyst.PT_2"
"ATTACCTGTATACAGA"	"Cyst.PC"
"ATTACCTTCGAAACAA"	"Cyst.PT_2"
"ATTACCTTCTACCACC"	"Cyst.PT_1"
"ATTACCTTCTCCTGAC"	"Cyst.PT_1"
"ATTACTCAGGCACTCC"	"Cyst.PT_2"
"ATTACTCCAACCACAT"	"Cyst.TAL_2"
"ATTACTCCAATCGCAT"	"Cyst.TAL_2"
"ATTACTCCATTGGCAT"	"Cyst.PT_1"
"ATTACTCGTAGAATAC"	"Cyst.TAL_2"
"ATTATCCCAAATACAG"	"Cyst.IC-A1"
"ATTATCCCACAAGCTT"	"Cyst.TAL_2"
"ATTATCCGTTTCTTAC"	"Cyst.PT_3"
"ATTATCCTCGAAGGAC"	"Cyst.TAL_1"
"ATTATCCTCGCTGTTC"	"T-cell"
"ATTCACTAGTATGAAC"	"Cyst.PT_2"
"ATTCACTCAGGGAATC"	"Cyst.PT_2"
"ATTCACTCATATCGGT"	"Cyst.PT_1"
"ATTCACTTCATCCTGC"	"Mac"
"ATTCAGGAGACGCTCC"	"Cyst.PT_2"
"ATTCAGGAGATGGGCT"	"Podocytes"
"ATTCAGGCAAACCGGA"	"Cyst.PT_3"
"ATTCAGGCAAGTGGGT"	"Cyst.PT_3"
"ATTCAGGCAGCTCTGG"	"Mac"
"ATTCAGGCATTAAAGG"	"Cyst.PT_1"
"ATTCAGGCATTGCAAC"	"Cyst.PT_1"
"ATTCAGGGTAGCTGAG"	"Cyst.TAL_2"
"ATTCAGGGTATTAAGG"	"Cyst.PT_2"
"ATTCAGGGTGTGCTTA"	"Cyst.PT_1"
"ATTCAGGGTTGCTGAT"	"Cyst.TAL_1"
"ATTCAGGGTTTCTATC"	"Cyst.PT_1"
"ATTCAGGTCCTCACTG"	"Cyst.PT_3"
"ATTCAGGTCGCTGCGA"	"Cyst.PC"
"ATTCATCAGCAGATAT"	"Cyst.PT_2"
"ATTCATCAGCTTTCCC"	"Cyst.TAL_1"
"ATTCATCCACAGGATG"	"Cyst.PT_1"
"ATTCATCCAGATAAAC"	"Cyst.PT_2"
"ATTCATCCATGGTACT"	"vSMC"
"ATTCCATAGCAACCAG"	"Cyst.PT_1"
"ATTCCATCAAGGTCAG"	"Cyst.PC"
"ATTCCATCAATCGTCA"	"EC"
"ATTCCATCACTAGAGG"	"Cyst.PT_2"
"ATTCCATCATACAGAA"	"Cyst.ATL"
"ATTCCATCATACTTTC"	"EC"
"ATTCCCGAGGGTCAAC"	"Cyst.TAL_2"
"ATTCCCGCACGGTGAA"	"Podocytes"
"ATTCCCGCATTGACTG"	"Fibroblast"
"ATTCCCGGTGCCTGCA"	"INT"
"ATTCCCGGTGTATACC"	"Cyst.TAL_2"
"ATTCCTACAATAGGGC"	"Cyst.PT_1"
"ATTCCTACAGAGAAAG"	"EC"
"ATTCCTAGTCAAAGAT"	"Cyst.PT_1"
"ATTCCTAGTGCATGAG"	"Cyst.PT_2"
"ATTCCTATCAACCTCC"	"Fibroblast"
"ATTCGTTCAATCTCGA"	"Mac"
"ATTCGTTCAGTCAGTT"	"Podocytes"
"ATTCGTTGTATGCTTG"	"Fibroblast"
"ATTCGTTGTTATGACC"	"Cyst.PT_2"
"ATTCGTTTCCAACCAA"	"Cyst.PT_3"
"ATTCGTTTCTTAGGAC"	"Cyst.ATL"
"ATTCTACAGCATTTCG"	"Cyst.TAL_1"
"ATTCTACAGGAAAGTG"	"vSMC"
"ATTCTACCAAGAGGTC"	"Cyst.TAL_2"
"ATTCTACCAGAACCGA"	"Cyst.TAL_1"
"ATTCTACCAGGTTTAC"	"Cyst.PT_1"
"ATTCTACCATGCAGCC"	"Cyst.PT_1"
"ATTCTACGTTGGATCT"	"Cyst.PT_1"
"ATTCTACTCGCCTAGG"	"Cyst.PT_3"
"ATTCTTGCACTGATTG"	"Cyst.PT_2"
"ATTCTTGGTAAGTCAA"	"T-cell"
"ATTCTTGGTGTCTAAC"	"Cyst.PT_1"
"ATTCTTGTCAGCTTCC"	"Cyst.TAL_1"
"ATTCTTGTCCATTTAC"	"EC"
"ATTCTTGTCCCAGTGG"	"Cyst.TAL_2"
"ATTGGGTAGCATCCTA"	"EC"
"ATTGGGTAGTACCCTA"	"Cyst.PT_1"
"ATTGGGTAGTGCGCTC"	"Cyst.PT_1"
"ATTGGGTCACGTATAC"	"Cyst.PT_2"
"ATTGGGTGTATTCTCT"	"Cyst.PT_2"
"ATTGGGTGTCGGCACT"	"EC"
"ATTGGGTTCGATTCCC"	"Cyst.PT_1"
"ATTGGGTTCTCACGAA"	"Cyst.PT_2"
"ATTGTTCAGCATTGAA"	"Cyst.PT_2"
"ATTGTTCAGGAATCGC"	"Cyst.PT_3"
"ATTGTTCAGGCAGGTT"	"Cyst.PT_3"
"ATTGTTCTCAAGCTGT"	"Cyst.TAL_2"
"ATTGTTCTCGCCGATG"	"Cyst.PT_1"
"ATTGTTCTCTCTATAC"	"Cyst.PT_3"
"ATTTACCAGCTCGCAC"	"Cyst.PC"
"ATTTACCCAAGCAGGT"	"Cyst.TAL_1"
"ATTTACCCAATTCTTC"	"Cyst.PT_1"
"ATTTACCGTAACAGGC"	"Cyst.PT_1"
"ATTTACCGTTACGCCG"	"Cyst.PT_1"
"ATTTACCGTTCTAACG"	"Cyst.PC"
"ATTTACCTCGTGGCTG"	"Cyst.TAL_2"
"ATTTCACCAAAGCAAT"	"Unk_2"
"ATTTCACCAGCTACCG"	"Cyst.PC"
"ATTTCACCATACAGAA"	"Cyst.PT_3"
"ATTTCACGTCAGGTAG"	"Cyst.PT_1"
"ATTTCACTCGCCTCTA"	"Cyst.TAL_1"
"ATTTCACTCTCTCTTC"	"Cyst.PT_3"
"ATTTCTGAGCATTTGC"	"Cyst.PT_1"
"ATTTCTGAGCTCGACC"	"Cyst.TAL_2"
"ATTTCTGCATAACTCG"	"EC"
"ATTTCTGGTATGCTTG"	"Cyst.TAL_2"
"ATTTCTGGTCTTGTCC"	"Cyst.PC"
"ATTTCTGGTTGTATGC"	"Cyst.PT_2"
"ATTTCTGTCAACTACG"	"Cyst.PT_2"
"ATTTCTGTCATCGGGC"	"Cyst.PT_1"
"CAAAGAAAGGGCTAAC"	"Cyst.PT_2"
"CAAAGAACAATACGAA"	"Cyst.PT_3"
"CAAAGAACACCTTCGT"	"Cyst.TAL_2"
"CAAAGAACACTCATAG"	"Fibroblast"
"CAAAGAACATACAGCT"	"Cyst.TAL_2"
"CAAAGAACATTGTCGA"	"Fibroblast"
"CAAAGAATCGAGTCCG"	"Cyst.TAL_1"
"CAAAGAATCTACCAGA"	":LowQual"
"CAACAACAGGGTCAAC"	"Cyst.PT_1"
"CAACAACTCATCGCCT"	"Cyst.TAL_1"
"CAACAGTAGCCTAGGA"	"T-cell"
"CAACAGTCACTGCATA"	"Mac"
"CAACAGTGTCCAGTTA"	"Cyst.PT_1"
"CAACAGTGTTCGGGTC"	"Cyst.PT_1"
"CAACAGTTCGGTCAGC"	"Fibroblast"
"CAACAGTTCGTAGTGT"	"EC"
"CAACCAAAGATGTAGT"	"Cyst.PT_2"
"CAACCAAGTCGAAACG"	"Cyst.PT_1"
"CAACCAAGTGAACTAA"	":LowQual"
"CAACCAAGTGCGCTCA"	"Cyst.PC"
"CAACCAAGTGGAAATT"	"Cyst.PT_1"
"CAACCAATCCCGAGGT"	"Cyst.PT_1"
"CAACCTCAGACTGTTC"	"Cyst.PT_3"
"CAACCTCAGCACTCTA"	"Unk_1"
"CAACCTCCACAGGATG"	"Cyst.TAL_1"
"CAACCTCGTCCATACA"	"Cyst.PT_1"
"CAACCTCTCATGCCAA"	"Cyst.PT_1"
"CAACCTCTCATTGTGG"	"Cyst.PC"
"CAACCTCTCCGGCAGT"	"Cyst.PT_2"
"CAACCTCTCTCGTGAA"	"Cyst.PT_3"
"CAACCTCTCTGGTGGC"	"Cyst.PT_2"
"CAACGATAGGAGTCTG"	"Cyst.TAL_2"
"CAACGATCAAACCGGA"	"vSMC"
"CAACGATCAACCCGCA"	"Cyst.PT_3"
"CAACGATCACTACAGT"	"Cyst.TAL_2"
"CAACGATGTGCACATT"	"Cyst.TAL_1"
"CAACGGCAGGATACGC"	"T-cell"
"CAACGGCAGGTGATCG"	"Cyst.PC"
"CAACGGCCAACGCATT"	"Cyst.PT_3"
"CAACGGCCACCGCTAG"	"Cyst.PT_2"
"CAACGGCCAGCATACT"	"Cyst.PT_1"
"CAACGGCCAGCTCTGG"	"Cyst.TAL_2"
"CAACGGCCATTGTGCA"	"Cyst.PC"
"CAACGGCTCCGCACGA"	"Cyst.TAL_1"
"CAACGGCTCCGGCAGT"	"Cyst.PT_3"
"CAACGGCTCGGCTTGG"	"Cyst.TAL_1"
"CAAGACTAGAATTGTG"	"Cyst.PT_2"
"CAAGACTAGCATTGTC"	"Cyst.TAL_1"
"CAAGACTAGTTGCATC"	"Cyst.PT_1"
"CAAGACTCACTGCGTG"	"Cyst.TAL_1"
"CAAGACTCATGTCAGT"	"Cyst.TAL_1"
"CAAGACTTCTGAATGC"	"Cyst.PT_2"
"CAAGAGGAGAGGTCAC"	"Cyst.PT_1"
"CAAGAGGCACTGTCCT"	"Cyst.PT_1"
"CAAGAGGCATCAGCGC"	"Cyst.PT_2"
"CAAGAGGGTACGTAGG"	"Cyst.TAL_2"
"CAAGAGGGTCTACATG"	"Cyst.PT_1"
"CAAGAGGTCACCTACC"	"Cyst.PT_2"
"CAAGAGGTCCATCTGC"	"Cyst.TAL_1"
"CAAGAGGTCCCTTGGT"	"Cyst.PC"
"CAAGAGGTCCGAGTGC"	"Cyst.TAL_2"
"CAAGAGGTCCTTCTAA"	"Cyst.PT_2"
"CAAGAGGTCGGCACTG"	"Cyst.PC"
"CAAGAGGTCGGTCGGT"	"Cyst.PT_1"
"CAAGCTAAGAAGGGAT"	"Cyst.PT_3"
"CAAGCTAAGCGCTGAA"	"Cyst.PT_1"
"CAAGCTAAGTTGCCTA"	"Cyst.TAL_2"
"CAAGCTACATACTGTG"	"Fibroblast"
"CAAGCTAGTTACCTTT"	"Cyst.TAL_2"
"CAAGGGAAGCGTTCCG"	"Cyst.PT_2"
"CAAGGGACATGTTCGA"	":LowQual"
"CAAGGGATCCTAAGTG"	"Cyst.PT_3"
"CAATACGAGTGCAAAT"	"Cyst.PC"
"CAATACGCATCGAGCC"	"Cyst.PT_2"
"CAATACGCATGAAGGC"	"Cyst.PT_1"
"CAATACGGTCTGTAAC"	"Cyst.TAL_2"
"CAATACGTCCATAAGC"	"Cyst.PT_1"
"CAATCGAAGTTGTAGA"	"Cyst.PT_2"
"CAATCGACAATCTGCA"	"EC"
"CAATCGAGTACTCCCT"	"EC"
"CAATCGAGTCAGACTT"	"Cyst.PT_1"
"CAATCGATCATGTCTT"	"Cyst.TAL_1"
"CAATGACAGACGAAGA"	"Cyst.TAL_1"
"CAATGACAGGTAGCCA"	"EC"
"CAATGACAGGTTATAG"	"Cyst.PT_1"
"CAATGACAGTCGGCAA"	"Cyst.TAL_2"
"CAATGACCAGGCTATT"	"Cyst.PC"
"CAATGACCAGTTTCAG"	"Cyst.PT_1"
"CAATGACCATCGTTCC"	"Cyst.TAL_2"
"CAATGACCATGAAGGC"	"Cyst.PT_3"
"CAATGACTCCCAAGCG"	"Cyst.PT_2"
"CAATTTCAGGTGCGAT"	"Cyst.PT_1"
"CAATTTCCAAGTCGTT"	"Fibroblast"
"CAATTTCCAAGTGCTT"	"Cyst.PT_2"
"CAATTTCGTGACTGTT"	"INT"
"CAATTTCTCATGCCAA"	"Cyst.TAL_2"
"CACAACAAGCACTCAT"	"Cyst.PT_3"
"CACAACAAGCATGGGT"	"Cyst.PT_1"
"CACAACAAGCTCGCAC"	"Cyst.PT_2"
"CACAACACATCCTTGC"	"Cyst.PT_1"
"CACAACAGTCCTCCAT"	"Cyst.PT_2"
"CACAACAGTGTTTGCA"	"Cyst.PT_1"
"CACAACATCCCGTAAA"	"Cyst.TAL_1"
"CACAACATCGTTAGAC"	"Cyst.PT_1"
"CACACAAAGCATGCAG"	"Cyst.PT_2"
"CACACAAAGGACGCAT"	"Cyst.PT_1"
"CACACAACAAACGAGC"	"Cyst.TAL_1"
"CACACAAGTCACTAGT"	"Cyst.PT_1"
"CACACAAGTGCATCTA"	"Cyst.PT_1"
"CACACAATCCGTCACT"	"Cyst.PT_2"
"CACAGATCACATTGTG"	"Cyst.PT_1"
"CACAGATCAGACATCT"	"Cyst.PT_1"
"CACAGATGTCTTTATC"	"Cyst.PT_2"
"CACAGATTCGAGGCAA"	"Cyst.TAL_2"
"CACAGATTCTTAGCCC"	"Cyst.PT_2"
"CACAGGCAGCAACCAG"	"Cyst.PT_1"
"CACAGGCCACTGAGGA"	"Cyst.PT_1"
"CACAGGCCAGCACACC"	"Cyst.PT_2"
"CACAGGCCATCTTAGG"	"Cyst.PT_1"
"CACAGGCGTAAGATAC"	"Cyst.PT_1"
"CACATGAAGTAAACTG"	"Fibroblast"
"CACATGAAGTAGCATA"	"Cyst.PT_1"
"CACATGAAGTCACACT"	"Cyst.TAL_2"
"CACATGACAAATGCGG"	"Cyst.PT_2"
"CACATGACAGCACGAA"	"Cyst.PT_2"
"CACATGAGTCCAAGAG"	"Cyst.PT_2"
"CACATGAGTGTTTCTT"	"Cyst.PT_1"
"CACATGATCGCTACAA"	"Cyst.PT_3"
"CACCAAAAGTATAGGT"	"Cyst.TAL_2"
"CACCAAACAGACGATG"	"Podocytes"
"CACCAAATCAGCGTCG"	"Podocytes"
"CACCGTTCAAAGAACT"	"Cyst.PT_3"
"CACCGTTCAATCAGCT"	"Cyst.TAL_1"
"CACCGTTCAGCATGCC"	"EC"
"CACCGTTGTTCACCGG"	"Fibroblast"
"CACCGTTTCCATCTAT"	"Cyst.PT_1"
"CACGAATCACGGTCTG"	"Cyst.TAL_2"
"CACGAATCATATGGCT"	"Cyst.PT_3"
"CACGAATGTAACGTTC"	"vSMC"
"CACGAATGTAAGCAAT"	"Cyst.ATL"
"CACGAATGTACTGAGG"	"Cyst.TAL_1"
"CACGAATGTATCCCTC"	"EC"
"CACGAATGTGCCTAAT"	"Cyst.PC"
"CACGAATTCGAATGCT"	"Podocytes"
"CACGGGTAGAGACAAG"	"Cyst.PT_3"
"CACGGGTAGCAGGTCA"	"Cyst.PT_3"
"CACGGGTAGGATGGCT"	"EC"
"CACGGGTCAGCTGAGA"	"Cyst.PC"
"CACGGGTCATACAGCT"	"Cyst.PT_3"
"CACGTGGAGTGCTCAT"	"Cyst.PT_1"
"CACGTGGCATCTAGAC"	"Cyst.TAL_1"
"CACGTGGGTCATCCCT"	"Cyst.PT_1"
"CACGTGGTCCCGATCT"	"Fibroblast"
"CACGTTCAGAGTTGCG"	"Cyst.TAL_1"
"CACGTTCCAACGTTAC"	"vSMC"
"CACGTTCCAGAACTAA"	"Cyst.PT_3"
"CACGTTCCAGTTCCAA"	"T-cell"
"CACGTTCCATACCACA"	"Cyst.PT_2"
"CACGTTCCATTGCCGG"	"Cyst.PT_3"
"CACGTTCGTCGAATTC"	"Cyst.PT_2"
"CACGTTCGTGGTAATA"	"Mac"
"CACGTTCTCTAGTGAC"	"EC"
"CACGTTCTCTATTGTC"	"EC"
"CACTAAGCATCCTATT"	"Cyst.PT_2"
"CACTAAGGTGCCTGAC"	"EC"
"CACTAAGGTGCGCTCA"	"Cyst.PT_1"
"CACTAAGGTTCGTTCC"	"Cyst.TAL_2"
"CACTGAAAGGCCATAG"	"Cyst.IC-A1"
"CACTGAACAGGATGAC"	"Cyst.PT_1"
"CACTGAATCATTCTTG"	"Cyst.PT_1"
"CACTGAATCATTGGTG"	"Podocytes"
"CACTGGGAGTGGCAGT"	"Cyst.PT_3"
"CACTGGGGTCGCGGTT"	"Cyst.PT_2"
"CACTGGGGTGTGAATA"	"Cyst.IC-A1"
"CACTGGGTCCATTTGT"	"Cyst.PT_1"
"CACTGGGTCGGCTCTT"	"Cyst.TAL_1"
"CACTGTCGTACGTACT"	"Cyst.PT_1"
"CACTTCGAGGGAACAA"	"Cyst.PT_1"
"CACTTCGAGTGTAGTA"	"Cyst.PT_1"
"CACTTCGCATCTGCGG"	"Cyst.PT_3"
"CACTTCGCATTGAAAG"	"Cyst.PT_3"
"CACTTCGGTACTTCCC"	"vSMC"
"CACTTCGGTAGTGCGA"	"Cyst.TAL_2"
"CACTTCGTCATCTATC"	"Cyst.PC"
"CACTTCGTCTGAGCAT"	"Cyst.PT_1"
"CAGAGCCAGACGCATG"	"Cyst.PT_3"
"CAGAGCCAGGGCCTCT"	"Cyst.TAL_1"
"CAGAGCCGTTCGAAGG"	"Cyst.PT_1"
"CAGAGCCGTTGCCGCA"	"EC"
"CAGAGCCTCACTGAAC"	"Cyst.PT_2"
"CAGAGCCTCTACTATC"	"EC"
"CAGAGCCTCTTCTAAC"	"Cyst.PT_3"
"CAGATACGTAGGACTG"	"Mac"
"CAGATACGTCCTATAG"	"Cyst.PT_1"
"CAGATACTCGAAACAA"	"Cyst.PT_1"
"CAGATACTCGACGCGT"	"Cyst.PT_1"
"CAGATCAAGGAAGAAC"	"INT"
"CAGATCAAGTCCTGCG"	"Cyst.PT_1"
"CAGATCACAAGTATAG"	"Cyst.PT_2"
"CAGATCACACCCAATA"	"Cyst.TAL_1"
"CAGATCACACCGTGCA"	"Cyst.PT_3"
"CAGATCACAGAAGCGT"	"Cyst.PT_1"
"CAGATCAGTCGAACAG"	"Cyst.PT_3"
"CAGATTGAGTTTCGGT"	"vSMC"
"CAGATTGCAACTTCTT"	"Cyst.PT_1"
"CAGATTGGTCCCAAAT"	"Cyst.IC-A1"
"CAGATTGGTTTACGAC"	"vSMC"
"CAGATTGTCGACATCA"	"Cyst.PT_1"
"CAGATTGTCGGCATCG"	"T-cell"
"CAGCAATAGGTAATCA"	"Cyst.PT_1"
"CAGCAATCAGGGAATC"	"Cyst.TAL_1"
"CAGCAATCATACCAGT"	"Cyst.PT_3"
"CAGCAATTCAAACTGC"	"vSMC"
"CAGCACGAGCACTCAT"	"Cyst.PT_1"
"CAGCACGGTCCAAAGG"	"Cyst.PT_2"
"CAGCACGTCGGTAAGG"	"EC"
"CAGCAGCCACGCTATA"	"Cyst.TAL_2"
"CAGCAGCGTTCCTACC"	"Mac"
"CAGCAGCGTTTCACTT"	"Cyst.TAL_2"
"CAGCAGCTCCACGTCT"	"Cyst.PC"
"CAGCAGCTCTATGTGG"	"Cyst.PT_1"
"CAGCAGCTCTGTCGTC"	":LowQual"
"CAGCCAGCAACACTAC"	"Cyst.PT_3"
"CAGCCAGCACTCTAGA"	":LowQual"
"CAGCCAGGTACACGCC"	"Cyst.PC"
"CAGCCAGGTTGTACGT"	"Cyst.PC"
"CAGCCAGTCATTCGGA"	"Cyst.PT_1"
"CAGCCAGTCCCGAAAT"	"Cyst.PT_1"
"CAGCCAGTCGGCTATA"	"Cyst.PT_1"
"CAGCCAGTCTTTCCAA"	"Cyst.TAL_1"
"CAGCGTGAGGTGCCAA"	"Cyst.PT_2"
"CAGCGTGCAAATCCCA"	"Cyst.PT_3"
"CAGCGTGCAGCGAACA"	"Cyst.PT_2"
"CAGCGTGGTCATTGCA"	"Cyst.PT_1"
"CAGCGTGTCATGCGGC"	"Cyst.PT_1"
"CAGGCCAAGTGCACTT"	"Cyst.TAL_2"
"CAGGCCACACACGGAA"	"Cyst.PT_1"
"CAGGCCACATCTAACG"	"EC"
"CAGGCCAGTGCCTTTC"	"Cyst.PT_3"
"CAGGCCATCCTGGTCT"	"T-cell"
"CAGGCCATCTCGACCT"	"Cyst.ATL"
"CAGGGCTAGCCGATCC"	"Cyst.PT_1"
"CAGGGCTAGGCTTCCG"	"vSMC"
"CAGGGCTGTACTGCGC"	"Cyst.PT_1"
"CAGGGCTTCACAATGC"	"Cyst.PT_2"
"CAGGGCTTCACCACAA"	"Cyst.PT_3"
"CAGGGCTTCTACCAGA"	"Cyst.PT_2"
"CAGGGCTTCTGCACCT"	"Cyst.PT_1"
"CAGGTATAGCCTGAAG"	"Cyst.PT_3"
"CAGGTATAGGTTCATC"	"Cyst.PT_3"
"CAGGTATAGTTGGCTT"	"Cyst.PT_2"
"CAGGTATCATCAGCTA"	"Cyst.PT_1"
"CAGGTATGTAGGCTGA"	"Fibroblast"
"CAGGTATGTCGCTTAA"	"Cyst.PT_1"
"CAGGTATGTGCAATGG"	"Cyst.TAL_2"
"CAGGTATGTTGGTACT"	"Cyst.TAL_1"
"CAGGTATTCCCGAATA"	"Cyst.TAL_1"
"CAGGTATTCGTCTAAG"	"Cyst.PT_1"
"CAGTGCGAGATGTTGA"	":LowQual"
"CAGTGCGAGTGATCGG"	"Cyst.PT_1"
"CAGTGCGCAAATTAGG"	"Podocytes"
"CAGTGCGCAGATCCAT"	"Cyst.PT_1"
"CAGTGCGCATACTTTC"	"Cyst.PT_2"
"CAGTGCGTCCAAGAGG"	"Cyst.PT_1"
"CAGTGCGTCGAACCTA"	"Cyst.PT_1"
"CAGTTAGAGACATAGT"	"Cyst.TAL_1"
"CAGTTAGAGCAACTCT"	"Cyst.TAL_1"
"CAGTTAGAGCCTGACC"	"Cyst.TAL_1"
"CAGTTAGAGGTACAAT"	"Cyst.PT_3"
"CAGTTAGCACTCCACT"	"Cyst.PT_1"
"CAGTTAGGTTTACGTG"	"Podocytes"
"CAGTTAGTCGGAGCAA"	"Cyst.TAL_2"
"CAGTTAGTCGTTAGTG"	"Cyst.PT_1"
"CAGTTCCAGTGCACAG"	"Cyst.TAL_2"
"CAGTTCCGTCTCTCCA"	"T-cell"
"CAGTTCCGTTCAGGTT"	"Cyst.PT_3"
"CAGTTCCGTTGTCTAG"	"Cyst.TAL_2"
"CAGTTCCTCAAAGCCT"	"INT"
"CAGTTCCTCAGAATAG"	"Unk_2"
"CAGTTCCTCCTGGGTG"	"Cyst.PT_1"
"CATAAGCAGATCCCGC"	"Cyst.PT_1"
"CATAAGCAGGCCCAAA"	"EC"
"CATAAGCAGGGCTAAC"	"Cyst.PT_1"
"CATAAGCCACCACATA"	"vSMC"
"CATAAGCCACCCAATA"	"EC"
"CATAAGCCACTGTGTA"	"Cyst.PT_1"
"CATAAGCGTCTCCTGT"	"Cyst.PC"
"CATAAGCTCGGTGCAC"	"Podocytes"
"CATACAGCAAATGGAT"	"Cyst.TAL_2"
"CATACAGCACACCGAC"	"Cyst.PC"
"CATACAGCAGCAGATG"	"vSMC"
"CATACAGCATTCTCTA"	"Cyst.TAL_2"
"CATACAGGTAGTCGGA"	"Cyst.PT_1"
"CATACAGGTCTCACAA"	"Cyst.TAL_1"
"CATACAGTCTCGGCTT"	"Fibroblast"
"CATACAGTCTTTGCAT"	"Cyst.TAL_1"
"CATACCCAGAGGGTGG"	"Mac"
"CATACCCAGATCGCTT"	"Cyst.PT_1"
"CATACCCAGCGCACAA"	"Cyst.PT_3"
"CATACCCGTAAGATAC"	"Cyst.TAL_1"
"CATACCCTCACCGCTT"	"Cyst.PT_3"
"CATACCCTCGACGACC"	"Cyst.PT_2"
"CATACCCTCGCAATTG"	"Cyst.PT_2"
"CATACTTAGGTTGACG"	"Cyst.PT_2"
"CATACTTAGTAACAGT"	"Cyst.PT_1"
"CATACTTCAATATCCG"	"Cyst.PT_1"
"CATACTTCATCGTTCC"	"Cyst.TAL_1"
"CATACTTGTAACAAGT"	"Cyst.PT_2"
"CATACTTGTAGTCTGT"	"Cyst.TAL_2"
"CATACTTGTGTTTGCA"	"Cyst.TAL_2"
"CATACTTTCGACGCGT"	"Cyst.TAL_1"
"CATAGACAGGTCTACT"	"Cyst.PT_2"
"CATAGACCACACCTGG"	"Cyst.PT_1"
"CATAGACGTTGCATAC"	"Fibroblast"
"CATAGACTCACGGGCT"	"Podocytes"
"CATAGACTCCGAAGGA"	"Cyst.TAL_1"
"CATCAAGCACGCACCA"	"Cyst.TAL_1"
"CATCAAGGTCCTCAGG"	"Cyst.PT_1"
"CATCAAGTCACGAACT"	"Cyst.TAL_2"
"CATCAAGTCATTGGTG"	"Cyst.TAL_2"
"CATCAAGTCCTCGCAT"	"Cyst.TAL_1"
"CATCAAGTCTTAGCAG"	"Cyst.PT_1"
"CATCCACCAGATGCGA"	"Cyst.PC"
"CATCCACGTTCTGACA"	":LowQual"
"CATCCACTCAGTAGGG"	"Cyst.PC"
"CATCCACTCAGTCCGG"	"Cyst.TAL_2"
"CATCCACTCGATCCAA"	"EC"
"CATCCACTCGCTTGCT"	"Cyst.TAL_2"
"CATCCCAAGGGCTTCC"	"Fibroblast"
"CATCCCACAAGTGATA"	"EC"
"CATCCCACAGTCGGTC"	"Cyst.TAL_2"
"CATCCCAGTGTCACAT"	"Fibroblast"
"CATCCCAGTGTCCACG"	"Cyst.PT_1"
"CATCCCATCCAATGCA"	"EC"
"CATCCGTAGCTAAATG"	"Cyst.PT_3"
"CATCCGTCAAGTGTCT"	"Unk_2"
"CATCCGTCACGCGTCA"	"Cyst.PT_1"
"CATCCGTGTCAAGCGA"	"Cyst.TAL_2"
"CATCCGTTCGCTGATA"	"Cyst.PT_1"
"CATCGCTAGACTCATC"	"vSMC"
"CATCGCTAGAGTATAC"	"Cyst.PT_2"
"CATCGCTCACCATTCC"	"Cyst.TAL_2"
"CATCGCTCAGGCTTGC"	"Cyst.PT_3"
"CATCGCTCATCTCCCA"	"Podocytes"
"CATCGCTGTATGTGTC"	"Cyst.PT_3"
"CATCGCTTCAGAATAG"	"Cyst.PT_1"
"CATCGCTTCGCCAGAC"	"EC"
"CATCGGGCACACGGTC"	"vSMC"
"CATCGGGCATAGAATG"	"Cyst.TAL_2"
"CATCGGGCATGGTGGA"	"Cyst.PT_1"
"CATCGGGCATTGAAAG"	"Cyst.PT_1"
"CATCGGGTCAAACCCA"	"Cyst.PT_2"
"CATCGGGTCCTTCACG"	"Cyst.TAL_2"
"CATCGGGTCGCCAATA"	"Cyst.PT_1"
"CATCGGGTCGGCGATC"	"Cyst.PT_2"
"CATCGGGTCTCTCGAC"	"Cyst.PT_1"
"CATCGTCAGACTTAAG"	"Cyst.PC"
"CATCGTCAGATGACAT"	"Cyst.TAL_2"
"CATCGTCCATCTTCGC"	"Cyst.PC"
"CATCGTCGTAGAGATT"	"Cyst.PT_1"
"CATCGTCGTGAATTAG"	"Cyst.PT_3"
"CATCGTCGTGACTGAG"	"Cyst.PT_3"
"CATCGTCTCACCTGTC"	"Cyst.PT_3"
"CATCGTCTCATTGCGA"	"Cyst.PT_3"
"CATCGTCTCGTCGCTT"	"Cyst.PT_1"
"CATCGTCTCTTTCTAG"	"Cyst.TAL_1"
"CATGAGTCAACCTATG"	"Cyst.TAL_2"
"CATGAGTCATAACGGG"	"Cyst.PT_1"
"CATGAGTGTCTACGTA"	"Cyst.TAL_2"
"CATGAGTGTCTTGAGT"	"Cyst.TAL_1"
"CATGAGTTCCCTGGTT"	"Cyst.PT_2"
"CATGAGTTCCTGGCTT"	"vSMC"
"CATGCAAAGTAAATGC"	"EC"
"CATGCAAGTAACTAAG"	"Cyst.TAL_2"
"CATGCAAGTGAGAACC"	"Cyst.TAL_2"
"CATGCAATCACTACTT"	"Cyst.TAL_2"
"CATGCAATCACTTCTA"	"Cyst.PT_1"
"CATGCAATCCTCTGCA"	"Cyst.PT_1"
"CATGCCTAGCAAACAT"	"Cyst.PT_1"
"CATGCCTAGGCGTTGA"	"Cyst.TAL_1"
"CATGCCTCAAAGGATT"	"Cyst.PT_1"
"CATGCCTCACAGTGTT"	"Cyst.PT_2"
"CATGCCTGTACCTAAC"	"Cyst.PT_3"
"CATGCCTGTGGTATGG"	"Cyst.PT_1"
"CATGCCTTCCGCAACG"	"Cyst.TAL_1"
"CATGCCTTCGCTTTAT"	"Fibroblast"
"CATGCCTTCTCTGACC"	"Cyst.PT_2"
"CATGCGGAGGCACAAC"	"Cyst.PT_1"
"CATGCGGAGGCGACAT"	"Cyst.TAL_1"
"CATGCGGAGGTCACAG"	"Podocytes"
"CATGCGGCACCGGTCA"	"Mac"
"CATGCGGCACTACCCT"	"vSMC"
"CATGCGGGTCCTTTGC"	"Cyst.PT_1"
"CATGCGGGTGACTCGC"	"Cyst.PT_1"
"CATGCGGTCACTGATG"	"Cyst.PT_3"
"CATGCTCAGTAAACGT"	"EC"
"CATGCTCCAAGCACCC"	"vSMC"
"CATGCTCCATGAATAG"	"vSMC"
"CATGCTCGTTATAGAG"	"Podocytes"
"CATGCTCGTTCGAGCC"	"Cyst.PT_3"
"CATGCTCGTTGCATGT"	"Mac"
"CATGCTCTCTCCGAAA"	"Cyst.PT_2"
"CATGGATCATTCGATG"	"Cyst.TAL_1"
"CATGGTAAGCTACTAC"	"Cyst.PT_1"
"CATGGTAAGGAGACCT"	"Cyst.PT_2"
"CATGGTAAGTGGATTA"	"Cyst.PC"
"CATGGTACAGCTACTA"	"Cyst.PT_1"
"CATGGTACAGTGAGCA"	"Cyst.PC"
"CATGGTAGTAAGCAAT"	"Cyst.PT_3"
"CATGGTAGTACTTCCC"	"Unk_2"
"CATGGTAGTGGAACCA"	"Cyst.PT_1"
"CATGGTATCAACTTTC"	"Cyst.PT_2"
"CATGGTATCCGTACGG"	"Cyst.TAL_1"
"CATGGTATCCTACTGC"	"Cyst.PT_1"
"CATTCATAGCCACCGT"	"Cyst.PT_1"
"CATTCATCAAAGGGCT"	"Cyst.PT_1"
"CATTCATCACACGGAA"	"vSMC"
"CATTCATGTCAATCTG"	"Cyst.TAL_1"
"CATTCATGTCACTAGT"	"Cyst.TAL_2"
"CATTCATTCATCACAG"	"Cyst.PT_1"
"CATTCATTCTCTAGGA"	"Cyst.PT_3"
"CATTCCGAGAACGCGT"	"Cyst.PT_3"
"CATTCCGAGAGTCTTC"	"Cyst.PT_1"
"CATTCCGCAGAGGTAC"	"Cyst.TAL_2"
"CATTCCGGTCTTGTCC"	"Cyst.TAL_1"
"CATTCCGTCAAACTGC"	"Cyst.PC"
"CATTCCGTCCGACGGT"	"Cyst.PT_2"
"CATTCCGTCGGCCAAC"	"Cyst.PT_1"
"CATTCCGTCGGTCGGT"	"Cyst.PT_3"
"CATTCTAAGGTAAAGG"	":LowQual"
"CATTCTAAGGTCACTT"	"Cyst.TAL_2"
"CATTCTACAACTGAAA"	"Cyst.PT_1"
"CATTCTACAGGCGTTC"	"Cyst.PT_1"
"CATTCTACATGTTACG"	"Cyst.PT_1"
"CATTCTAGTTCACGAT"	"Cyst.PT_2"
"CATTCTATCACCTACC"	"Cyst.PC"
"CATTCTATCTGCTTTA"	"Cyst.PT_1"
"CATTCTATCTGTGCTC"	"Cyst.PT_1"
"CATTGAGCACGGCGTT"	"Cyst.PC"
"CATTGAGCATTGAAGA"	"Cyst.TAL_1"
"CATTGAGGTGCCTGAC"	"vSMC"
"CATTGAGGTGGTTCTA"	"Cyst.PT_3"
"CATTGAGGTTCCAAAC"	"EC"
"CATTGCCAGAATCTAG"	"Cyst.PT_3"
"CATTGCCCAAATCGTC"	"Cyst.PC"
"CATTGCCCAGGCGTTC"	"Cyst.PT_1"
"CATTGCCCATTCTCTA"	"vSMC"
"CATTGCCGTAGGACCA"	"Cyst.PT_2"
"CATTGCCGTCCCTGTT"	"Cyst.PT_3"
"CATTGCCGTGAGTGAC"	"Cyst.TAL_1"
"CATTGCCTCAGACCCG"	"Cyst.TAL_1"
"CATTGCCTCTTGATTC"	"Cyst.TAL_2"
"CATTGTTGTTCTCGCT"	"Mac"
"CATTTCAAGGCCACTC"	"Cyst.TAL_1"
"CCAAGCGCAGATTTCG"	"Cyst.PT_1"
"CCAAGCGGTGGATCGA"	"Cyst.PT_3"
"CCAATGAAGATCGACG"	"Cyst.PT_1"
"CCAATGAAGCATTGAA"	"Cyst.TAL_2"
"CCAATGAAGGACGCTA"	"Cyst.PT_1"
"CCAATGAAGGGTCTTT"	"Unk_1"
"CCAATGACAAAGGTTA"	"Cyst.PT_2"
"CCAATGACATCATGAC"	"Cyst.PT_1"
"CCAATGAGTTAGTTCG"	"Cyst.TAL_2"
"CCAATGATCTGGCCAG"	"Cyst.PT_3"
"CCAATTTAGCGAGTAC"	"Cyst.IC-A1"
"CCAATTTGTACTCAAC"	"Unk_1"
"CCAATTTGTGTGAATA"	"Cyst.PT_2"
"CCAATTTGTTAGAGAT"	"Cyst.PT_1"
"CCAATTTTCGCAATGT"	"T-cell"
"CCAATTTTCTGTCCCA"	"Cyst.PT_1"
"CCACAAAAGGTATTGA"	"Cyst.PT_1"
"CCACAAACAGCGGTCT"	"Cyst.PC"
"CCACAAAGTACAGGTG"	"EC"
"CCACAAAGTCAACCTA"	"Cyst.TAL_2"
"CCACAAATCCCAGCGA"	"Cyst.TAL_1"
"CCACAAATCGTTCTGC"	"Cyst.PT_3"
"CCACAAATCTTAAGGC"	"Cyst.PT_3"
"CCACACTAGGGTTAAT"	"Cyst.PT_2"
"CCACACTCAGCTAACT"	"vSMC"
"CCACACTGTATTCCTT"	"Cyst.TAL_2"
"CCACACTGTCGCGGTT"	"Cyst.PT_2"
"CCACACTGTTAAACAG"	"Cyst.TAL_1"
"CCACACTTCTGCAGCG"	"Cyst.PC"
"CCACCATAGTTCTCTT"	"Cyst.TAL_1"
"CCACCATGTGGGAGAG"	"Cyst.PT_2"
"CCACCATGTTCTGACA"	"Cyst.PC"
"CCACCATTCGAGGCAA"	"Cyst.TAL_2"
"CCACCATTCTTACGTT"	"Cyst.PT_2"
"CCACGAGAGACTCATC"	"Cyst.PT_2"
"CCACGAGAGGTGCTAG"	"Cyst.PT_1"
"CCACGAGAGTCGGCAA"	"Cyst.TAL_2"
"CCACGAGCATTCTGTT"	"EC"
"CCACGAGGTATGTCAC"	"Cyst.PT_1"
"CCACGAGTCCTCACCA"	"Cyst.TAL_2"
"CCACGAGTCTCAACCC"	"Cyst.PC"
"CCACGAGTCTCAGAAC"	"Cyst.TAL_1"
"CCACGTTCACCAGCCA"	"Cyst.TAL_2"
"CCACGTTCAGCCTACG"	"Cyst.ATL"
"CCACGTTGTATCGATC"	"Cyst.PC"
"CCACGTTGTCAGGTAG"	"Cyst.PT_3"
"CCACTTGCAAGTATCC"	"Cyst.PT_2"
"CCACTTGCACCACATA"	"Cyst.PT_2"
"CCACTTGGTCTTCCGT"	"EC"
"CCACTTGGTTATGACC"	"Cyst.TAL_2"
"CCATAAGAGCGTGTTT"	"Cyst.PT_1"
"CCATAAGTCAAGGTGG"	"Cyst.TAL_1"
"CCATAAGTCACACGAT"	"Cyst.PT_3"
"CCATAAGTCATATGGC"	"vSMC"
"CCATAAGTCGTCACCT"	"Cyst.PT_1"
"CCATCACCAAATACAG"	"Cyst.PT_2"
"CCATCACCACTGAGGA"	"Cyst.PT_1"
"CCATCACCATCGAACT"	"Cyst.TAL_1"
"CCATCACGTACCCAGC"	"Cyst.TAL_1"
"CCATCACTCAGCCCAG"	"Cyst.PT_3"
"CCATCACTCAGCGTCG"	"Cyst.TAL_2"
"CCATCACTCCCTCTTT"	"Cyst.PT_1"
"CCATCACTCGCGGACT"	"Cyst.TAL_2"
"CCCAACTAGCAGAAAG"	"EC"
"CCCAACTAGCATTGAA"	"Cyst.TAL_1"
"CCCAACTAGTTTCGGT"	"Mac"
"CCCAACTCAGGTATGG"	"Cyst.PT_2"
"CCCAACTGTACGCGTC"	"Cyst.PC"
"CCCAACTGTGAAAGTT"	"Cyst.PT_3"
"CCCAACTGTGACATCT"	"Cyst.PT_1"
"CCCAACTGTTTACCTT"	"Cyst.PT_2"
"CCCAACTTCCTGTAAG"	"Cyst.TAL_1"
"CCCAACTTCGAGGCAA"	"Cyst.PT_3"
"CCCATTGAGGACGCAT"	"Cyst.TAL_1"
"CCCATTGAGTATCTGC"	"Cyst.TAL_2"
"CCCATTGCAAGCGATG"	"Podocytes"
"CCCATTGCAGTGGGTA"	"Cyst.PT_1"
"CCCATTGTCACAGTGT"	"Cyst.PC"
"CCCATTGTCCGCATAA"	"Cyst.TAL_2"
"CCCGAAGAGCACCTGC"	"Fibroblast"
"CCCGAAGAGCGACCCT"	"Cyst.TAL_1"
"CCCGAAGAGGTTCAGG"	"Cyst.PT_3"
"CCCGAAGAGTATCTGC"	"Cyst.PT_2"
"CCCGAAGCATGGACAG"	"Cyst.TAL_1"
"CCCGAAGGTGGAACCA"	"Cyst.PT_2"
"CCCGAAGGTTCAAGTC"	"Cyst.PT_3"
"CCCGGAAAGAACTCCT"	"Fibroblast"
"CCCGGAACATTGAGCT"	"Cyst.TAL_2"
"CCCGGAAGTTGCGGAA"	"Cyst.PT_1"
"CCCGGAATCTACCACC"	"Cyst.TAL_1"
"CCCTAACAGCTAAATG"	"Fibroblast"
"CCCTAACAGGATTTCC"	"Cyst.TAL_2"
"CCCTAACCACAAGCAG"	"Cyst.PT_1"
"CCCTAACCAGGCGTTC"	"INT"
"CCCTAACTCCGAGGCT"	"EC"
"CCCTAACTCTCTTCAA"	"Cyst.PT_3"
"CCCTAACTCTTTCCGG"	"Cyst.TAL_1"
"CCCTCAAAGAGCTGCA"	"Unk_2"
"CCCTCAACAAACTCTG"	"Cyst.PT_1"
"CCCTCAAGTACAATAG"	"Cyst.TAL_2"
"CCCTCAATCACTGGTA"	"Cyst.TAL_1"
"CCCTCAATCTTGGGCG"	"Cyst.PT_1"
"CCCTCTCAGCATCCCG"	"Cyst.PT_1"
"CCCTCTCCACTAACCA"	"Cyst.PT_1"
"CCCTCTCCACTGCACG"	"INT"
"CCCTCTCCACTTGAGT"	"Cyst.PT_1"
"CCCTCTCCAGGCTTGC"	"Cyst.PT_1"
"CCCTCTCGTTTAAGGA"	"Cyst.PC"
"CCCTCTCTCCCTCTTT"	"Cyst.TAL_1"
"CCCTCTCTCCTACCGT"	"Cyst.TAL_1"
"CCCTCTCTCCTCTCTT"	"Mac"
"CCCTGATAGGTCACAG"	"Cyst.PT_3"
"CCCTGATCACTACGGC"	"Cyst.ATL"
"CCCTGATTCAGTCACA"	"Cyst.ATL"
"CCCTGATTCCGTACGG"	"Cyst.PT_1"
"CCCTTAGAGGCGAACT"	"Cyst.PT_1"
"CCCTTAGCAAATCAAG"	"Cyst.TAL_1"
"CCCTTAGCAAATGGAT"	"Cyst.PC"
"CCCTTAGCAATAGTAG"	"Cyst.PT_1"
"CCCTTAGGTGTCCTAA"	"Cyst.TAL_1"
"CCCTTAGGTTCAGCTA"	"Cyst.TAL_2"
"CCCTTAGTCGTCGCTT"	"Cyst.TAL_1"
"CCGAACGCAAGACGAC"	"Cyst.PT_1"
"CCGAACGCACCCTTAC"	"Cyst.PT_1"
"CCGAACGCAGAGTGAC"	"Cyst.PT_3"
"CCGAACGCATGTTTGG"	"Cyst.PT_2"
"CCGAACGGTATGGAAT"	"Cyst.IC-A1"
"CCGAACGTCATTGCCC"	"Cyst.TAL_2"
"CCGATCTAGTGATAAC"	"Cyst.PC"
"CCGATCTAGTTTGGCT"	"Cyst.PT_3"
"CCGATCTCACAGCTGC"	"Cyst.TAL_1"
"CCGATCTGTACTGTTG"	"vSMC"
"CCGATCTTCATCACCC"	"Cyst.PT_3"
"CCGATCTTCATTACGG"	"Cyst.TAL_1"
"CCGATCTTCGGCATTA"	"Cyst.TAL_1"
"CCGATCTTCTGCCTGT"	"Cyst.TAL_1"
"CCGATGGAGGATCACG"	"vSMC"
"CCGATGGCACAGTACT"	"Cyst.PT_3"
"CCGATGGCACGCGTGT"	"Fibroblast"
"CCGATGGTCACTGATG"	"Cyst.PT_2"
"CCGCAAGAGATTACCC"	"vSMC"
"CCGCAAGAGTTGCGAG"	"Cyst.PT_1"
"CCGCAAGCATTGTACG"	"Cyst.PT_2"
"CCGCAAGTCTGGCCTT"	"Cyst.PT_2"
"CCGGACAAGGTCCGAA"	"Cyst.PT_1"
"CCGGACACAGGTATGG"	"Cyst.TAL_1"
"CCGGACACAGTGCCTG"	"Cyst.PT_2"
"CCGGACAGTGAACCGA"	"Cyst.TAL_1"
"CCGGACAGTGCTATTG"	"Cyst.PT_1"
"CCGGACATCAACGAGG"	"EC"
"CCGGGTAAGATAGTCA"	"Cyst.PT_2"
"CCGGGTAAGCTCTTCC"	"Cyst.PT_3"
"CCGGGTACAAGCGATG"	"Cyst.TAL_1"
"CCGGGTACACGAGAAC"	"Cyst.IC-A1"
"CCGGGTACAGCCATTA"	"Mac"
"CCGGGTACATATGAAG"	"Cyst.PT_1"
"CCGGGTAGTAGGACTG"	"Cyst.TAL_1"
"CCGGGTAGTATTGAGA"	"Cyst.PT_1"
"CCGGGTAGTTGTGGAG"	"Cyst.PT_1"
"CCGGGTATCAAGATAG"	"Cyst.TAL_1"
"CCGGTAGCAAGGTCTT"	"Cyst.PT_1"
"CCGGTAGGTACTTCCC"	"vSMC"
"CCGGTAGGTGGCACTC"	"Cyst.PT_1"
"CCGGTAGTCCGATGCG"	"Cyst.TAL_2"
"CCGGTAGTCGAGAAAT"	"Cyst.PT_3"
"CCGGTAGTCGCTCTAC"	"Cyst.PT_3"
"CCGGTGAAGCCGAACA"	"T-cell"
"CCGGTGAAGGATGAGA"	"Cyst.PT_2"
"CCGGTGACATAGTCAC"	"Cyst.PT_3"
"CCGGTGACATTGCAAC"	"Cyst.TAL_2"
"CCGGTGAGTGGTTTAC"	"Cyst.PT_2"
"CCGGTGAGTTCCAGGC"	"Cyst.TAL_2"
"CCGGTGATCAGTCAGT"	"Cyst.PC"
"CCGTAGGCATAATCCG"	"Unk_2"
"CCGTAGGTCTAATTCC"	"T-cell"
"CCGTGAGAGACTCTTG"	"Cyst.TAL_2"
"CCGTGAGCATGAGATA"	"Cyst.PT_1"
"CCGTGAGTCTCAAAGC"	"Mac"
"CCGTGAGTCTTGTGCC"	"Cyst.PT_1"
"CCGTTCAAGAGGGTAA"	"Cyst.PT_2"
"CCGTTCAAGCACCGTC"	"Cyst.PT_3"
"CCGTTCAAGCACGATG"	"Cyst.PT_1"
"CCGTTCACATAGAGGC"	"Cyst.PT_1"
"CCTAACCAGGAAGTCC"	"Cyst.PT_3"
"CCTAACCAGTTACGGG"	"Cyst.PT_2"
"CCTAACCCACTTGAAC"	"Fibroblast"
"CCTAACCGTAATGTGA"	"Cyst.PT_3"
"CCTAACCGTAGAGACC"	"Cyst.TAL_1"
"CCTAACCGTCAAGCCC"	"Cyst.PT_1"
"CCTAACCGTTCCGCTT"	"vSMC"
"CCTAACCGTTGTCTAG"	"Podocytes"
"CCTAACCTCAAGATAG"	"Cyst.TAL_2"
"CCTAACCTCGGCAGTC"	"Mac"
"CCTAACCTCTACCTTA"	"Cyst.PT_3"
"CCTAAGAGTCGCATTA"	"Cyst.TAL_2"
"CCTACGTAGGCGAAGG"	"EC"
"CCTACGTAGGGCCTCT"	"Cyst.PT_3"
"CCTACGTCAAGTACCT"	"Cyst.PT_3"
"CCTACGTTCAGTGTGT"	":LowQual"
"CCTACGTTCATGCGGC"	"Cyst.TAL_2"
"CCTACGTTCGGCTGGT"	":LowQual"
"CCTACGTTCGTCCTCA"	"Mac"
"CCTATCGAGGTGCCAA"	"Cyst.PT_1"
"CCTATCGAGTAGACAT"	"Cyst.PC"
"CCTATCGGTCTTGCTC"	"Cyst.ATL"
"CCTATCGTCAGTCACA"	"Cyst.TAL_2"
"CCTCAACAGCTCCCTT"	"Cyst.TAL_2"
"CCTCAACCAACTCGTA"	"Cyst.PT_2"
"CCTCAACCACATGAAA"	"Cyst.TAL_2"
"CCTCAACGTAACAGGC"	"Cyst.PT_1"
"CCTCACAAGGTGCCTC"	"vSMC"
"CCTCACAAGTCAGCCC"	"Cyst.PT_1"
"CCTCACAGTGATAGAT"	"Fibroblast"
"CCTCACAGTGGACAGT"	"Cyst.PT_1"
"CCTCACATCCTCATAT"	"Cyst.TAL_1"
"CCTCACATCGTTTACT"	"Podocytes"
"CCTCACATCTTAATCC"	"Cyst.PT_1"
"CCTCAGTAGACCATGG"	"Cyst.PT_2"
"CCTCAGTAGTTTGGCT"	"Cyst.TAL_2"
"CCTCAGTCACCCTAAA"	"vSMC"
"CCTCAGTCACGCGGTT"	"Cyst.PT_2"
"CCTCAGTCATATGAAG"	"Cyst.PT_2"
"CCTCAGTGTACTGACT"	"Cyst.TAL_1"
"CCTCAGTGTTCAACGT"	"Cyst.PT_3"
"CCTCAGTTCATTGTGG"	"Cyst.PT_2"
"CCTCATGCAATAGGAT"	"Cyst.PT_3"
"CCTCATGCACCCAAGC"	"EC"
"CCTCATGCAGACGATG"	"Cyst.PT_2"
"CCTCATGCATGTCAGT"	"vSMC"
"CCTCATGGTGGGAGAG"	"Cyst.PT_1"
"CCTCATGTCAAATGAG"	":LowQual"
"CCTCATGTCTCGGTCT"	"Unk_2"
"CCTCATGTCTGCTCTG"	"Unk_2"
"CCTCCAACATGTGACT"	"Cyst.TAL_1"
"CCTCCAAGTAGCCAGA"	"Cyst.PT_1"
"CCTCCAAGTCTAACGT"	"Cyst.TAL_2"
"CCTCCAAGTTCGTGCG"	"Cyst.PT_1"
"CCTCCAATCCCGAGGT"	"Podocytes"
"CCTCCTCAGACCAACG"	"Cyst.TAL_2"
"CCTCCTCAGTAGGCCA"	"Cyst.PT_2"
"CCTCCTCCAAGATGGC"	"Cyst.PT_3"
"CCTCCTCCAAGGTCGA"	"Cyst.PT_2"
"CCTCCTCCAGCGTGCT"	"Cyst.PT_1"
"CCTCCTCTCACTGGGC"	"Cyst.PT_1"
"CCTCCTCTCCGCACTT"	"vSMC"
"CCTCTAGAGCGTTCAT"	"Cyst.PT_2"
"CCTCTAGCAATAGGAT"	"Cyst.PT_2"
"CCTCTAGGTTGCCATA"	"Cyst.PT_2"
"CCTCTAGGTTGTTGCA"	"Cyst.PT_1"
"CCTCTAGTCTAGTTCT"	"Cyst.TAL_1"
"CCTCTCCAGCTGAGTG"	"Cyst.PT_1"
"CCTCTCCAGTCCGTCG"	"Cyst.PT_1"
"CCTCTCCAGTGTTCCA"	"Cyst.PT_3"
"CCTCTCCCAGAACGCA"	"EC"
"CCTCTCCCATCGGATT"	"Cyst.PT_1"
"CCTCTCCGTAGCGATG"	"Cyst.PT_1"
"CCTCTCCGTGATTGGG"	"Cyst.PT_1"
"CCTCTCCGTGCATTTG"	"Cyst.TAL_1"
"CCTCTCCGTTTGGGAG"	"Cyst.PT_1"
"CCTCTCCTCGCCGTGA"	"EC"
"CCTCTCCTCGCGTCGA"	"Cyst.TAL_1"
"CCTCTCCTCGGCAGTC"	"Cyst.PT_2"
"CCTCTCCTCTAAGCGT"	"Cyst.PT_2"
"CCTCTCCTCTCAACGA"	"Cyst.PT_2"
"CCTGCATAGAATCGCG"	"Cyst.TAL_1"
"CCTGCATAGCGTGAGT"	"Cyst.PT_3"
"CCTGCATAGTGTTGTC"	"EC"
"CCTGCATCACCCAATA"	"Cyst.PT_1"
"CCTGCATTCTACTATC"	"Cyst.TAL_1"
"CCTGTTGAGGTATCTC"	"Cyst.PT_2"
"CCTGTTGCAGCCGTTG"	"Cyst.PT_3"
"CCTGTTGGTTATCTTC"	"Cyst.PT_2"
"CCTGTTGTCCACAAGT"	"Cyst.TAL_2"
"CCTTCAGAGGAGTACC"	"Cyst.PT_1"
"CCTTCAGAGTAATACG"	"Cyst.PT_1"
"CCTTCAGCAGGACTAG"	"Cyst.PT_1"
"CCTTCAGCAGTTGAAA"	"Cyst.PT_3"
"CCTTCAGGTATGAAGT"	"Cyst.PT_1"
"CCTTCAGGTATGAGCG"	"Cyst.PT_1"
"CCTTCAGGTCCACACG"	"Cyst.TAL_1"
"CCTTCAGTCACCTACC"	"Cyst.PT_2"
"CCTTCAGTCATGCTAG"	"Mac"
"CCTTCAGTCTAGCATG"	"Cyst.PT_2"
"CCTTCAGTCTTCACAT"	"Cyst.PT_3"
"CCTTGTGAGCTTTCCC"	"Cyst.TAL_1"
"CCTTGTGAGTAGTGCG"	"Cyst.PT_2"
"CCTTGTGAGTATGACA"	"Cyst.PT_1"
"CCTTGTGAGTTGCTCA"	"Cyst.PT_1"
"CCTTGTGCAATGGCCC"	"Fibroblast"
"CCTTGTGGTGCGACAA"	"Cyst.PT_1"
"CCTTGTGTCACACGAT"	"Cyst.PT_2"
"CCTTGTGTCACTACGA"	"Cyst.PC"
"CCTTTGGAGCGATGAC"	"Cyst.PT_1"
"CCTTTGGAGCGATTCT"	"Cyst.PC"
"CCTTTGGAGTACCATC"	"Cyst.IC-A1"
"CCTTTGGCAACTTGGT"	"Cyst.TAL_2"
"CCTTTGGGTCTTAGTG"	"Cyst.TAL_1"
"CCTTTGGGTGATACAA"	"Cyst.PT_2"
"CCTTTGGGTGTATTGC"	"Cyst.PT_1"
"CCTTTGGTCATTGTGG"	"Cyst.PT_1"
"CCTTTGGTCCATTGCC"	"Cyst.TAL_2"
"CCTTTGGTCCTCACGT"	"Podocytes"
"CCTTTGGTCTTTGCGC"	"Unk_2"
"CGAAGGAAGCCATTCA"	"Cyst.TAL_1"
"CGAAGGACAAGAGATT"	"Cyst.TAL_2"
"CGAAGGACATCAGCGC"	"Cyst.TAL_2"
"CGAAGGAGTTATAGAG"	"Cyst.PT_3"
"CGAAGTTAGGTCATCT"	"Cyst.TAL_2"
"CGAAGTTCAATCAGCT"	"Cyst.TAL_2"
"CGAAGTTGTACACGCC"	"Cyst.PT_3"
"CGAATTGCAAATGGCG"	"Cyst.PT_1"
"CGAATTGCAGGAATAT"	"Cyst.PT_1"
"CGAATTGTCTCACCCA"	"Cyst.TAL_1"
"CGACAGCAGGGCAAGG"	"Fibroblast"
"CGACAGCCAAGCTACT"	"Podocytes"
"CGACAGCCAATAGGGC"	"Cyst.PT_1"
"CGACAGCCACCACATA"	"EC"
"CGACAGCCATGGAAGC"	"Cyst.TAL_2"
"CGACAGCGTACATACC"	"vSMC"
"CGACAGCGTCACGTGC"	"Cyst.PT_1"
"CGACAGCGTCCTCCTA"	"Cyst.PT_2"
"CGACAGCGTTTGGCTA"	"Cyst.PT_2"
"CGACAGCTCCGGTTCT"	"Cyst.PC"
"CGACAGCTCGCATTGA"	"Cyst.PT_2"
"CGAGAAGAGAGTTCGG"	"Cyst.TAL_2"
"CGAGAAGAGCACAAAT"	"Cyst.TAL_1"
"CGAGAAGAGCTGCCAC"	"Cyst.PT_1"
"CGAGAAGCAGCTGTGC"	"Cyst.TAL_1"
"CGAGAAGCAGTGGTGA"	"Podocytes"
"CGAGAAGGTGAACCGA"	"Cyst.TAL_2"
"CGAGGAAAGTAGACAT"	"Cyst.TAL_1"
"CGAGGAAAGTGCACTT"	"Cyst.PT_2"
"CGAGGAACAAATACGA"	"Cyst.PT_2"
"CGAGGAACACAGAGCA"	"Cyst.PT_1"
"CGAGGAAGTCAGGCAA"	":LowQual"
"CGAGGAAGTTACGTAC"	"Cyst.PT_1"
"CGAGGAAGTTAGGACG"	"Cyst.TAL_1"
"CGAGGCTCAGATCATC"	"Cyst.TAL_2"
"CGAGGCTGTATGAGGC"	"Cyst.TAL_1"
"CGAGGCTGTCAACCTA"	"Cyst.TAL_2"
"CGAGGCTTCCACGGAC"	"Cyst.TAL_2"
"CGAGGCTTCGGAGATG"	"Cyst.PT_2"
"CGAGTGCAGCCTAGGA"	"Mac"
"CGAGTGCAGCGACTAG"	"Cyst.PT_1"
"CGAGTGCAGGGCAGAG"	"Mac"
"CGAGTGCCACTAACGT"	"Cyst.PT_1"
"CGAGTGCCATGGAACG"	":LowQual"
"CGAGTGCGTAGATTGA"	"Fibroblast"
"CGAGTGCGTTTCCAAG"	"vSMC"
"CGAGTGCTCAAAGGTA"	"Cyst.TAL_2"
"CGAGTTAAGACCTTTG"	"Cyst.PT_1"
"CGAGTTAAGAGGTTTA"	"Cyst.PC"
"CGAGTTAAGGAACTAT"	"Cyst.PT_1"
"CGAGTTAAGTCATAGA"	"Cyst.PT_3"
"CGAGTTAAGTGCCAGA"	"Cyst.TAL_2"
"CGAGTTACAGGCGAAT"	"Cyst.PT_3"
"CGAGTTAGTTCGGTAT"	"Cyst.PT_1"
"CGAGTTATCCCAGGAC"	"Cyst.PC"
"CGAGTTATCGAGGCAA"	"Cyst.PT_1"
"CGAGTTATCGTCCATC"	"Cyst.PT_3"
"CGAGTTATCTTCGTGC"	"Mac"
"CGATCGGAGATGATTG"	"Mac"
"CGATCGGCACGAGGAT"	"Cyst.PT_2"
"CGATCGGGTAATGCTC"	"Cyst.PT_1"
"CGATCGGGTATGAGAT"	"Cyst.TAL_1"
"CGATCGGGTTGTAAAG"	"Cyst.PT_1"
"CGATCGGTCACCATAG"	"Cyst.TAL_2"
"CGATCGGTCTGCTGAA"	"Cyst.PT_1"
"CGATCGGTCTTCCCAG"	"Cyst.TAL_2"
"CGATGCGCATCATGAC"	"Cyst.PT_1"
"CGATGCGCATGAATAG"	"Cyst.TAL_1"
"CGATGCGGTACTGACT"	"Cyst.PT_3"
"CGATGCGGTCATACCA"	"Cyst.TAL_1"
"CGATGCGGTGTGAGCA"	"Cyst.IC-A1"
"CGATGCGTCTCTCAAT"	"Cyst.PT_1"
"CGATGGCAGGTAGCCA"	"Cyst.PT_2"
"CGATGGCCAGCAGTGA"	"Cyst.PT_2"
"CGATGGCTCACAACCA"	"Cyst.TAL_2"
"CGATGGCTCAGGACGA"	"Cyst.PC"
"CGATGGCTCGCAGTCG"	"Unk_1"
"CGCAGGTAGAGTGACC"	"Cyst.PT_3"
"CGCAGGTGTTTCAGAC"	"Cyst.PT_1"
"CGCAGGTTCCTCTCTT"	"Cyst.TAL_2"
"CGCATAAGTAGGCAGT"	"Cyst.PT_1"
"CGCATAAGTTAACCTG"	"Cyst.TAL_2"
"CGCATAATCACAGAGG"	"Cyst.PT_2"
"CGCATAATCTTCCAGC"	"Cyst.PT_2"
"CGCATGGAGACGACTG"	"Cyst.PT_2"
"CGCATGGGTGCCTACG"	"Cyst.PT_2"
"CGCATGGTCCACACCT"	"Cyst.PT_1"
"CGCATGGTCTAGGAAA"	"Cyst.PT_2"
"CGCATGGTCTGAATCG"	"Cyst.PT_2"
"CGCCAGAAGCTGAAGC"	"Cyst.PT_1"
"CGCCAGACACTACAGT"	"Unk_2"
"CGCCAGACAGCACAGA"	"Cyst.PT_2"
"CGCCAGACAGTATTCG"	"Mac"
"CGCCAGAGTAGAGTTA"	"Cyst.TAL_1"
"CGCCAGAGTCTACAGT"	"Cyst.TAL_1"
"CGCCAGATCTAGACCA"	"Cyst.PT_3"
"CGCCAGATCTCGCTTG"	"Cyst.TAL_1"
"CGCCATTAGATTGACA"	"Cyst.TAL_2"
"CGCCATTAGCTAAGTA"	"Cyst.PT_1"
"CGCCATTAGGCATCTT"	"Unk_2"
"CGCCATTAGGTCGCCT"	"Cyst.PT_3"
"CGCCATTCATGGGATG"	"Cyst.TAL_1"
"CGCCATTTCTGCTTTA"	"Cyst.PT_2"
"CGCGTGAAGCGACCCT"	"Cyst.PT_1"
"CGCGTGAAGGGAGATA"	"Cyst.PT_1"
"CGCGTGACACAATGCT"	"Cyst.PT_2"
"CGCGTGACATTAAAGG"	"Cyst.PT_1"
"CGGAACCAGATTGGGC"	"Cyst.PT_1"
"CGGAACCCAAGAAACT"	"Cyst.PT_3"
"CGGAACCGTGAGACCA"	"Cyst.PT_1"
"CGGAACCGTTAAGTCC"	"Cyst.PT_1"
"CGGAACCTCCTTGACC"	"Cyst.PT_1"
"CGGAACCTCTTAGGAC"	"Cyst.TAL_1"
"CGGAATTAGCAAGGAA"	"Cyst.PT_1"
"CGGAATTGTTCTCACC"	"Cyst.PT_2"
"CGGAATTTCATGGATC"	"Cyst.PT_2"
"CGGACACAGATCGCCC"	"Mac"
"CGGACACCAACAGAGC"	"Cyst.TAL_1"
"CGGACACCAAGAGGCT"	"EC"
"CGGACACCACGTACTA"	"EC"
"CGGACACCAGGGTCTC"	"Cyst.PC"
"CGGACACGTTGCGTAT"	"Cyst.PT_3"
"CGGACACTCAAGAGGC"	"Cyst.IC-A1"
"CGGACACTCGCTGCGA"	"Cyst.PT_1"
"CGGAGAAAGGCTTAAA"	"Cyst.PT_1"
"CGGAGAACACCAGTAT"	"Cyst.PT_3"
"CGGAGAACAGCGGATA"	"Cyst.PT_2"
"CGGAGAAGTGCCAAGA"	"Cyst.TAL_1"
"CGGCAGTAGGCGTTGA"	"Cyst.PT_2"
"CGGCAGTAGGCTAACG"	"Cyst.ATL"
"CGGCAGTCACCCATAA"	"Cyst.TAL_1"
"CGGCAGTCAGAGAATT"	"Cyst.PT_1"
"CGGCAGTCATGTGACT"	"Cyst.PT_1"
"CGGCAGTGTCGAATTC"	"Cyst.TAL_1"
"CGGCAGTGTGATTCTG"	"Cyst.PT_1"
"CGGCAGTTCCCGAATA"	"Cyst.TAL_2"
"CGGCAGTTCCCGAGAC"	"Cyst.PT_3"
"CGGGACTAGAGTTGAT"	"Cyst.PT_1"
"CGGGACTAGGTTTGAA"	"Cyst.PT_1"
"CGGGACTCAGGACTAG"	"Cyst.TAL_2"
"CGGGCATAGCATCCTA"	"Cyst.TAL_2"
"CGGGCATGTACTAACC"	"Cyst.TAL_2"
"CGGGTCACAAGTGGTG"	"Cyst.PC"
"CGGGTCACACTAGGCC"	"Cyst.PT_2"
"CGGGTCAGTAATGTGA"	"Cyst.PT_1"
"CGGGTGTAGCACCCAC"	"Cyst.TAL_1"
"CGGGTGTAGGCCCACT"	"Cyst.PT_2"
"CGGGTGTCACATACGT"	"Cyst.TAL_2"
"CGGGTGTCATAGGCGA"	"Cyst.TAL_1"
"CGGGTGTTCAACCTTT"	"Cyst.PT_2"
"CGGGTGTTCTCAGGCG"	"Cyst.PT_2"
"CGGTCAGAGCCTCCAG"	"vSMC"
"CGGTCAGCATCTCGTC"	"Cyst.PT_1"
"CGGTCAGTCCGACATA"	"Cyst.PT_3"
"CGGTCAGTCGGTTGTA"	"Mac"
"CGTAAGTAGAGGCGTT"	"Cyst.TAL_2"
"CGTAAGTCAATTCTCT"	":LowQual"
"CGTAAGTGTGGCGCTT"	"Cyst.PT_2"
"CGTAAGTTCATCAGTG"	"Fibroblast"
"CGTAAGTTCGTTATCT"	"Cyst.PT_3"
"CGTAATGCAAGAAACT"	"Cyst.PT_1"
"CGTAATGCACAAGTTC"	"Cyst.PT_1"
"CGTAATGGTCGAGATG"	"Cyst.PC"
"CGTAATGGTTGCAAGG"	"EC"
"CGTAATGTCAGCCTCT"	"Cyst.PT_1"
"CGTAGTAGTCCAACGC"	"EC"
"CGTAGTAGTCCTGAAT"	"Cyst.PT_1"
"CGTAGTAGTTGTTGCA"	"T-cell"
"CGTAGTATCAAGCGTT"	"Cyst.PT_1"
"CGTAGTATCTCATTGT"	"Fibroblast"
"CGTCAAAAGTCTGCAT"	"Cyst.PT_3"
"CGTCAAAAGTGAGGCT"	"Cyst.PT_2"
"CGTCAAAGTCGAAACG"	"Cyst.PT_1"
"CGTCAAATCAAGGAGC"	"Cyst.PC"
"CGTCAAATCGCGGACT"	"Cyst.PT_1"
"CGTCCATAGAAGCGGG"	"Cyst.PT_1"
"CGTCCATAGCACCGAA"	"Cyst.PT_3"
"CGTCCATCACACCGAC"	"Cyst.TAL_1"
"CGTCCATCACGTACAT"	"Cyst.ATL"
"CGTCCATGTGCCTACG"	"Cyst.PT_2"
"CGTCCATTCAGGTGTT"	"Cyst.PT_2"
"CGTGAATAGTCGGCAA"	"Cyst.PT_3"
"CGTGAATGTAGGTCAG"	"vSMC"
"CGTGAATTCACGGGCT"	"Cyst.TAL_2"
"CGTGATAAGCGAATGC"	"Cyst.PT_3"
"CGTGATACACGCACCA"	"vSMC"
"CGTGATATCCCTGGTT"	"Cyst.PT_1"
"CGTGCTTAGGAAAGGT"	"Cyst.PT_2"
"CGTGCTTCAGCATACT"	"Cyst.PT_3"
"CGTGCTTGTCGAGCTC"	"Cyst.PT_1"
"CGTGCTTGTGAGTTGG"	"Cyst.PT_1"
"CGTGCTTTCACCACAA"	"T-cell"
"CGTGTCTAGAGGATGA"	"Cyst.TAL_1"
"CGTGTCTCAGACAAGC"	"Cyst.PT_1"
"CGTGTCTGTAGGTGCA"	"Cyst.TAL_1"
"CGTGTCTGTCAAAGAT"	"Cyst.TAL_1"
"CGTGTCTGTGGCTTGC"	"Cyst.TAL_1"
"CGTGTCTTCACCTGTC"	"vSMC"
"CGTTAGAAGGCGAAGG"	"Cyst.TAL_1"
"CGTTAGATCCACAGGC"	"Cyst.PT_3"
"CGTTAGATCTACACAG"	"Cyst.TAL_1"
"CGTTAGATCTATGCCC"	"Unk_1"
"CGTTCTGAGAGTCACG"	"Cyst.PT_3"
"CGTTCTGCACAATCTG"	"Mac"
"CGTTCTGCACACCGAC"	"vSMC"
"CGTTCTGCATAATCGC"	"Mac"
"CGTTCTGCATGGCACC"	"Cyst.PT_2"
"CGTTCTGGTAGACTGG"	"Cyst.PT_3"
"CGTTCTGGTCTTTCTA"	"Cyst.PC"
"CGTTGGGGTACCATAC"	"Cyst.PT_1"
"CGTTGGGGTTCTCTCG"	"Cyst.TAL_1"
"CTAACCCAGACTGGGT"	"Cyst.PT_2"
"CTAACCCCATCATCCC"	"Cyst.PT_2"
"CTAACCCGTGTGTCCG"	"Cyst.PT_3"
"CTAACCCTCGCCTCTA"	"Cyst.PT_3"
"CTAACTTAGCAAGGAA"	"vSMC"
"CTAACTTAGTCGCCAC"	"Fibroblast"
"CTAACTTCAGAACCGA"	"Cyst.PT_2"
"CTAACTTGTATCGCAT"	"Cyst.TAL_2"
"CTAACTTGTGGAATGC"	"Cyst.PT_1"
"CTAACTTGTGTCCACG"	"Cyst.PT_2"
"CTAACTTTCTTGGGCG"	"EC"
"CTAAGTGAGGTGGTTG"	"Cyst.PT_2"
"CTAAGTGCACATAACC"	"Cyst.PT_3"
"CTAAGTGCAGGCTATT"	":LowQual"
"CTAAGTGCAGTCTTCC"	"Cyst.PT_3"
"CTAAGTGGTCAACGCC"	"Cyst.TAL_1"
"CTAAGTGGTCATCTAG"	"Cyst.PT_2"
"CTAAGTGGTTTACTTC"	"Unk_2"
"CTAAGTGTCCCTCTAG"	"Cyst.PT_1"
"CTACAGACAATAGGAT"	"Cyst.ATL"
"CTACAGACATATGGCT"	"Cyst.PT_1"
"CTACAGAGTACACGTT"	"Cyst.PT_2"
"CTACAGAGTGTGTTTG"	"Cyst.TAL_1"
"CTACAGAGTTATTCTC"	"Cyst.TAL_2"
"CTACAGAGTTCAAAGA"	"Cyst.PT_2"
"CTACAGATCAGCCTTC"	"Cyst.TAL_1"
"CTACAGATCCATGCAA"	"Cyst.PT_2"
"CTACATTAGTTAACAG"	"Cyst.PT_1"
"CTACATTCACCAGTAT"	"Fibroblast"
"CTACATTCACGTAACT"	"Cyst.TAL_2"
"CTACATTCAGAAGCTG"	"Cyst.TAL_1"
"CTACATTCAGACACCC"	"Cyst.TAL_1"
"CTACATTGTAGAGGAA"	"Fibroblast"
"CTACATTGTGCGGATA"	"vSMC"
"CTACATTTCGAGAATA"	"Podocytes"
"CTACCCACACACGTGC"	"Podocytes"
"CTACCCAGTCTAGATC"	"T-cell"
"CTACCCAGTGCGAACA"	"Cyst.PT_1"
"CTACCCATCTGCCCTA"	"Cyst.PC"
"CTACCCATCTTGAGCA"	"Cyst.PT_1"
"CTACCTGGTACGGTTT"	"Cyst.TAL_1"
"CTACCTGTCGGTCATA"	"Cyst.TAL_1"
"CTACGGGAGTTTGGCT"	"Unk_1"
"CTACGGGCAAGCCCAC"	"Cyst.PT_2"
"CTACGGGCATGTCAGT"	"Cyst.PC"
"CTACGGGCATTCAGGT"	"Cyst.PT_1"
"CTACGGGGTGTAGGAC"	"Cyst.TAL_2"
"CTACGGGTCAATCCGA"	"Cyst.TAL_2"
"CTACGGGTCGTGGCGT"	"Cyst.PC"
"CTACGGGTCTACGGTA"	"Cyst.PT_2"
"CTACGGGTCTCAGGCG"	"Fibroblast"
"CTACTATAGAAAGTCT"	"Cyst.TAL_1"
"CTACTATAGCACCCAC"	"Cyst.TAL_1"
"CTACTATGTGGTATGG"	"INT"
"CTACTATTCTATCGGA"	"Cyst.PC"
"CTAGACAAGCCTCTCT"	"Cyst.TAL_1"
"CTAGACAAGCTAAGTA"	"Cyst.TAL_1"
"CTAGACAAGGTTGGAC"	"Cyst.PT_2"
"CTAGACAAGTAAACAC"	"Cyst.TAL_2"
"CTAGACACAATGTCTG"	"vSMC"
"CTAGACACACGGCCAT"	"Cyst.PT_2"
"CTAGACAGTCTGATCA"	"Cyst.PT_3"
"CTAGACAGTCTTGAGT"	"Cyst.PT_3"
"CTAGACATCCGGACTG"	"Cyst.TAL_2"
"CTAGGTAAGTCACAGG"	"Cyst.PT_2"
"CTAGGTACAAGCCATT"	"Cyst.PT_3"
"CTAGGTAGTTCTTAGG"	"Cyst.TAL_2"
"CTAGGTATCTTTGCTA"	"Cyst.TAL_1"
"CTATAGGCAAAGAACT"	"Unk_1"
"CTATAGGCAATTCGTG"	"vSMC"
"CTATAGGGTACAAACA"	"Cyst.TAL_2"
"CTATAGGGTATGACAA"	"Cyst.PT_1"
"CTATAGGGTCCAACGC"	"Cyst.PT_1"
"CTATAGGGTCGAACAG"	"vSMC"
"CTATCCGAGTAATTGG"	"Cyst.PT_1"
"CTATCCGAGTAGAATC"	"Cyst.PT_2"
"CTATCCGCACAGCTGC"	"Cyst.TAL_1"
"CTATCCGCATAATGAG"	"Cyst.PT_1"
"CTATCCGCATATCGGT"	"Cyst.TAL_1"
"CTATCCGGTAGAATGT"	"Cyst.TAL_1"
"CTATCTAAGCTGGAGT"	"Cyst.PT_1"
"CTATCTACACCTCTGT"	"Cyst.TAL_2"
"CTATCTAGTAACACGG"	"Cyst.PT_1"
"CTATCTAGTTCCTTGC"	"Cyst.PT_3"
"CTATCTATCGCATTAG"	"Cyst.PT_2"
"CTATCTATCTGAGATC"	"Cyst.PT_2"
"CTCAACCAGTTGAAGT"	"Cyst.PT_1"
"CTCAACCCAACCCTCT"	"Mac"
"CTCAACCCATTGAAGA"	"Cyst.PC"
"CTCAACCGTCATCAGT"	"Fibroblast"
"CTCAACCGTTAATCGC"	"vSMC"
"CTCAACCTCTCACGAA"	"Cyst.PT_1"
"CTCAACCTCTGGTCAA"	"Cyst.PC"
"CTCAAGACAAACTCTG"	"Podocytes"
"CTCAAGACATACTTTC"	"EC"
"CTCAAGAGTTAGGGAC"	"Cyst.PT_2"
"CTCAAGAGTTCGTGCG"	"Cyst.TAL_2"
"CTCAATTAGATGGGCT"	"Cyst.PT_2"
"CTCAATTAGGTCCTGC"	"Cyst.TAL_2"
"CTCAATTCAAGCACCC"	"Cyst.PT_3"
"CTCAATTGTCTTGCGG"	"Cyst.TAL_1"
"CTCAATTGTGATTCTG"	"Cyst.PT_3"
"CTCAATTTCGTTCCCA"	"Cyst.PT_2"
"CTCACTGAGACATGCG"	"T-cell"
"CTCACTGAGACTCTAC"	"Cyst.PT_1"
"CTCACTGAGATAGCTA"	"Cyst.TAL_2"
"CTCACTGCACAGCATT"	"Cyst.TAL_2"
"CTCACTGCACAGCTGC"	"Fibroblast"
"CTCACTGCACGAGGTA"	"Unk_1"
"CTCACTGCACTAAACC"	"Cyst.TAL_1"
"CTCACTGCATCATTGG"	"Cyst.TAL_1"
"CTCACTGGTGGTACAG"	"Cyst.PT_1"
"CTCACTGGTGTCATGT"	"Cyst.PT_2"
"CTCACTGGTGTGAATA"	"Cyst.IC-A1"
"CTCAGAACAAGCACAG"	"EC"
"CTCAGAAGTGGATGAC"	"Cyst.TAL_1"
"CTCAGAAGTGTCCCTT"	"Cyst.PT_3"
"CTCAGAAGTTTACGTG"	"Fibroblast"
"CTCAGAAGTTTCAGAC"	"Cyst.TAL_2"
"CTCAGGGAGGAAACGA"	"Cyst.PT_1"
"CTCAGGGAGGACATCG"	"Cyst.PT_1"
"CTCAGGGCAATGAACA"	"EC"
"CTCAGGGCATAGATCC"	"Cyst.TAL_2"
"CTCAGGGGTACGAGCA"	"Cyst.PT_1"
"CTCAGGGGTAGCACAG"	"Cyst.PT_1"
"CTCAGGGGTATTGGCT"	"Cyst.PT_1"
"CTCAGGGTCAACGCTA"	"Fibroblast"
"CTCAGGGTCCTCATAT"	"Cyst.PT_2"
"CTCAGTCAGCATTTGC"	"Cyst.PT_1"
"CTCAGTCAGTAGCAAT"	"Cyst.PT_3"
"CTCAGTCCAACAGATA"	"Cyst.PT_3"
"CTCAGTCCAGCGTGAA"	"Cyst.PT_1"
"CTCAGTCCAGGACGAT"	"Cyst.TAL_2"
"CTCAGTCGTAAGGCCA"	"Cyst.PT_3"
"CTCAGTCGTGCTCTCT"	"Cyst.PT_1"
"CTCAGTCGTTTACACG"	"Cyst.PT_2"
"CTCAGTCTCACTGATG"	"Cyst.TAL_1"
"CTCAGTCTCAGCCCAG"	"Cyst.PT_2"
"CTCAGTCTCGACTCCT"	"Mac"
"CTCATCGAGACTACCT"	"Cyst.TAL_1"
"CTCATCGCAAAGCGTG"	"Cyst.PT_2"
"CTCATCGCAGATCCTA"	"Cyst.PT_1"
"CTCATCGCATGTGCCG"	"Cyst.TAL_2"
"CTCATGCTCAACCTCC"	"Cyst.PT_1"
"CTCATGCTCTAAGGAA"	"vSMC"
"CTCATGCTCTTAGCTT"	"Unk_2"
"CTCATTAAGTCGCGAA"	"Cyst.TAL_1"
"CTCATTAAGTGCGCTC"	"Cyst.PT_3"
"CTCATTACAGAACGCA"	"Cyst.PT_3"
"CTCATTACAGGACTTT"	"Cyst.TAL_2"
"CTCATTACAGTCGGAA"	"Cyst.PT_2"
"CTCATTACATCACCAA"	"Cyst.PT_3"
"CTCATTACATCGATAC"	"Cyst.PT_2"
"CTCATTAGTAGAATAC"	"Cyst.PT_3"
"CTCATTAGTGGTATGG"	"Cyst.TAL_1"
"CTCATTAGTTGACGGA"	"Cyst.TAL_2"
"CTCCAACAGCGAATGC"	"Cyst.PT_3"
"CTCCAACCAAACAGGC"	"EC"
"CTCCAACCAGCGTGCT"	"Cyst.TAL_1"
"CTCCAACCATCGGCCA"	"Cyst.PT_1"
"CTCCAACGTCCACTCT"	"EC"
"CTCCAACGTCTCCTGT"	"Cyst.PT_2"
"CTCCACAAGCTAGATA"	"Cyst.TAL_2"
"CTCCACAAGGTAGACC"	"Cyst.TAL_2"
"CTCCACACAATGAGCG"	"Cyst.PT_1"
"CTCCACACATGTTTGG"	"Cyst.PT_3"
"CTCCACAGTCGAGTTT"	"Cyst.TAL_1"
"CTCCACATCACTGGGC"	"Cyst.TAL_2"
"CTCCACATCCAACACA"	"Cyst.PT_2"
"CTCCATGAGCATCAGG"	"Cyst.PC"
"CTCCATGCAAAGACGC"	"Cyst.PT_2"
"CTCCATGCACACCTAA"	"EC"
"CTCCATGCACGCCAGT"	"Cyst.PT_1"
"CTCCATGCAGAACTAA"	"Cyst.PT_3"
"CTCCATGGTCCGCAGT"	"Cyst.PT_1"
"CTCCATGGTTTGGAGG"	"Cyst.PT_2"
"CTCCATGTCCGTGACG"	"T-cell"
"CTCCCAACAAATTAGG"	"vSMC"
"CTCCCAACAGGTATGG"	"Cyst.TAL_1"
"CTCCCAACAGTAGATA"	"Cyst.PT_1"
"CTCCCAAGTCAGTTTG"	"Cyst.PT_2"
"CTCCCAATCCGTGACG"	"Cyst.TAL_1"
"CTCCCTCCAAAGAGTT"	"Cyst.PT_3"
"CTCCCTCGTCGTACAT"	"Cyst.TAL_2"
"CTCCCTCTCCGAACGC"	"Cyst.PT_2"
"CTCCGATAGGCTGGAT"	"Cyst.TAL_2"
"CTCCGATGTATTAAGG"	"Cyst.TAL_2"
"CTCCGATTCCCTTGGT"	"Cyst.PT_1"
"CTCCGATTCTACTCAT"	"Cyst.TAL_1"
"CTCCTCCCAAGTAGTA"	"Cyst.PT_1"
"CTCCTCCCAATGCAGG"	"Cyst.PT_2"
"CTCCTCCCACGCCAGT"	"Cyst.PT_1"
"CTCCTCCCACTGTGTA"	"vSMC"
"CTCCTCCGTCTGCGCA"	"Cyst.PT_2"
"CTCCTCCGTTACACTG"	"T-cell"
"CTCCTCCTCATTACCT"	"Cyst.PT_1"
"CTCCTCCTCGCTCTCA"	"Cyst.PC"
"CTCCTTTAGCGTTCAT"	"Cyst.TAL_2"
"CTCCTTTCAATACCTG"	"Cyst.TAL_1"
"CTCCTTTGTACGCTTA"	"EC"
"CTCCTTTGTCAGGAGT"	"Fibroblast"
"CTCCTTTGTTGTGCAT"	"Cyst.PT_2"
"CTCCTTTTCAGACCTA"	"Cyst.TAL_2"
"CTCCTTTTCATTTACC"	"Cyst.PT_2"
"CTCGAGGCAAGCGCAA"	"Cyst.PT_3"
"CTCGAGGTCGGAGATG"	"Fibroblast"
"CTCGAGGTCTCCGTGT"	"Cyst.TAL_2"
"CTCTCAGCAATCCTAG"	"Cyst.PT_1"
"CTCTCAGCAATTGGTC"	"Cyst.PT_2"
"CTCTCAGCAGAGTAAT"	"Cyst.PT_3"
"CTCTCAGCATCGATAC"	"Cyst.PC"
"CTCTCAGCATGTGGCC"	"Mac"
"CTCTCAGTCTGCTTTA"	"Cyst.TAL_1"
"CTCTCGAAGCTCCACG"	"Cyst.PT_2"
"CTCTCGACAAGGCCTC"	"Cyst.PT_1"
"CTCTCGACAGAACTCT"	"Cyst.TAL_1"
"CTCTCGAGTACGTACT"	"vSMC"
"CTCTCGAGTCCTCAGG"	"EC"
"CTCTCGAGTTGCTGAT"	"Cyst.TAL_1"
"CTCTCGATCATCCCGT"	"Cyst.PT_1"
"CTCTGGTAGAGCAGAA"	"Cyst.PT_2"
"CTCTGGTGTGGACCAA"	"Cyst.PT_2"
"CTCTGGTTCTAGCCTC"	"vSMC"
"CTGAATGAGAGCCTGA"	"vSMC"
"CTGAATGCAGAACGCA"	"Cyst.TAL_1"
"CTGAATGGTGGCTTGC"	"Cyst.TAL_1"
"CTGAATGGTGTTCATG"	"Cyst.ATL"
"CTGAATGGTTATCTTC"	"Cyst.PT_2"
"CTGAATGTCGACATTG"	"Cyst.ATL"
"CTGAATGTCGCTCTCA"	"Cyst.PT_3"
"CTGAATGTCGTTAGTG"	"EC"
"CTGAGCGAGATCACCT"	"Cyst.TAL_1"
"CTGAGCGAGGCTTAGG"	"Cyst.PT_1"
"CTGAGCGAGTCTAACC"	"Cyst.PC"
"CTGAGCGCAATAGTAG"	"Cyst.PT_2"
"CTGAGCGCAGTAACCT"	"Cyst.PT_1"
"CTGAGCGGTGACATCT"	"Cyst.PT_1"
"CTGAGCGTCCATACAG"	"Cyst.PT_1"
"CTGAGCGTCCGGACGT"	"Cyst.PT_2"
"CTGAGGCCAGTATGAA"	"Cyst.PT_2"
"CTGAGGCCATTGCAAC"	"vSMC"
"CTGAGGCGTGATTAGA"	"Cyst.PT_1"
"CTGAGGCTCATTGCTT"	"Cyst.PT_1"
"CTGAGGCTCGCTGTTC"	"Cyst.PT_3"
"CTGATCCCAGATAAAC"	"Cyst.PT_2"
"CTGATCCGTATCCCTC"	"Cyst.TAL_2"
"CTGATCCGTCCAGCCA"	"Cyst.PT_3"
"CTGATCCTCTTTGATC"	"Cyst.PT_3"
"CTGCAGGCACATACTG"	"Cyst.TAL_1"
"CTGCAGGCACGGCGTT"	"INT"
"CTGCAGGGTTCGGACC"	"Cyst.PT_2"
"CTGCATCCAGCAGACA"	"Cyst.PT_2"
"CTGCATCGTAGGACTG"	"Cyst.PT_1"
"CTGCATCTCCCTATTA"	"Cyst.TAL_2"
"CTGCATCTCCTCACGT"	"Cyst.TAL_1"
"CTGCATCTCGCATAGT"	"Cyst.PT_3"
"CTGCCATAGTTCACTG"	"Cyst.PT_2"
"CTGCCATCAAGGTTGG"	"Cyst.PT_1"
"CTGCCATCACCGCTGA"	"Cyst.PT_1"
"CTGCCATCATCCTTCG"	"Cyst.TAL_1"
"CTGCCATCATCGAAGG"	"Cyst.PT_2"
"CTGCCATCATTAGGCT"	"Cyst.TAL_1"
"CTGCCATGTCGGCTAC"	"Cyst.TAL_1"
"CTGCCATGTTTGTTCT"	"Cyst.PT_2"
"CTGCCATTCAACCGAT"	"Cyst.PT_3"
"CTGCCTAAGATGGCAC"	"Cyst.PT_2"
"CTGCCTAAGGTGCCAA"	"Cyst.PT_3"
"CTGCCTACAACCCGCA"	"Cyst.TAL_2"
"CTGCCTAGTTGTCATG"	"Cyst.PT_3"
"CTGCGAGAGGCATCAG"	"Fibroblast"
"CTGCGAGCAGACCTGC"	"Unk_1"
"CTGCGAGCAGGCGAAT"	"Cyst.TAL_1"
"CTGCGAGCATAAGCGG"	"Cyst.TAL_2"
"CTGCGAGCATGACACT"	"Cyst.PT_2"
"CTGCGAGTCAAAGGTA"	"Cyst.PT_1"
"CTGCGAGTCGAAGCCC"	"Cyst.PC"
"CTGCTCAAGGTTATAG"	"Cyst.PT_2"
"CTGCTCAAGTCTCCTC"	"Cyst.PT_3"
"CTGCTCACAAATGAGT"	"Cyst.PT_1"
"CTGCTCACAAGGCTTT"	"Cyst.TAL_2"
"CTGCTCAGTAACACCT"	"Cyst.PT_1"
"CTGCTCAGTAGTTAGA"	"Cyst.PT_1"
"CTGCTCAGTCAACACT"	"Cyst.TAL_2"
"CTGCTCATCCATAAGC"	"Fibroblast"
"CTGCTCATCCTTCTGG"	"Cyst.TAL_1"
"CTGGACGAGCCTCAAT"	"Cyst.PT_2"
"CTGGACGCAGACCAAG"	"Cyst.TAL_2"
"CTGGACGGTATCGATC"	"Cyst.TAL_2"
"CTGGACGGTCCAAAGG"	"Cyst.TAL_1"
"CTGGACGGTGGACCTC"	"Cyst.PT_1"
"CTGGACGTCTTCTAAC"	"Cyst.PT_3"
"CTGGCAGCAACAGCTT"	"vSMC"
"CTGGCAGCAATCTCTT"	"Cyst.TAL_1"
"CTGGCAGCACTCATAG"	"Cyst.IC-A1"
"CTGGCAGCAGCGTTGC"	"Cyst.PT_3"
"CTGGCAGCAGGACTAG"	"EC"
"CTGGCAGCATCGGAGA"	"Cyst.PT_1"
"CTGGCAGCATCGTCCT"	"Cyst.PT_1"
"CTGGCAGGTCTGCCTT"	"Mac"
"CTGGCAGGTTCGGCCA"	"vSMC"
"CTGGCAGTCGTCTCAC"	"Cyst.PT_2"
"CTGGTCTAGTCGTCTA"	"Cyst.PT_1"
"CTGGTCTGTTTGAAAG"	"EC"
"CTGGTCTTCACCCTGT"	"Cyst.PT_1"
"CTGTACCAGCGGTAGT"	"Cyst.PT_2"
"CTGTACCCATGAGAAT"	"Cyst.PT_1"
"CTGTACCGTAAGGCTG"	"Cyst.TAL_2"
"CTGTACCGTACACTCA"	"Cyst.PT_3"
"CTGTACCGTATGACAA"	"Cyst.TAL_1"
"CTGTACCTCAAGAGTA"	":LowQual"
"CTGTAGAAGAAACCAT"	"Cyst.PT_1"
"CTGTAGAAGAGTCTTC"	"Cyst.TAL_2"
"CTGTAGAAGCTCTATG"	"Cyst.PT_2"
"CTGTAGAAGGTACATA"	"Cyst.PT_1"
"CTGTAGAAGGTTTGAA"	"Cyst.PT_2"
"CTGTAGACACCCAATA"	"Cyst.ATL"
"CTGTAGACAGTAACAA"	"Cyst.TAL_1"
"CTGTAGACATAAGCGG"	"Cyst.PT_3"
"CTGTAGAGTTCCGCTT"	"Cyst.PT_1"
"CTGTAGATCATGCATG"	"Cyst.PT_2"
"CTGTAGATCGCAGATT"	"Cyst.PT_1"
"CTGTATTCAGCTTTGA"	"Cyst.PT_3"
"CTGTATTCATAGGAGC"	"T-cell"
"CTGTATTTCCTATGGA"	"Cyst.PT_3"
"CTGTATTTCTCTAAGG"	"T-cell"
"CTGTCGTAGTTTCGAC"	"Cyst.PC"
"CTGTCGTCAACCCTCT"	"Cyst.TAL_1"
"CTGTCGTGTCACAGTT"	"Cyst.PT_2"
"CTGTCGTTCAATCAGC"	"Cyst.TAL_1"
"CTGTCGTTCTTGGATG"	"Cyst.TAL_2"
"CTGTGAAAGACTGAGC"	":LowQual"
"CTGTGAAAGCCTTGAT"	"Cyst.PT_3"
"CTGTGAAAGGTTGCCC"	"Cyst.TAL_2"
"CTGTGAACACAGTGAG"	"Cyst.PT_3"
"CTGTGAAGTCTGGTTA"	"Cyst.PT_1"
"CTGTGAATCAAGCTGT"	"T-cell"
"CTGTGAATCGTTGTTT"	"Cyst.PC"
"CTGTGAATCTCTGACC"	"Cyst.PT_1"
"CTGTGGGAGCCTTTGA"	"Cyst.PT_2"
"CTGTGGGAGGAGAGTA"	":LowQual"
"CTGTGGGAGTCACGAG"	"Podocytes"
"CTGTGGGAGTTAGAAC"	"Cyst.TAL_2"
"CTGTGGGAGTTGGAAT"	"Cyst.TAL_1"
"CTGTGGGCAAGCTGTT"	"Cyst.PT_1"
"CTGTGGGCATGGCCCA"	"Cyst.TAL_2"
"CTGTGGGTCAGGAACG"	"Cyst.PT_2"
"CTTACCGAGACTACCT"	"Cyst.TAL_1"
"CTTACCGGTAGCTAAA"	"Cyst.PT_2"
"CTTACCGTCCGGCTTT"	"Cyst.PT_1"
"CTTACCGTCGAGTGAG"	"Cyst.PT_1"
"CTTACCGTCTGGTCAA"	":LowQual"
"CTTAGGAAGTGATAAC"	"Cyst.PT_1"
"CTTAGGACAAAGGATT"	"Cyst.PT_1"
"CTTAGGACAGAGGAAA"	"Cyst.PT_1"
"CTTAGGACAGGCTTGC"	"Cyst.TAL_2"
"CTTAGGAGTGCATGTT"	"Cyst.PT_1"
"CTTAGGATCAGCGCGT"	"Cyst.PT_3"
"CTTCAATAGCAAATCA"	"vSMC"
"CTTCAATAGCTACTGT"	"EC"
"CTTCAATAGGCCGCTT"	"Cyst.TAL_2"
"CTTCAATGTCGAACGA"	"T-cell"
"CTTCAATGTCGTCGGT"	"Cyst.TAL_1"
"CTTCAATGTGTCCCTT"	"vSMC"
"CTTCAATGTTAATCGC"	"Cyst.PT_3"
"CTTCAATGTTCCTTGC"	"Cyst.PT_2"
"CTTCAATGTTGGGAAC"	"Cyst.PT_1"
"CTTCCGAGTATAATGG"	"Cyst.TAL_1"
"CTTCCGAGTTGGACTT"	"Mac"
"CTTCCTTCAACATACC"	"Cyst.TAL_2"
"CTTCCTTGTCGCATTA"	"Cyst.PT_2"
"CTTCCTTTCAATCTCT"	"Cyst.PT_2"
"CTTCCTTTCAGCACCG"	"Cyst.PT_3"
"CTTCCTTTCATTGTTC"	"Cyst.PT_1"
"CTTCCTTTCCACGTGG"	"Cyst.TAL_1"
"CTTCGGTCACGCTATA"	"Cyst.PT_3"
"CTTCGGTCACTGTGTA"	"Cyst.PT_1"
"CTTCGGTGTGTCTTAG"	"Cyst.PT_1"
"CTTCGGTTCGTTGTAG"	"Cyst.PT_3"
"CTTCTAACAAGGCAAC"	"Cyst.TAL_1"
"CTTCTAACAAGGTCGA"	"Cyst.PT_2"
"CTTCTAACAGCAGTAG"	"Cyst.TAL_2"
"CTTCTAAGTGTATTGC"	"Cyst.TAL_2"
"CTTCTAATCAGAATAG"	"Cyst.PT_1"
"CTTCTAATCCACCCTA"	"Cyst.PT_3"
"CTTCTCTCAAGACGAC"	"Cyst.PT_1"
"CTTCTCTGTCCCTGAG"	"Cyst.PT_3"
"CTTCTCTGTTCTCCAC"	"Cyst.PT_1"
"CTTCTCTTCAAATGCC"	"Cyst.PT_1"
"CTTCTCTTCAGCTCTC"	"Cyst.PT_1"
"CTTCTCTTCATTTCGT"	"Mac"
"CTTGAGAAGAAGAACG"	"Cyst.PT_3"
"CTTGAGAAGATACATG"	"Cyst.TAL_1"
"CTTGATTAGAGCCTGA"	"Cyst.PT_3"
"CTTGATTAGTGAGTTA"	"Cyst.PT_1"
"CTTGATTAGTGCCAGA"	"Cyst.PT_2"
"CTTGATTCACATTCTT"	"Cyst.PT_3"
"CTTGATTCATCATTGG"	"Cyst.PT_2"
"CTTGATTGTAGGAGGG"	"EC"
"CTTGATTTCAAAGCCT"	"Cyst.TAL_1"
"CTTGATTTCATGAAAG"	"Cyst.TAL_2"
"CTTGATTTCGGTGTTA"	"Cyst.ATL"
"CTTTCAAAGAGATCGC"	"Cyst.PT_1"
"CTTTCAAAGGTACCTT"	"Cyst.TAL_2"
"CTTTCAACAGATTCGT"	"Cyst.PT_3"
"CTTTCAACAGCACAGA"	"Cyst.PT_2"
"CTTTCAACATAACCCA"	"Cyst.TAL_1"
"CTTTCAATCACAACCA"	"Cyst.PT_2"
"CTTTCAATCCTTCTGG"	"Cyst.PC"
"CTTTCAATCGCATTAG"	"Cyst.PT_2"
"CTTTCGGAGGAATCGC"	"Cyst.PT_1"
"CTTTCGGAGTGGCGAT"	"Cyst.PT_1"
"CTTTCGGCAACTGGTT"	"Cyst.PT_1"
"CTTTCGGCAGTCGAGA"	"vSMC"
"CTTTCGGGTGACGCCT"	"Cyst.TAL_2"
"CTTTCGGTCACGATCA"	"Cyst.TAL_2"
"GAAACCTAGATACCAA"	"Cyst.PT_2"
"GAAACCTCACGAAAGC"	"Cyst.PT_3"
"GAAACCTTCAACTACG"	"Cyst.TAL_1"
"GAAATGAAGCGACAGT"	"Fibroblast"
"GAAATGAAGTACTCGT"	"Cyst.TAL_1"
"GAAATGAAGTTTGTCG"	"Cyst.PT_1"
"GAAATGACAAGCGCAA"	"Cyst.IC-A1"
"GAAATGACATCTGTTT"	"Podocytes"
"GAACACTAGAATTGCA"	"Cyst.PC"
"GAACACTAGCTTCTAG"	"Cyst.TAL_2"
"GAACACTAGGGAGAAT"	"Cyst.PT_2"
"GAACACTCAGAATGTA"	"Cyst.TAL_1"
"GAACACTCAGCAGAAC"	"Cyst.PT_3"
"GAACACTCATGATCTG"	"Cyst.PT_1"
"GAACACTGTAAGATAC"	"Cyst.PT_1"
"GAACACTGTCGCATGC"	"Cyst.TAL_1"
"GAACACTTCACCTGGG"	"Cyst.PT_1"
"GAACACTTCGACACTA"	"Unk_1"
"GAACACTTCGGCCCAA"	"vSMC"
"GAACGTTAGCCGGAAT"	"Cyst.PT_2"
"GAACGTTAGCTGACCC"	"Cyst.PC"
"GAACGTTCAACTGGTT"	"Cyst.PT_2"
"GAACGTTCAAGTAGTA"	"Cyst.PC"
"GAACGTTCACCAACAT"	"vSMC"
"GAACGTTTCACTACGA"	"Cyst.TAL_2"
"GAACGTTTCCAAGCCG"	"Cyst.TAL_1"
"GAACTGTAGGATCACG"	"Cyst.PT_2"
"GAACTGTAGGCACTAG"	"Cyst.ATL"
"GAACTGTCAAACAGGC"	"Cyst.PT_1"
"GAACTGTCAACAACAA"	"Unk_2"
"GAACTGTCAATCACGT"	"Cyst.PT_1"
"GAACTGTCAGTAACAA"	"Cyst.PT_1"
"GAACTGTGTTCTCCCA"	"Cyst.PT_3"
"GAACTGTTCAGACCCG"	"Cyst.PT_3"
"GAACTGTTCATAGGCT"	"Cyst.PT_3"
"GAACTGTTCCAGTTCC"	"EC"
"GAACTGTTCCCTCTAG"	"Cyst.PT_1"
"GAACTGTTCGACTCCT"	"EC"
"GAAGAATAGCCTGTCG"	"Cyst.TAL_1"
"GAAGAATCATAGCTGT"	"Fibroblast"
"GAAGAATGTAGGCTCC"	"Cyst.PT_2"
"GAAGAATTCCATTCGC"	"Unk_1"
"GAAGCCCAGACGCCCT"	"Cyst.PT_2"
"GAAGCCCAGTCACTAC"	"Cyst.PT_3"
"GAAGCCCCACCGGAAA"	"Cyst.PT_3"
"GAAGCCCCAGCACAAG"	"Cyst.PT_1"
"GAAGCCCCATGAGATA"	"Cyst.PT_2"
"GAAGCCCTCCAATCCC"	"Podocytes"
"GAAGCCCTCCCTAGGG"	"Fibroblast"
"GAAGCCCTCGCACGGT"	"Cyst.PT_1"
"GAAGCGAAGCTGACTT"	"Cyst.TAL_1"
"GAAGCGAAGGGTACAC"	"Cyst.PT_3"
"GAAGCGACAACACTAC"	"Cyst.PT_2"
"GAAGCGACAGACGCTC"	"Cyst.PT_1"
"GAAGCGACATCAGCTA"	"Podocytes"
"GAAGCGACATCCGATA"	"Cyst.PT_3"
"GAAGCGAGTAAGGAGA"	"Cyst.PT_3"
"GAAGCGAGTGATTCTG"	"Cyst.PT_3"
"GAAGGACAGCGACATG"	"Cyst.PT_2"
"GAAGGACAGGCCTTCG"	"Cyst.PC"
"GAAGGACCACCAAATC"	"Cyst.PT_3"
"GAAGGACTCACTGGTA"	"Cyst.PC"
"GAAGGACTCAGCCCAG"	"Cyst.PT_2"
"GAAGGACTCGTTCTGC"	"EC"
"GAAGGGTAGTGCTCAT"	"Fibroblast"
"GAAGGGTCACACCGCA"	"Cyst.PT_1"
"GAAGGGTCACCTCTAC"	"Cyst.TAL_2"
"GAAGGGTCATCAGCGC"	"Cyst.PT_1"
"GAAGGGTGTACGAAAT"	"Cyst.PT_2"
"GAAGTAAAGCACCGTC"	"Mac"
"GAAGTAAAGCTAATGA"	"Cyst.PT_3"
"GAAGTAAGTATCGATC"	"Cyst.PT_1"
"GAATAGAAGCCTGAGA"	"Cyst.TAL_1"
"GAATAGACACTGAGTT"	"Cyst.PT_3"
"GAATAGACATCTTTCA"	"Cyst.TAL_2"
"GAATAGATCATGCTAG"	"Cyst.PT_1"
"GAATAGATCTCATGGA"	"Cyst.TAL_2"
"GAATCACAGAGGTTTA"	"Cyst.TAL_2"
"GAATCACCATAGGTAA"	"EC"
"GAATCACGTCCAGGTC"	"Cyst.PC"
"GAATCACGTTAAGTCC"	"Cyst.TAL_2"
"GAATCACTCAACGAGG"	"Cyst.TAL_1"
"GAATCACTCGCTCCTA"	"Cyst.TAL_2"
"GAATCGTCAACTCGTA"	"Cyst.PT_2"
"GAATCGTCATGGACAG"	"Cyst.TAL_1"
"GAATCGTGTTACAGCT"	"Cyst.TAL_1"
"GAATCGTGTTCCACAA"	"Cyst.PT_3"
"GACACGCAGAATAACC"	"Cyst.TAL_2"
"GACACGCAGGCTTAAA"	"Cyst.PT_3"
"GACACGCGTCCCTAAA"	"Cyst.PC"
"GACACGCGTGAAGCTG"	"Cyst.PT_2"
"GACACGCGTGGAAATT"	"Cyst.TAL_1"
"GACACGCTCTCATGGA"	"Cyst.TAL_2"
"GACAGCCAGAGTCTTC"	"Cyst.PT_1"
"GACAGCCAGGAGGCAG"	"Cyst.PT_2"
"GACAGCCCAGGCATTT"	"Cyst.PT_1"
"GACAGCCGTCTTCCGT"	"Cyst.TAL_2"
"GACATCACAATTAGGA"	"Cyst.PT_1"
"GACATCAGTAGAGATT"	"T-cell"
"GACATCAGTATCTCGA"	"Unk_1"
"GACCAATCAGGACTAG"	"Cyst.PT_2"
"GACCAATGTATACCTG"	"Cyst.TAL_1"
"GACCAATTCGAAATCC"	"Cyst.PT_1"
"GACCCAGAGCCGAATG"	"EC"
"GACCCAGCAGCATTGT"	"Cyst.TAL_2"
"GACCCAGCATGCTGCG"	"Cyst.TAL_1"
"GACCCAGTCCGCGATG"	"Cyst.PT_3"
"GACCCTTAGTTGCTGT"	"Cyst.PT_2"
"GACCCTTCAACTTCTT"	"Cyst.PT_1"
"GACCCTTCAGAAGCTG"	"Podocytes"
"GACCCTTCAGCTCGGT"	"Mac"
"GACCCTTCATAACCCA"	"Cyst.PT_1"
"GACCCTTCATTAGGCT"	"Cyst.TAL_1"
"GACCCTTGTAGATTGA"	"Cyst.PT_2"
"GACCCTTGTCCATACA"	"Podocytes"
"GACCCTTTCAGCTAGT"	"Cyst.TAL_1"
"GACCCTTTCTAGACAC"	"Cyst.PT_1"
"GACCGTGAGGGAGGGT"	"Cyst.PT_2"
"GACCGTGCATGACTTG"	"Cyst.TAL_1"
"GACCGTGGTGGAACCA"	"Cyst.PT_1"
"GACCGTGTCAGTCATG"	"Fibroblast"
"GACCGTGTCATCTGTT"	"Cyst.TAL_2"
"GACCGTGTCCGAACGC"	"Fibroblast"
"GACCTTCAGTATGAAC"	"Cyst.PT_2"
"GACCTTCCATCATTTC"	"Cyst.PT_2"
"GACCTTCCATCTCCCA"	"Cyst.PT_3"
"GACCTTCGTCTGGTTA"	"Cyst.TAL_1"
"GACCTTCTCCACTGGG"	"Cyst.ATL"
"GACCTTCTCCTTCTAA"	"Cyst.PT_1"
"GACGCTGAGCGACCCT"	"Cyst.PT_3"
"GACGCTGGTGCTAGCC"	"Cyst.PT_1"
"GACGCTGGTGGACAGT"	"EC"
"GACGCTGGTGTCTTAG"	"EC"
"GACGCTGTCGAAGGAC"	"Cyst.TAL_2"
"GACGTTAAGCTGGCTC"	"Cyst.PT_1"
"GACGTTAAGTCATAGA"	"T-cell"
"GACGTTAAGTTGGAGC"	"Cyst.PT_1"
"GACGTTACACACTGGC"	"Cyst.PT_1"
"GACGTTACAGCGATTT"	"Cyst.PT_3"
"GACGTTACATTAGGAA"	"Cyst.TAL_1"
"GACGTTAGTCGTAATC"	"Unk_1"
"GACGTTATCTATGTGG"	"Cyst.PT_1"
"GACTATGCACACTTAG"	"Cyst.PT_2"
"GACTATGCACTACTTT"	"Cyst.PT_1"
"GACTATGCAGTAGAAT"	":LowQual"
"GACTATGGTGAATTAG"	"Cyst.PT_2"
"GACTATGGTGCACAAG"	"Cyst.PC"
"GACTATGTCGTAGTGT"	"Cyst.PT_1"
"GACTCAAGTCACCCTT"	"Cyst.TAL_1"
"GACTCAAGTTGCTCGG"	"Cyst.TAL_2"
"GACTCAATCACCTGTC"	"Cyst.PT_2"
"GACTCAATCAGATGCT"	"Unk_2"
"GACTCAATCCCGAGAC"	"Cyst.TAL_2"
"GACTCAATCCCGTAAA"	"Cyst.PT_1"
"GACTCTCTCAACCTCC"	"Cyst.PT_3"
"GACTGATAGCGCCTTG"	"Cyst.PT_1"
"GACTGATCAACGATTC"	"Cyst.PT_1"
"GACTGATCACATTGTG"	"Cyst.PT_2"
"GACTGATCATTGACAC"	"Fibroblast"
"GACTGATGTCCCAAAT"	"Cyst.PT_2"
"GACTGATTCAAGAATG"	"Cyst.PT_2"
"GACTGATTCACGATAC"	"Cyst.PT_1"
"GACTGATTCATTCGGA"	"Cyst.TAL_1"
"GACTGATTCGGCTGAC"	"Cyst.PT_2"
"GACTTCCAGATGCAGC"	"Cyst.PT_1"
"GACTTCCTCAGAGCGA"	"Cyst.PT_1"
"GAGAAATAGAAGGTAG"	"Cyst.PT_1"
"GAGAAATAGCGTCAAG"	"Cyst.PT_3"
"GAGAAATCATACCACA"	"Cyst.PT_1"
"GAGAAATGTACGATTC"	"vSMC"
"GAGAAATGTGAGATTA"	"Cyst.PT_1"
"GAGAAATGTGGCAGAT"	"vSMC"
"GAGAAATTCTTCCCGA"	"EC"
"GAGACCCAGCCAGAGT"	"Cyst.PT_2"
"GAGACCCCACAAGTGG"	"Fibroblast"
"GAGACCCCAGCAATTC"	"Cyst.TAL_2"
"GAGACCCGTCAGGCAA"	"Cyst.TAL_2"
"GAGACTTAGTAGGATT"	"Cyst.PT_2"
"GAGACTTCACCATTCC"	"Fibroblast"
"GAGACTTCAGTATACC"	"Cyst.PT_1"
"GAGAGGTAGCACACCC"	"Mac"
"GAGAGGTCACTTGACA"	"Cyst.PC"
"GAGAGGTGTGACACAG"	"EC"
"GAGAGGTGTGGTTCTA"	"Cyst.PT_2"
"GAGAGGTTCTGCTTTA"	"Cyst.TAL_1"
"GAGATGGGTCCTGGTG"	"Cyst.PT_1"
"GAGATGGTCAGTCAGT"	"Cyst.TAL_1"
"GAGATGGTCCTAAACG"	"Cyst.PT_3"
"GAGATGGTCGCCCAGA"	"Cyst.TAL_1"
"GAGCCTGAGATGCTAA"	"Cyst.PT_2"
"GAGCCTGCAAATAGCA"	"Cyst.PT_1"
"GAGCCTGCATGACCCG"	"Cyst.TAL_2"
"GAGCCTGGTGACTCGC"	"EC"
"GAGCCTGGTTAAGCAA"	"Cyst.TAL_1"
"GAGCCTGTCAGTCCGG"	"Mac"
"GAGCCTGTCGGAGATG"	"Cyst.PT_3"
"GAGCTGCAGGTGCTTT"	"Cyst.PT_3"
"GAGCTGCCATGATGCT"	"Cyst.PT_3"
"GAGCTGCCATGGGATG"	"Cyst.ATL"
"GAGCTGCCATTCTGTT"	"Cyst.TAL_1"
"GAGCTGCGTACGTGAG"	"Cyst.PT_1"
"GAGCTGCGTTAAGACA"	"Cyst.PT_1"
"GAGCTGCTCACGATAC"	"Cyst.PT_1"
"GAGCTGCTCTTTCCGG"	"Cyst.PC"
"GAGGCAAAGGAGTACC"	"Cyst.PC"
"GAGGCAACAAGCGATG"	"Cyst.PT_1"
"GAGGCAAGTAGTCTTG"	"Cyst.PT_2"
"GAGGCAAGTCGTGATT"	"Cyst.TAL_2"
"GAGGCAATCTTCGGAA"	"Cyst.PT_2"
"GAGGCCTAGTGGTTAA"	"Cyst.TAL_1"
"GAGGCCTCAAATACGA"	"T-cell"
"GAGGCCTCATACTGTG"	"Podocytes"
"GAGGCCTCATCGGAAG"	"Cyst.TAL_1"
"GAGGCCTGTTCGAGCC"	"Cyst.PT_1"
"GAGGGATAGGAGCTGT"	"Cyst.TAL_2"
"GAGGGATCAATCGCAT"	"Cyst.PT_2"
"GAGGGATCATTCCTAT"	"Cyst.TAL_1"
"GAGGGATGTAGGTTTC"	"Cyst.PT_1"
"GAGGGATGTATCCCTC"	"Cyst.PT_1"
"GAGGGATGTCCGGCAT"	"Cyst.PT_1"
"GAGGGATGTCTCAGGC"	"Cyst.TAL_2"
"GAGGGATTCCTACGAA"	"Cyst.PT_3"
"GAGGGATTCGGCGATC"	"Cyst.PT_1"
"GAGGGTAAGAGTGAAG"	"Cyst.PT_3"
"GAGGGTAAGAGTGGCT"	"Unk_2"
"GAGGGTAAGAGTTCGG"	"Cyst.PT_1"
"GAGGGTACAAAGAGTT"	"Cyst.PT_1"
"GAGGGTAGTTGTATGC"	"Cyst.PT_1"
"GAGGGTATCGCCGTGA"	"Cyst.PC"
"GAGTCATCAGGAGACT"	"Cyst.PT_1"
"GAGTCATGTCAGTCGC"	"Mac"
"GAGTCATTCCGCCTAT"	"Cyst.TAL_1"
"GAGTCTACACACAGAG"	"vSMC"
"GAGTCTAGTACAAGTA"	"Cyst.PT_1"
"GAGTCTAGTGACTAAA"	"Cyst.PT_1"
"GAGTCTAGTTTCGATG"	"Fibroblast"
"GAGTCTATCACCCTGT"	"Cyst.TAL_1"
"GAGTCTATCATAAGGA"	"Cyst.PT_1"
"GAGTGAGCATGGAGAC"	"Cyst.PT_1"
"GAGTGAGGTCGACGCT"	"vSMC"
"GAGTGAGGTCTGTGGC"	"Cyst.PT_2"
"GAGTGAGGTTTCCCAC"	"Cyst.PT_2"
"GAGTGAGTCGAAACAA"	"Cyst.PT_2"
"GAGTGAGTCTGCTAGA"	"Cyst.TAL_1"
"GAGTGTTAGTTGAAGT"	"Cyst.PT_2"
"GAGTGTTGTCCGAAGA"	"Unk_2"
"GAGTGTTGTGCAACAG"	"vSMC"
"GAGTGTTTCAGTGTTG"	"Cyst.PT_3"
"GAGTGTTTCCTAGAGT"	"Cyst.PT_2"
"GAGTGTTTCTCAACCC"	"Cyst.PT_1"
"GAGTTACCACCCGTAG"	"Cyst.PT_2"
"GAGTTACCATACACCA"	"Cyst.TAL_1"
"GAGTTACGTACGAAAT"	"Cyst.TAL_1"
"GAGTTACGTGCTTCAA"	"Cyst.PT_3"
"GAGTTACTCTTCGCTG"	"Cyst.PT_1"
"GAGTTGTAGACAGCGT"	"Podocytes"
"GAGTTGTAGCAGGGAG"	"Cyst.PT_1"
"GAGTTGTAGGTTCATC"	"Cyst.TAL_2"
"GAGTTGTAGTCGTTAC"	"Cyst.PC"
"GAGTTGTCAACTGCCG"	"Cyst.PT_3"
"GAGTTGTCACGGAAGT"	"Cyst.TAL_1"
"GAGTTGTCAGGAACCA"	"Cyst.PT_3"
"GAGTTGTCAGGTTTAC"	"Cyst.PT_1"
"GAGTTGTTCATCACTT"	"Cyst.PT_2"
"GAGTTGTTCATGCTAG"	"INT"
"GAGTTGTTCGTTAGTG"	"Cyst.PT_2"
"GAGTTTGAGCAGCCCT"	"Cyst.TAL_1"
"GAGTTTGAGTCCCGAC"	"EC"
"GAGTTTGCAAGTCGTT"	"Cyst.PT_2"
"GAGTTTGCACATTGTG"	"Cyst.PT_3"
"GAGTTTGCAGTGTGGA"	"Cyst.TAL_1"
"GAGTTTGTCAAAGGAT"	"Cyst.PT_2"
"GATAGAAAGAAGCCAC"	"Cyst.PT_1"
"GATAGAAAGTGTAGAT"	"Cyst.PT_3"
"GATAGAAAGTTTGCTG"	"Cyst.PT_1"
"GATAGAACATGATCTG"	"Cyst.PT_1"
"GATAGAAGTGCCCTTT"	"vSMC"
"GATAGAATCAATCTCT"	"Cyst.PC"
"GATAGCTAGATACAGT"	"EC"
"GATAGCTAGATACCAA"	"Cyst.PT_3"
"GATAGCTAGTTGCATC"	"Cyst.PT_2"
"GATAGCTCACCTATCC"	"T-cell"
"GATAGCTGTACTAAGA"	"Cyst.PC"
"GATAGCTGTCACATTG"	"Cyst.IC-A1"
"GATAGCTGTCATTGCA"	"Cyst.PT_1"
"GATAGCTGTGTTAACC"	"Cyst.PT_2"
"GATAGCTTCCTAGCGG"	"Cyst.TAL_1"
"GATAGCTTCCTCTAAT"	"Cyst.TAL_2"
"GATAGCTTCTCAATCT"	"Unk_1"
"GATCACAAGTGGTCAG"	"Cyst.PT_1"
"GATCACACAATTGGTC"	"Cyst.PC"
"GATCACACAGACGCTC"	"Cyst.PT_1"
"GATCACACAGCAGTAG"	"Cyst.PT_3"
"GATCACACAGGTAGTG"	"Cyst.TAL_1"
"GATCACAGTTTAAGGA"	"Cyst.PC"
"GATCACATCAGACTGT"	"Cyst.TAL_1"
"GATCACATCATTTCGT"	"Cyst.PT_3"
"GATCACATCCCAAGTA"	"Cyst.PC"
"GATCAGTAGAATTGCA"	"Mac"
"GATCAGTCAAGCTCTA"	"Podocytes"
"GATCAGTCAAGTCGTT"	"Cyst.PT_3"
"GATCAGTCACAGTCCG"	"Cyst.PT_3"
"GATCAGTGTTCGAGCC"	"Cyst.TAL_2"
"GATCAGTTCCATCAGA"	"Cyst.PT_1"
"GATCAGTTCGTGGAAG"	"Cyst.TAL_1"
"GATCAGTTCTAGGCCG"	"Cyst.PT_1"
"GATCAGTTCTCATAGG"	"Cyst.PT_3"
"GATCAGTTCTTGCAAG"	"Cyst.PT_1"
"GATCATGAGACCAAGC"	"EC"
"GATCATGAGATTGAGT"	"Mac"
"GATCATGAGTGGAAGA"	"Cyst.TAL_2"
"GATCATGCAAGGACAC"	"vSMC"
"GATCATGCACCAAATC"	"Cyst.PT_2"
"GATCATGGTGTTACAC"	"Cyst.TAL_2"
"GATCATGTCCAAATGC"	"Cyst.PT_1"
"GATCCCTAGCAATTAG"	"Cyst.PT_3"
"GATCCCTAGCGCCCAT"	"Cyst.PT_1"
"GATCCCTCAAACCATC"	"Cyst.PT_1"
"GATCCCTCAACCGATT"	"EC"
"GATCCCTGTACCAGAG"	"Cyst.TAL_2"
"GATCGTAAGATTAGAC"	"Cyst.TAL_1"
"GATCGTACACAAGCAG"	"Cyst.PT_2"
"GATCGTACATGTAACC"	"Cyst.PT_1"
"GATCGTAGTCCATCTC"	"Cyst.TAL_2"
"GATCGTATCTACGGGC"	"Cyst.PT_1"
"GATGACTAGTCGCCAC"	"Cyst.PT_1"
"GATGACTCAACACAAA"	"Cyst.PT_3"
"GATGACTCAGAAGTTA"	"Cyst.TAL_2"
"GATGACTGTATAATGG"	"Cyst.TAL_1"
"GATGACTGTATGGAAT"	":LowQual"
"GATGACTGTCTAACGT"	"Cyst.PT_2"
"GATGACTGTCTGCAAT"	"Cyst.PC"
"GATGACTGTTCCGCAG"	"Cyst.PT_1"
"GATGACTGTTTACACG"	"Cyst.PC"
"GATGACTTCATGCCAA"	"Cyst.PT_3"
"GATGACTTCCACTTTA"	"Cyst.TAL_2"
"GATGACTTCGCGTAGC"	"Cyst.TAL_2"
"GATGACTTCTTACCAT"	"Cyst.TAL_1"
"GATGAGGAGAACGCGT"	"Cyst.PT_1"
"GATGAGGCAGCTCTGG"	"Cyst.TAL_1"
"GATGAGGGTTGAGTCT"	"Cyst.PT_2"
"GATGAGGTCCGCTTAC"	"Cyst.PT_1"
"GATGAGGTCTGACAGT"	"EC"
"GATGAGGTCTGCGATA"	"Cyst.PT_1"
"GATGATCAGGAAAGTG"	"Cyst.PT_2"
"GATGATCGTAGGAGTC"	"Cyst.PT_3"
"GATGCTAAGAGCAGCT"	"Cyst.PT_1"
"GATGCTAAGCTAATGA"	"Cyst.PT_1"
"GATGCTAGTGACTCTA"	"Cyst.PT_3"
"GATGCTATCCTGTTGC"	"Cyst.TAL_1"
"GATGCTATCGCGAAGA"	"Cyst.TAL_1"
"GATGCTATCTGAACGT"	"Cyst.PT_2"
"GATGCTATCTTCCAGC"	"Cyst.PT_2"
"GATGGAGAGTGGCGAT"	"EC"
"GATGGAGAGTTGCCTA"	"Cyst.TAL_2"
"GATGGAGGTGTCCCTT"	"Cyst.TAL_1"
"GATGGAGGTTTGCAGT"	"Cyst.PT_3"
"GATGGAGTCACTGTTT"	"Cyst.PT_2"
"GATGGAGTCATTTCGT"	"Cyst.TAL_2"
"GATGGAGTCTACACTT"	"Cyst.PT_2"
"GATGTTGAGACAAGCC"	"Cyst.PT_3"
"GATGTTGAGATGTTCC"	"Cyst.TAL_1"
"GATGTTGAGTCGCCAC"	"Cyst.PC"
"GATGTTGCACCACTGG"	"Cyst.PT_1"
"GATGTTGCACCCTAGG"	"Cyst.PT_1"
"GATGTTGGTAACATCC"	"Cyst.PT_3"
"GATGTTGTCGCTAAAC"	"Cyst.PC"
"GATGTTGTCTGGTGGC"	"Cyst.PT_3"
"GATTCGACAAATGATG"	"Cyst.PT_2"
"GATTCGACACCTCGTT"	"Cyst.PT_3"
"GATTCTTAGACGAAGA"	"EC"
"GATTCTTAGATGCTTC"	"Cyst.PT_1"
"GATTCTTAGGGAGAAT"	"Cyst.TAL_1"
"GATTCTTAGTGAGTGC"	"Cyst.PT_2"
"GATTCTTGTACACTCA"	"Cyst.PT_1"
"GATTCTTGTTAAGGGC"	"Cyst.TAL_1"
"GATTCTTTCCTCATAT"	"Cyst.PT_2"
"GATTCTTTCTCGCCTA"	"Cyst.PT_1"
"GATTCTTTCTCTGAGA"	"Cyst.PT_1"
"GATTGGTAGATTGACA"	"EC"
"GATTGGTCAATTGGTC"	"Cyst.TAL_1"
"GATTGGTCACGGGTAA"	"Fibroblast"
"GATTGGTCAGAGTTCT"	"Cyst.PT_3"
"GATTGGTCAGATCATC"	"Cyst.PT_2"
"GATTGGTCATCCTCAC"	"vSMC"
"GATTGGTGTCTACGAT"	"EC"
"GATTGGTGTCTTTCTA"	"Unk_1"
"GATTGGTGTTTCGGCG"	"Cyst.PT_2"
"GATTGGTTCGGTCACG"	"vSMC"
"GATTTCTAGATGAAGG"	"Cyst.TAL_1"
"GATTTCTAGCCATGCC"	"Cyst.PT_1"
"GATTTCTAGCTACAAA"	"Cyst.PT_3"
"GATTTCTCAACGTAAA"	"Cyst.PT_2"
"GATTTCTCAGTAGTTC"	"Fibroblast"
"GATTTCTGTAGTCTGT"	"Cyst.PT_2"
"GATTTCTTCGAAGCAG"	"Cyst.PT_1"
"GATTTCTTCGACGATT"	"Cyst.TAL_2"
"GCAACATAGAGAGCGG"	"Unk_2"
"GCAACATAGCATCCTA"	":LowQual"
"GCAACATAGTCACTGT"	"Cyst.TAL_1"
"GCAACATCAACACAGG"	"Cyst.TAL_1"
"GCAACATCAATGCAAA"	"Cyst.PT_2"
"GCAACATGTGTTTGCA"	"Cyst.PT_3"
"GCAACATGTTCCGCAG"	"Cyst.TAL_1"
"GCAACATTCTCTCGAC"	"Cyst.TAL_2"
"GCAACCGAGAATGTTG"	"Cyst.PT_1"
"GCAACCGAGAGGTGCT"	"Cyst.TAL_1"
"GCAACCGAGCCAGTAG"	"Cyst.TAL_1"
"GCAACCGCAGTAGATA"	"Cyst.PT_1"
"GCAACCGCAGTTAGGG"	"Cyst.PT_2"
"GCAACCGCATTCACAG"	"Fibroblast"
"GCAACCGGTAGAGTTA"	"Cyst.PT_3"
"GCACATAAGACGATAT"	"Cyst.TAL_1"
"GCACATAAGCACGATG"	"Cyst.TAL_1"
"GCACATATCCTTCTTC"	"Cyst.PT_1"
"GCACATATCTGAGCAT"	"Cyst.PT_2"
"GCACGGTAGAAATCCA"	"Cyst.TAL_2"
"GCACGGTAGCACTCTA"	"Cyst.TAL_1"
"GCACGGTAGCAGCCTC"	"Cyst.TAL_2"
"GCACGGTAGCGCCTCA"	"Cyst.PT_1"
"GCACGGTCACAGCCTG"	"Cyst.PT_3"
"GCACGGTCATACGCAT"	"Cyst.ATL"
"GCACGGTGTCAGGAGT"	"Cyst.PT_1"
"GCACGGTGTCGTTCAA"	"Cyst.PT_3"
"GCACGGTGTGTTCCAA"	"Cyst.TAL_2"
"GCACGGTTCACTACGA"	"Cyst.TAL_2"
"GCACGTGCACTCAGAT"	"Cyst.PT_2"
"GCACGTGGTCAGGCAA"	"Cyst.PT_2"
"GCACGTGGTCTGGTTA"	"Cyst.TAL_2"
"GCACGTGTCCAGTGCG"	"Cyst.PT_3"
"GCACTAAAGTATGCAA"	"Cyst.TAL_1"
"GCACTAACAACCCTCT"	"Cyst.TAL_2"
"GCACTAACACCAATTG"	"Cyst.PT_2"
"GCACTAACACGGTAGA"	"Cyst.PC"
"GCACTAACAGCTGAAG"	"Cyst.PC"
"GCACTAACAGTAACGG"	"Cyst.PT_1"
"GCACTAACATGACCCG"	"Cyst.PT_1"
"GCACTAAGTCAAGGCA"	"Cyst.PT_1"
"GCACTAAGTGTGTGGA"	"Mac"
"GCACTAATCAGTCCGG"	"EC"
"GCACTAATCGGTAGGA"	"Cyst.PT_1"
"GCACTAATCTAGATCG"	"Cyst.IC-A1"
"GCACTAATCTGCGGGT"	"Cyst.PC"
"GCACTAATCTTGTTAC"	"Cyst.PT_2"
"GCAGCCAAGCTGAGTG"	"Cyst.PT_1"
"GCAGCCACATGGTACT"	"Cyst.TAL_2"
"GCAGCCAGTAAGAACT"	"Cyst.PT_1"
"GCAGCCAGTACGATCT"	"Cyst.PC"
"GCAGCCAGTATGGAAT"	"Cyst.TAL_2"
"GCAGCCATCATCTGTT"	"Fibroblast"
"GCAGCCATCGTGGCGT"	"Cyst.TAL_2"
"GCAGCTGAGACGGTTG"	"Cyst.PT_1"
"GCAGCTGAGGATTCCT"	"Cyst.PT_3"
"GCAGCTGCAGATCACT"	"Cyst.PT_2"
"GCAGCTGCATTCGGGC"	"Cyst.TAL_2"
"GCAGCTGGTAACACCT"	"Cyst.PT_1"
"GCAGGCTAGATACCAA"	"Cyst.TAL_1"
"GCAGGCTAGCAGCGAT"	"Cyst.PT_1"
"GCAGGCTAGGTGCGAT"	"Cyst.TAL_1"
"GCAGGCTAGTCTGGAG"	"Cyst.TAL_2"
"GCAGGCTCAGTAGTTC"	"Cyst.PT_1"
"GCAGGCTGTGACTGTT"	"Cyst.TAL_2"
"GCAGGCTTCAGTGGGA"	"Cyst.PC"
"GCAGGCTTCTCCGCAT"	"Cyst.TAL_2"
"GCAGGCTTCTCTCAAT"	"Cyst.PC"
"GCAGTTAAGCCGATTT"	"Cyst.PT_1"
"GCAGTTAAGCGTGAAC"	"Cyst.PT_3"
"GCAGTTAGTGCCTGAC"	"Cyst.PC"
"GCAGTTAGTGTGAGCA"	"Cyst.TAL_1"
"GCAGTTAGTTCTCCCA"	"Cyst.PT_2"
"GCAGTTATCGACGAGA"	"Cyst.PT_3"
"GCATCGGAGACGAAGA"	"Cyst.PT_1"
"GCATCGGAGTTGGAAT"	"Cyst.TAL_1"
"GCATCGGCAGCTACTA"	"Cyst.TAL_2"
"GCATCTCAGCCTTGAT"	"vSMC"
"GCATCTCAGCTGGCTC"	"Cyst.PT_1"
"GCATCTCAGGAAACGA"	"Cyst.TAL_1"
"GCATCTCCACGCTTAA"	"Cyst.TAL_1"
"GCATCTCCAGGCATGA"	"Cyst.PT_2"
"GCATCTCGTATCTCTT"	"Cyst.PT_2"
"GCATCTCGTCGATGCC"	"Cyst.PT_1"
"GCATCTCGTTCGGGTC"	"Cyst.PT_2"
"GCATGATAGCGTCAGA"	"Cyst.PT_2"
"GCATGATGTACGGATG"	"Cyst.PC"
"GCATGATGTGCGGTAA"	"Cyst.PT_3"
"GCATGATGTTCCTTGC"	"Cyst.PT_1"
"GCATGATGTTCTCGCT"	"Cyst.PT_2"
"GCATGATTCCTGTTGC"	"Unk_2"
"GCATTAGCAAAGCTAA"	"Cyst.TAL_1"
"GCATTAGGTACAGTTC"	"Cyst.PT_1"
"GCATTAGGTACCCACG"	"vSMC"
"GCATTAGGTAGACTGG"	"vSMC"
"GCATTAGGTCACATTG"	"Cyst.PT_2"
"GCCAACGAGCTCTATG"	"Cyst.PT_1"
"GCCAACGAGCTGCGAA"	"Cyst.PT_3"
"GCCAACGCACTCCTTG"	"Cyst.PT_1"
"GCCAACGCAGCAATTC"	"Cyst.TAL_1"
"GCCAACGCAGCTTCCT"	"Cyst.TAL_2"
"GCCAACGCAGTCGTTA"	"Podocytes"
"GCCAACGCATTCTCTA"	"Cyst.PT_3"
"GCCAACGGTACAGTCT"	"Cyst.PT_2"
"GCCAACGGTCATGACT"	"Cyst.TAL_1"
"GCCAACGGTGATACAA"	"Cyst.PT_2"
"GCCAACGTCCAGTGCG"	"Fibroblast"
"GCCAACGTCTGCAGCG"	"vSMC"
"GCCAGCAAGACCAAAT"	"Cyst.PT_1"
"GCCAGCAAGCAAGTGC"	"Cyst.PT_1"
"GCCAGCACACACCAGC"	"Mac"
"GCCAGCACATGGTACT"	"Cyst.PT_2"
"GCCAGCAGTGAGTAGC"	"Mac"
"GCCAGCAGTGCTCTCT"	"Cyst.PT_1"
"GCCAGCAGTGTTCCTC"	"Fibroblast"
"GCCAGCATCTAAACGC"	"Podocytes"
"GCCAGGTAGAGGTATT"	"Cyst.PT_1"
"GCCAGGTCAATCGCGC"	"Cyst.IC-A1"
"GCCAGGTCACAATTCG"	"Cyst.IC-A1"
"GCCAGGTGTAGCGCTC"	"Cyst.PT_1"
"GCCAGGTGTAGTGGCA"	"Cyst.PT_3"
"GCCAGGTTCCATTGCC"	"Cyst.TAL_2"
"GCCAGGTTCCGGCTTT"	"Cyst.PT_2"
"GCCAGTGAGAATACAC"	"Cyst.PT_2"
"GCCAGTGAGTCATGAA"	"Cyst.PT_2"
"GCCAGTGCAGAAATCA"	"EC"
"GCCAGTGCAGGCGAAT"	"Cyst.PT_1"
"GCCAGTGCATGACAGG"	"Cyst.PT_1"
"GCCAGTGGTCCTGTCT"	"Cyst.PT_2"
"GCCAGTGGTGAATGTA"	"Cyst.PT_1"
"GCCAGTGGTTGCTCCT"	"EC"
"GCCAGTGTCATCGTAG"	"Cyst.PT_2"
"GCCATGGCACTGGATT"	"T-cell"
"GCCATGGGTATTTCTC"	"Mac"
"GCCATTCAGCGACTAG"	"Cyst.TAL_2"
"GCCATTCAGGTGCAGT"	"Cyst.PT_3"
"GCCATTCCAAGAATAC"	"Cyst.PT_3"
"GCCATTCCAAGTGGAC"	"EC"
"GCCATTCCAGGCTACC"	"Cyst.PT_1"
"GCCATTCGTAATGCTC"	"EC"
"GCCATTCGTATGAGCG"	"Cyst.PC"
"GCCATTCGTCGTGATT"	"Cyst.TAL_2"
"GCCATTCGTTCTAAGC"	"Cyst.PT_3"
"GCCATTCTCCGCCTAT"	"T-cell"
"GCCATTCTCTTCCCAG"	"Cyst.IC-A1"
"GCCCAGAAGTAGGGTC"	"Cyst.PT_2"
"GCCCAGACAGACACCC"	"Cyst.TAL_1"
"GCCCAGAGTCACGTGC"	"Unk_1"
"GCCCAGATCGCCGAAC"	"Cyst.TAL_1"
"GCCCGAAAGACATACA"	"Cyst.PT_1"
"GCCCGAAAGAGGATCC"	"Cyst.PT_1"
"GCCCGAAAGTAACGAT"	"vSMC"
"GCCCGAAAGTAGGATT"	"Cyst.PT_3"
"GCCCGAACAACAGTGG"	"Cyst.TAL_2"
"GCCCGAACACTCACTC"	"Cyst.PT_3"
"GCCCGAACATTGTACG"	"Cyst.TAL_1"
"GCCCGAAGTCTCAGGC"	"Unk_1"
"GCCCGAATCATTGTGG"	"Cyst.PT_2"
"GCCGATGCACTCTCGT"	"Cyst.PT_1"
"GCCGATGCAGTAACCT"	"Cyst.PT_1"
"GCCGATGCATATGGCT"	"Cyst.TAL_2"
"GCCGATGTCATTCCTA"	"Cyst.PT_3"
"GCCGTGAAGGCTATCT"	":LowQual"
"GCCGTGAAGTCACACT"	"Cyst.PC"
"GCCGTGACACACTGGC"	"Cyst.TAL_1"
"GCCGTGACACGAAGAC"	"Cyst.PC"
"GCCGTGACACGTGTGC"	"Cyst.PT_3"
"GCCGTGACATCGTGCG"	"Cyst.PT_2"
"GCCGTGACATTCGGGC"	"Cyst.PC"
"GCCGTGAGTAGGTTTC"	"Cyst.PT_1"
"GCCGTGATCATGCAGT"	"Cyst.PT_1"
"GCCGTGATCCAATCTT"	"Cyst.PT_1"
"GCCGTGATCTCATGGA"	"Mac"
"GCCGTGATCTGTAACG"	"Cyst.ATL"
"GCCTGTTAGATACTGA"	"Cyst.TAL_2"
"GCCTGTTCAATCAAGA"	"Fibroblast"
"GCCTGTTCACGGCACT"	"Fibroblast"
"GCCTGTTCAGATACCT"	"Cyst.TAL_2"
"GCCTGTTCATTCTGTT"	"Cyst.TAL_2"
"GCCTGTTTCAGGAAGC"	"Cyst.TAL_1"
"GCGAGAAAGATAGTGT"	"Cyst.PC"
"GCGAGAAAGTAGCAAT"	"Cyst.PT_1"
"GCGAGAACAACCGGAA"	"Cyst.TAL_1"
"GCGAGAAGTCATCGGC"	"Cyst.PT_3"
"GCGAGAAGTGCCCTTT"	"Cyst.PT_2"
"GCGAGAATCGTTACCC"	"Cyst.PT_2"
"GCGAGAATCTACGCGG"	"Cyst.PT_1"
"GCGATCGAGAGTCGAC"	"Unk_1"
"GCGATCGAGTCGAAGC"	"Cyst.TAL_1"
"GCGATCGGTCCAAATC"	"Cyst.PT_3"
"GCGATCGTCCCGAGGT"	"Cyst.PT_2"
"GCGATCGTCTCTAAGG"	"Cyst.TAL_1"
"GCGGAAACACTACTTT"	"Cyst.TAL_1"
"GCGGAAACACTCGATA"	"Cyst.PC"
"GCGGAAACATGGAAGC"	"Cyst.PT_2"
"GCGGAAAGTCATAACC"	"vSMC"
"GCGGAAAGTTTGACAC"	"Podocytes"
"GCGGAAATCCTTACCG"	"Fibroblast"
"GCGGATCAGACGCTCC"	"Cyst.TAL_2"
"GCGGATCAGGCATCTT"	"EC"
"GCGGATCCAAAGAGTT"	":LowQual"
"GCGGATCCACGGATCC"	"vSMC"
"GCGGATCCAGATAAAC"	"Cyst.PT_3"
"GCGGATCCATGCCGCA"	"Cyst.TAL_1"
"GCGGATCGTCCAAATC"	"EC"
"GCGGATCGTGTGTGGA"	"Cyst.PT_1"
"GCGGATCTCCTTACCG"	"Cyst.PT_3"
"GCGTGCACACTACTTT"	"Cyst.PC"
"GCGTGCACATGCCGAC"	"vSMC"
"GCGTGCATCCTTATGT"	"Cyst.PT_3"
"GCGTGCATCTCCGAAA"	"Cyst.PT_1"
"GCGTGCATCTGTGCTC"	"Cyst.TAL_1"
"GCGTTTCCAAGGACAC"	"Cyst.TAL_1"
"GCGTTTCGTTCTCCCA"	"Cyst.PT_1"
"GCGTTTCTCGAAATCC"	"Cyst.TAL_1"
"GCGTTTCTCTCTCTAA"	"Cyst.PT_2"
"GCTACAACACATATCG"	"Podocytes"
"GCTACCTAGGCGACAT"	"Cyst.PT_1"
"GCTACCTCACACCAGC"	"Cyst.PT_3"
"GCTACCTCAGCTATAC"	"Cyst.PT_3"
"GCTACCTGTGGTACAG"	"Cyst.TAL_2"
"GCTACCTTCGAAGCCC"	"Cyst.PC"
"GCTACCTTCGCGTGAC"	"Cyst.PT_1"
"GCTCAAAAGCGGGTTA"	"Cyst.TAL_1"
"GCTCAAAAGCTCAGAG"	"Cyst.TAL_1"
"GCTCAAAGTACACGTT"	"Cyst.PT_2"
"GCTCAAAGTAGTGATA"	"Cyst.PT_3"
"GCTCAAAGTATAGGAT"	"Cyst.PT_1"
"GCTCAAAGTATCGGTT"	"Cyst.TAL_2"
"GCTCAAATCACCTTAT"	"vSMC"
"GCTCAAATCTAGTCAG"	"Cyst.TAL_1"
"GCTCAAATCTCGCCTA"	"Podocytes"
"GCTGAATAGGGCAGTT"	"Cyst.PT_3"
"GCTGAATCAAGCACCC"	"Cyst.TAL_2"
"GCTGAATCATCCCACT"	"Cyst.TAL_1"
"GCTGAATTCATAGACC"	"Fibroblast"
"GCTGAATTCCGTCACT"	"Cyst.PT_1"
"GCTGAATTCGGTCGAC"	"Podocytes"
"GCTGCAGAGCAGCAGT"	"Cyst.PT_3"
"GCTGCAGCAATAGTCC"	"Cyst.PT_1"
"GCTGCAGCATATGGCT"	"Mac"
"GCTGCAGCATGACGTT"	"Cyst.PT_1"
"GCTGCAGGTTTCCATT"	"Cyst.PT_1"
"GCTGCAGTCACATACG"	"Cyst.PT_1"
"GCTGCAGTCGAACCTA"	"Cyst.TAL_2"
"GCTGGGTAGACAGCTG"	"vSMC"
"GCTGGGTAGGGATCTG"	"Unk_1"
"GCTGGGTTCAAATGCC"	"Fibroblast"
"GCTTCACCAACGGGTA"	"Cyst.TAL_2"
"GCTTCACTCGCGTGCA"	"Cyst.PT_3"
"GCTTGGGCATACAGCT"	"Cyst.IC-A1"
"GCTTGGGGTTAGGACG"	"Fibroblast"
"GCTTGGGGTTATCTGG"	"Cyst.PC"
"GCTTGGGTCGAAACAA"	"Cyst.PT_1"
"GCTTGGGTCTCCGAGG"	"Cyst.PT_2"
"GCTTTCGAGAGCAAGA"	"Cyst.PT_1"
"GCTTTCGAGTGATGGC"	"Fibroblast"
"GCTTTCGAGTGCGCTC"	"Cyst.PT_3"
"GCTTTCGCAGTGTGCC"	"Cyst.PT_2"
"GCTTTCGGTACCGCGT"	"Cyst.PT_3"
"GCTTTCGGTGAGTTTC"	"Podocytes"
"GCTTTCGGTGCATGAG"	"Cyst.PT_1"
"GCTTTCGTCACTTGTT"	"Cyst.PT_3"
"GCTTTCGTCATCACAG"	"Cyst.TAL_1"
"GCTTTCGTCTCACTCG"	"Cyst.PT_1"
"GCTTTCGTCTCGCAGG"	"Unk_1"
"GGAACCCAGAGACAAG"	"Cyst.PT_2"
"GGAACCCAGCCATTCA"	"Cyst.TAL_2"
"GGAACCCAGCCGTAAG"	"Cyst.PT_1"
"GGAACCCCACCATAAC"	"Cyst.PT_3"
"GGAACCCCAGGAATCG"	"Cyst.TAL_2"
"GGAACCCGTAAGTCAA"	"Cyst.PT_2"
"GGAACCCGTCTTGTCC"	"Cyst.TAL_1"
"GGAACCCGTGAGTAGC"	"Cyst.TAL_2"
"GGAACCCTCGACGAGA"	"Cyst.TAL_1"
"GGAAGTGCACGGTGCT"	"Cyst.PT_3"
"GGAAGTGGTTACCCTC"	"Unk_2"
"GGAAGTGTCGTCGATA"	":LowQual"
"GGAAGTGTCTCACTCG"	"Cyst.PT_1"
"GGAATCTAGACCATTC"	"Cyst.PT_2"
"GGAATCTAGCACTGGA"	"Cyst.PT_2"
"GGAATCTGTCATCTAG"	"Cyst.TAL_1"
"GGAATGGCAAGGGCAT"	"Cyst.PT_2"
"GGAATGGCAGAATTCC"	"Cyst.PT_3"
"GGAATGGCATGGCCAC"	"vSMC"
"GGAATGGCATTCAGGT"	"Cyst.PT_2"
"GGAATGGGTAGCGTAG"	"Cyst.PT_1"
"GGAATGGTCTGTCGTC"	"Cyst.PT_2"
"GGACGTCCAAACTCGT"	"Cyst.PT_1"
"GGACGTCCAGAAGTGC"	"Cyst.PT_3"
"GGACGTCGTCCGGTCA"	"T-cell"
"GGAGAACAGCACAAAT"	"Cyst.PT_1"
"GGAGAACTCAGCTCTC"	"T-cell"
"GGAGAACTCATTCGTT"	"Cyst.TAL_1"
"GGAGATGCACACTTAG"	"Cyst.PT_2"
"GGAGATGGTTGCTGAT"	"Cyst.IC-A1"
"GGAGATGGTTTACTGG"	"Cyst.PT_2"
"GGAGCAAAGCTGGCTC"	"Cyst.PT_2"
"GGAGCAACACCGGAAA"	"Cyst.PT_1"
"GGAGCAACATAACAGA"	"Cyst.TAL_1"
"GGAGCAAGTGAGATCG"	"Cyst.PC"
"GGAGCAATCACTCGAA"	"Cyst.PT_1"
"GGAGCAATCTCGGCTT"	"Cyst.PT_2"
"GGAGGATAGACAACTA"	"Cyst.TAL_1"
"GGAGGATCACACTTAG"	"Cyst.PT_2"
"GGAGGATCACGGGTAA"	"Cyst.TAL_1"
"GGAGGATGTGATTCAC"	"Mac"
"GGAGGATTCCCTGTTG"	"Cyst.PT_1"
"GGAGGTAAGAACGTGC"	"EC"
"GGAGGTACAGGAATCG"	"INT"
"GGAGGTAGTAGGCAAC"	"Cyst.TAL_1"
"GGAGGTAGTCATCGCG"	"Cyst.PT_3"
"GGAGGTAGTCTTGAAC"	"Fibroblast"
"GGAGGTATCTAGCAAC"	"Cyst.TAL_1"
"GGATCTACATCAGCGC"	"Cyst.PT_2"
"GGATCTAGTACCTGTA"	"Cyst.PT_1"
"GGATCTAGTGTGCTTA"	"Cyst.PT_1"
"GGATGTTGTAGCTGTT"	"Cyst.PT_1"
"GGATGTTGTCTTAGTG"	"Cyst.PT_2"
"GGATGTTGTTCAGCGC"	"Cyst.PT_2"
"GGATGTTTCCAAGAGG"	"Cyst.PT_3"
"GGATGTTTCGGTCAGC"	"Cyst.PT_1"
"GGATGTTTCGTGGGAA"	"Cyst.PT_1"
"GGCACGTAGGCAGTCA"	"Cyst.PC"
"GGCACGTGTACGATCT"	"Cyst.TAL_2"
"GGCACGTGTCTAGGCC"	"Cyst.TAL_2"
"GGCACGTGTGTCCGGT"	"Cyst.PC"
"GGCACGTGTTCACCGG"	"Cyst.PT_2"
"GGCACGTTCAGCTGTA"	"Cyst.PC"
"GGCAGTCGTAGATGTA"	"Cyst.TAL_1"
"GGCAGTCGTCGTGCCA"	"Cyst.PC"
"GGCAGTCTCAGTGTGT"	"Cyst.TAL_1"
"GGCAGTCTCGTCAAAC"	"Cyst.PT_1"
"GGCGTCAAGAAATGGG"	"Cyst.PT_2"
"GGCGTCAAGGCGTCCT"	"Cyst.PT_1"
"GGCGTCACAGACAATA"	"Cyst.PT_2"
"GGCGTCATCGGTAAGG"	"Cyst.PT_1"
"GGCGTCATCGTCGCTT"	"Cyst.TAL_1"
"GGCGTCATCTCTCAAT"	"Cyst.PT_3"
"GGCGTCATCTGTAACG"	"Cyst.PT_1"
"GGCTGTGAGTCTCGTA"	"Cyst.PT_1"
"GGCTGTGGTAGCTAAA"	"Cyst.TAL_2"
"GGCTGTGGTCGTGGTC"	"Cyst.TAL_1"
"GGCTGTGGTGTACAGG"	"Cyst.TAL_1"
"GGCTGTGTCACGATCA"	"Fibroblast"
"GGCTGTGTCCACGTAA"	"Cyst.PT_2"
"GGCTGTGTCCGCACTT"	"Cyst.PT_1"
"GGCTTGGCACAACCGC"	"Unk_1"
"GGCTTGGCAGCACGAA"	"Cyst.TAL_1"
"GGCTTGGCAGCAGATG"	"Cyst.PT_1"
"GGCTTGGCAGGTTCCG"	"Cyst.PT_1"
"GGCTTGGTCATTCGTT"	"vSMC"
"GGCTTGGTCCATGATG"	"Cyst.PT_3"
"GGCTTGGTCCGTTGGG"	"Cyst.TAL_2"
"GGCTTTCAGGAACTCG"	"Cyst.PT_1"
"GGCTTTCCACAAAGTA"	"Cyst.TAL_1"
"GGCTTTCCAGGCTATT"	"Cyst.PT_3"
"GGCTTTCGTAGATGTA"	"Cyst.PT_3"
"GGCTTTCGTTCAAAGA"	"Cyst.PT_2"
"GGCTTTCGTTCCGTTC"	"Cyst.PT_1"
"GGCTTTCTCATTCGGA"	"Unk_1"
"GGCTTTCTCCATCCGT"	"Cyst.TAL_1"
"GGCTTTCTCTGCATAG"	"Cyst.TAL_1"
"GGGAAGTAGGGCCTCT"	"Cyst.PT_1"
"GGGAAGTCACTACGGC"	"Cyst.TAL_2"
"GGGAAGTGTACAAAGT"	"Cyst.TAL_2"
"GGGAAGTGTTCTTGCC"	"Cyst.TAL_1"
"GGGAAGTTCATTTGCT"	"Cyst.TAL_1"
"GGGAAGTTCTCTCTTC"	"Cyst.PC"
"GGGACAACACGTAACT"	"T-cell"
"GGGACCTAGCACCAGA"	"vSMC"
"GGGACCTAGCCTGAGA"	"vSMC"
"GGGACCTCAATCACGT"	"vSMC"
"GGGACCTCACCTAAAC"	"Cyst.PT_2"
"GGGACTCAGTTCCATG"	"Podocytes"
"GGGACTCCAGGGCTTC"	"Cyst.IC-A1"
"GGGACTCGTCACTTCC"	"Cyst.PT_3"
"GGGACTCGTCAGGTAG"	"Cyst.TAL_2"
"GGGACTCGTGTTAGCT"	"Unk_1"
"GGGACTCGTTGAGTCT"	"Cyst.PC"
"GGGACTCTCATACAGC"	"Cyst.PT_2"
"GGGACTCTCATAGAGA"	"Cyst.PT_1"
"GGGACTCTCGTAACAC"	"Cyst.PC"
"GGGAGATAGCAACAAT"	"Cyst.PT_2"
"GGGAGATCATCATTTC"	"Cyst.PT_3"
"GGGAGATGTCCAGTTA"	"Cyst.PT_2"
"GGGAGATGTGTACGCC"	"Cyst.PT_3"
"GGGAGATGTTTCTTAC"	"Cyst.PT_1"
"GGGAGATTCAACACGT"	"Cyst.PT_1"
"GGGAGATTCATTACGG"	"Cyst.PT_3"
"GGGAGATTCTCCAATT"	"Cyst.PC"
"GGGAGATTCTTCACAT"	"Cyst.PC"
"GGGAGATTCTTTCTAG"	"Cyst.PT_1"
"GGGAGTAGTAGTCTGT"	"Cyst.TAL_2"
"GGGAGTAGTCTTACTT"	"Cyst.TAL_2"
"GGGATCCAGCGGGTAT"	"Cyst.PT_2"
"GGGATCCAGGTTCTAC"	"Cyst.PT_1"
"GGGATCCCAGGTCAGA"	"Cyst.PT_2"
"GGGATCCCAGTCAGTT"	"Cyst.TAL_1"
"GGGATCCCATACTTTC"	"Cyst.TAL_2"
"GGGATCCGTATATGGA"	"Fibroblast"
"GGGATCCGTCAGTCCG"	"EC"
"GGGATCCGTGTGATGG"	"Cyst.TAL_2"
"GGGATCCGTTGCCATA"	"vSMC"
"GGGATCCTCGCACTCT"	"Cyst.TAL_1"
"GGGATGAAGAACTGAT"	"Cyst.PT_2"
"GGGATGAAGTCATACC"	"Cyst.PT_3"
"GGGATGACAGTCCGTG"	"Cyst.PT_2"
"GGGATGAGTAGAGATT"	"Cyst.PC"
"GGGATGAGTCTCCCTA"	"Cyst.PT_2"
"GGGATGATCGTCCATC"	"Cyst.TAL_1"
"GGGCCATGTGTCGCTG"	"Cyst.PT_3"
"GGGCCATTCACAAGAA"	"Cyst.TAL_1"
"GGGCCATTCTGCGGAC"	"Cyst.TAL_1"
"GGGCGTTAGATGTTGA"	"Cyst.PT_1"
"GGGCGTTCAGTAGATA"	"Cyst.TAL_2"
"GGGCGTTGTATCACGT"	"Cyst.TAL_1"
"GGGCGTTGTGATTCAC"	"Cyst.PT_2"
"GGGCGTTGTGTAAATG"	"Cyst.PT_3"
"GGGCGTTTCAGACTGT"	"Cyst.PT_1"
"GGGCTACAGCTGTACT"	"Cyst.PT_1"
"GGGCTACTCAATGTCG"	"Cyst.TAL_1"
"GGGCTACTCACAGAGG"	"Cyst.PT_1"
"GGGCTACTCCTCATAT"	"Cyst.PT_1"
"GGGCTACTCGACCATA"	"Cyst.PT_1"
"GGGCTCACAACGCATT"	"Cyst.TAL_2"
"GGGCTCACATCCGCGA"	"EC"
"GGGCTCAGTGTTTGCA"	"Cyst.TAL_1"
"GGGCTCATCTGCGAGC"	"Cyst.TAL_1"
"GGGTAGAAGGGCCTCT"	"Podocytes"
"GGGTAGACAGCATTGT"	"Cyst.PT_3"
"GGGTAGACATAGTCGT"	"Cyst.PT_2"
"GGGTAGACATGACAGG"	"Cyst.PT_1"
"GGGTATTCAGCTGCCA"	"Mac"
"GGGTATTGTCCGAAAG"	"Cyst.TAL_1"
"GGGTATTTCGACGTCG"	"Cyst.IC-A1"
"GGGTATTTCGTTACCC"	"Cyst.PT_2"
"GGGTCACCACGCACCA"	"Cyst.PT_1"
"GGGTCACGTAGACAGC"	"Cyst.TAL_1"
"GGGTCACGTCGTGTTA"	"Cyst.PT_1"
"GGGTCACGTTGCAAGG"	"Cyst.TAL_1"
"GGGTCACTCGTGTGAT"	"Cyst.PT_3"
"GGGTCTGAGCCTTCTC"	"Cyst.PT_3"
"GGGTCTGAGCGTCTGC"	"vSMC"
"GGGTCTGAGGCACTAG"	"Cyst.PT_2"
"GGGTCTGCAGGTCCCA"	"Cyst.PT_1"
"GGGTCTGGTAGATTGA"	"Cyst.PT_2"
"GGGTCTGGTCCTGTTC"	"Cyst.PT_2"
"GGGTCTGTCAACGTGT"	"Cyst.PT_2"
"GGGTCTGTCGAGTCTA"	"Cyst.PC"
"GGGTGAAAGACCTCAT"	"Cyst.PT_3"
"GGGTGAAAGACGCCCT"	"Cyst.PC"
"GGGTGAACACATATGC"	"Cyst.PT_2"
"GGGTGAAGTAAGATTG"	"Cyst.TAL_1"
"GGGTGAAGTAGACGTG"	"Cyst.PT_3"
"GGGTGAATCATCCTGC"	"Cyst.PT_1"
"GGGTGAATCCACTAGA"	"Fibroblast"
"GGGTGAATCCTATTTG"	"Cyst.PT_2"
"GGGTGAATCTTCTCAA"	"EC"
"GGGTGTCAGGGTTAAT"	"Unk_2"
"GGGTGTCTCGCCAGTG"	"Cyst.PT_1"
"GGGTTATAGACGGTTG"	"Cyst.PC"
"GGGTTATAGGCGAAGG"	"Cyst.PT_1"
"GGGTTATAGGTAATCA"	"Cyst.PT_2"
"GGGTTATAGGTCATCT"	"Cyst.PT_2"
"GGGTTATGTACGTAGG"	"Cyst.PT_1"
"GGGTTATGTCACCGCA"	"Cyst.PT_1"
"GGGTTATGTGCTTCAA"	"Cyst.TAL_1"
"GGGTTATGTGGGCTTC"	"Cyst.PT_2"
"GGGTTATGTTGGGTTT"	"Cyst.PT_3"
"GGGTTTACAAGTCCAT"	"Cyst.TAL_2"
"GGGTTTACACCAAAGG"	"Cyst.TAL_2"
"GGGTTTACACCGAATT"	"vSMC"
"GGGTTTATCCATTTAC"	"Cyst.PC"
"GGTAACTAGCTACTGT"	"Cyst.TAL_1"
"GGTAACTAGGTGGTTG"	"Cyst.PT_2"
"GGTAACTCACTGCGAC"	"Fibroblast"
"GGTAACTCATGACTTG"	"Cyst.PT_1"
"GGTAACTCATTGGCAT"	"Cyst.TAL_2"
"GGTAACTGTATTGACC"	"Cyst.TAL_2"
"GGTAACTGTTCATCTT"	"Fibroblast"
"GGTAACTTCACCATCC"	"Cyst.PT_1"
"GGTAACTTCGGCTGTG"	"Cyst.PT_2"
"GGTAACTTCGGTAGGA"	"Cyst.PT_2"
"GGTAATCGTACACGTT"	"Cyst.PC"
"GGTAATCTCTTCTGGC"	"Cyst.PT_1"
"GGTAGAGAGTGGTTGG"	"Cyst.PT_2"
"GGTAGAGCACAACCGC"	"Cyst.PT_3"
"GGTAGAGCACGACGTC"	"vSMC"
"GGTAGAGCAGACACAG"	"Cyst.PC"
"GGTAGAGGTCTTACAG"	"Cyst.PT_1"
"GGTAGAGTCAGAGTGG"	"Cyst.TAL_1"
"GGTAGAGTCCAAATGC"	"EC"
"GGTCACGAGACGTCGA"	"Cyst.PC"
"GGTCACGAGTGGAAGA"	"Cyst.TAL_2"
"GGTCACGAGTGTACAA"	"Podocytes"
"GGTCACGCAACAGATA"	"Cyst.IC-A1"
"GGTCACGCAGCGTAGA"	"Cyst.TAL_2"
"GGTCACGCATCACCAA"	"Cyst.PT_1"
"GGTCACGTCCTTCGAC"	"Cyst.PT_2"
"GGTCTGGGTCGCTCGA"	"Cyst.PT_1"
"GGTGAAGGTAGAAACT"	"Cyst.PC"
"GGTGAAGTCAAGGACG"	"Cyst.PT_2"
"GGTGATTCAAATCGGG"	"Fibroblast"
"GGTGATTGTTCCAAAC"	"Cyst.PT_1"
"GGTGATTTCACTGTCC"	"Cyst.PT_1"
"GGTGGCTGTCTACGAT"	"Cyst.PT_1"
"GGTGGCTTCATTTGTC"	"Cyst.PT_1"
"GGTGGCTTCGGTCTAA"	"EC"
"GGTGTCGAGCCTGAAG"	"Cyst.TAL_1"
"GGTGTCGAGTTTCGGT"	"Cyst.PT_2"
"GGTGTCGCACTCAAGT"	"Cyst.PT_1"
"GGTGTCGCATCTATCT"	"Cyst.PT_1"
"GGTGTCGGTGTAGTGG"	"Cyst.TAL_1"
"GGTGTCGGTTCAAGGG"	"Cyst.PT_3"
"GGTGTCGTCAAACGTC"	"Cyst.PT_1"
"GGTGTCGTCTAGTGAC"	"Cyst.PC"
"GGTGTTAAGGGAGGTG"	"Cyst.PT_2"
"GGTGTTAAGTCACAGG"	"Cyst.PT_2"
"GGTGTTACAATACGCT"	"Cyst.TAL_2"
"GGTGTTATCTAGTGTG"	"Podocytes"
"GGTTAACAGTTGTACC"	"Cyst.PT_2"
"GGTTAACCAAAGCAAT"	"Cyst.TAL_1"
"GGTTAACTCAGTCTTT"	"Cyst.PT_1"
"GGTTCTCAGGTAGACC"	"Cyst.PT_2"
"GGTTCTCAGTCACTCA"	"Cyst.PT_2"
"GGTTCTCCAAGGTCGA"	"Cyst.PT_2"
"GGTTCTCCACCCTATC"	"Cyst.PT_1"
"GGTTCTCCAGCTGTCG"	"Cyst.PT_1"
"GGTTCTCCATATCTGG"	"Cyst.PT_1"
"GGTTCTCGTACCGGCT"	"vSMC"
"GGTTCTCTCCGCTTAC"	"Cyst.TAL_1"
"GGTTCTCTCGTGCACG"	"Cyst.PT_1"
"GGTTCTCTCTCGACGG"	"Fibroblast"
"GGTTCTCTCTTCTGTA"	"Cyst.PT_2"
"GGTTGTACAGAATGTA"	"Cyst.PT_2"
"GGTTGTACATGCGTGC"	"Cyst.TAL_2"
"GGTTGTAGTACCTTCC"	"Cyst.PC"
"GGTTGTAGTAGCTGTT"	"Cyst.PT_2"
"GTAACACGTAGGTACG"	"Cyst.PT_3"
"GTAACACGTCCATAGT"	"vSMC"
"GTAACCAAGGACTGGT"	"Cyst.PT_1"
"GTAACCACAATTTCTC"	"Cyst.TAL_2"
"GTAACCAGTGCCGGTT"	"Cyst.PT_1"
"GTAACCAGTTCCGGTG"	"Cyst.PT_1"
"GTAACCAGTTGTGTTG"	"Cyst.TAL_2"
"GTAACCATCCGTTGGG"	"Cyst.PT_2"
"GTAACCATCGTTCAGA"	"Cyst.PT_2"
"GTAAGTCAGGTCGACA"	"Cyst.TAL_1"
"GTAAGTCCAATTGCCA"	"Unk_2"
"GTAAGTCCACCTCTAC"	"Cyst.PT_1"
"GTAAGTCCACGATTCA"	"Cyst.PT_3"
"GTAAGTCCAGTTCTAG"	"Cyst.PT_1"
"GTAAGTCGTTCGGCCA"	"Cyst.PT_2"
"GTAAGTCTCCCGTTGT"	"Cyst.PT_1"
"GTAATCGAGAATCGCG"	"Cyst.PT_2"
"GTAATCGAGAGATTCA"	"Cyst.PT_2"
"GTAATCGCAAGGTCGA"	"Cyst.PT_3"
"GTAATCGGTTATAGCC"	"Cyst.PT_2"
"GTAATCGGTTTGATCG"	"Cyst.TAL_2"
"GTAATCGTCTATCCAT"	"Cyst.TAL_1"
"GTAATCGTCTGCTGAA"	"Podocytes"
"GTAATGCAGCCAAGTG"	"Cyst.PT_1"
"GTAATGCCAAGCTCTA"	"Cyst.TAL_2"
"GTAATGCCACAAATGA"	"Cyst.PT_3"
"GTAATGCGTATATGGA"	"Cyst.TAL_1"
"GTACAACAGGCTATCT"	"Cyst.PT_2"
"GTACAACCAGGTTTAC"	"Cyst.PT_1"
"GTACAACGTCAGATTC"	"Cyst.PT_2"
"GTACAACGTCTCCTGT"	"Cyst.PT_1"
"GTACAACGTCTCGCGA"	"Cyst.PT_1"
"GTACAACTCCGGACTG"	"Cyst.TAL_2"
"GTACAACTCTCTGAGA"	"Cyst.TAL_1"
"GTACAGTCACGTAACT"	"Cyst.TAL_2"
"GTACAGTGTACGGATG"	"Cyst.PT_3"
"GTACAGTTCTAAGAAG"	"Cyst.PT_3"
"GTACAGTTCTCCGAAA"	"Cyst.PT_1"
"GTACAGTTCTCTGACC"	"Cyst.PT_2"
"GTAGAAAAGATAGGGA"	"Unk_1"
"GTAGAAAAGCTCGAAG"	"Cyst.TAL_2"
"GTAGAAAAGTAAACAC"	"Cyst.PT_1"
"GTAGAAAAGTTACGTC"	"Cyst.PT_2"
"GTAGAAAGTCACTACA"	"Cyst.PT_2"
"GTAGAAAGTGTGTTTG"	"Cyst.PT_2"
"GTAGAAATCGTTCGCT"	"Fibroblast"
"GTAGAGGAGTGCCGAA"	"Cyst.TAL_1"
"GTAGAGGCAAATAAGC"	"Cyst.TAL_1"
"GTAGAGGCAAGTTTGC"	"Cyst.TAL_1"
"GTAGAGGCACGAGGTA"	"EC"
"GTAGAGGGTCATTCCC"	"Cyst.TAL_1"
"GTAGAGGGTGCCCACA"	"Unk_2"
"GTAGAGGTCAACTGAC"	"Cyst.PT_1"
"GTAGAGGTCCCAGGAC"	"Cyst.PT_2"
"GTAGAGGTCCTGGTCT"	"Cyst.PC"
"GTAGAGGTCTTAGCTT"	"Cyst.PT_1"
"GTAGAGGTCTTCCCGA"	"Cyst.PT_3"
"GTAGATCAGACTCTTG"	"Cyst.PT_3"
"GTAGATCAGCCATTTG"	"Cyst.PT_1"
"GTAGATCAGGACTGGT"	"Cyst.PC"
"GTAGATCGTACAGGTG"	"Cyst.PT_2"
"GTAGATCGTCCCGTGA"	"Cyst.PT_3"
"GTAGATCTCGTGTGGC"	"Cyst.PC"
"GTAGCTAAGAGGATCC"	"Mac"
"GTAGCTACAAATACAG"	"Cyst.PT_1"
"GTAGCTACAAGGATGC"	"Cyst.PT_3"
"GTAGCTATCACACCGG"	"Cyst.TAL_1"
"GTAGCTATCCCATGGG"	"Cyst.PT_3"
"GTAGCTATCGAGGCAA"	"Cyst.TAL_1"
"GTAGCTATCGGAAGGT"	"Cyst.PC"
"GTAGCTATCTAGGCAT"	"Cyst.PT_1"
"GTAGGAGAGAGGCGGA"	"Cyst.PT_1"
"GTAGGAGCATATGGCT"	"Cyst.PT_3"
"GTAGGAGTCAGGAGAC"	"Mac"
"GTAGGAGTCTAGCAAC"	"vSMC"
"GTAGGTTAGAGGGTCT"	"Cyst.PT_1"
"GTAGGTTAGTCGTTAC"	"Mac"
"GTAGGTTCAAGCCCAC"	"Cyst.TAL_1"
"GTAGGTTCAAGGTCGA"	"Cyst.TAL_2"
"GTAGGTTGTGTTCCTC"	"EC"
"GTAGGTTGTTGTAAAG"	"Cyst.PT_3"
"GTAGGTTTCCCGAAAT"	"Cyst.PT_1"
"GTAGGTTTCGAATCCA"	"EC"
"GTAGGTTTCGGTCATA"	"Fibroblast"
"GTAGTACGTTCCTAAG"	"Cyst.PT_3"
"GTAGTACTCTTTACAC"	"Cyst.TAL_1"
"GTATTGGAGCATCCTA"	"Fibroblast"
"GTATTGGCACAGAAGC"	"Podocytes"
"GTATTGGCACGGTGAA"	"Cyst.PT_2"
"GTATTGGCATGTACGT"	"EC"
"GTATTGGGTAGGACTG"	"Cyst.TAL_1"
"GTATTGGGTATCATGC"	"Cyst.PT_1"
"GTATTGGGTTCTTCAT"	"Cyst.PT_2"
"GTATTGGTCCTTTGAT"	"Mac"
"GTATTGGTCGTTTACT"	"Cyst.PT_1"
"GTATTGGTCTGAATCG"	"Cyst.PT_1"
"GTATTTCAGCGACATG"	"vSMC"
"GTATTTCAGGCTAACG"	"Cyst.TAL_2"
"GTATTTCAGTAACAGT"	"Cyst.TAL_1"
"GTATTTCGTTAGTTCG"	"Podocytes"
"GTATTTCTCGCTTGAA"	"Cyst.PT_1"
"GTCAAACCATGTTTGG"	"Cyst.PT_1"
"GTCAAACGTAGGATAT"	"vSMC"
"GTCAAACGTCAATCTG"	"Cyst.PT_2"
"GTCAAACGTGGTTCTA"	"Fibroblast"
"GTCAAACTCGCTACAA"	"Cyst.PT_2"
"GTCAAACTCTTCCACG"	"Cyst.PC"
"GTCAAGTCAGAGTCAG"	"Cyst.TAL_1"
"GTCAAGTCAGTAACAA"	"Cyst.PT_1"
"GTCAAGTGTAGCACAG"	"Cyst.PT_3"
"GTCAAGTTCGGCTGAC"	"Cyst.PT_3"
"GTCACGGAGTAGTCAA"	"Cyst.PT_2"
"GTCACGGTCCAAATGC"	"Cyst.PT_3"
"GTCACGGTCCATCTCG"	"Cyst.PT_2"
"GTCACGGTCGAACTCA"	"Cyst.PT_3"
"GTCACTCAGATTGCGG"	"Cyst.PT_1"
"GTCACTCAGCCTGACC"	"vSMC"
"GTCACTCAGGGTAGCT"	"Cyst.PT_1"
"GTCACTCTCTCACTCG"	"Cyst.PT_2"
"GTCAGCGAGGACACTG"	"Cyst.PT_2"
"GTCAGCGAGTAAACTG"	"Cyst.PT_3"
"GTCAGCGAGTCTGCGC"	"Cyst.PT_1"
"GTCAGCGCAACCGATT"	"Cyst.PT_1"
"GTCAGCGCATCACAGT"	"Cyst.PT_2"
"GTCAGCGGTCGGCCTA"	"Cyst.PT_2"
"GTCAGCGTCAACCGAT"	"Cyst.PT_1"
"GTCAGCGTCGCATTGA"	"Cyst.TAL_2"
"GTCAGCGTCGCTAAAC"	"Cyst.PT_3"
"GTCAGCGTCTGACAGT"	"Cyst.PT_2"
"GTCATCCCAGAACGCA"	"Cyst.PT_2"
"GTCATCCGTAAGGAGA"	"Cyst.TAL_1"
"GTCATCCTCCATTCGC"	"Cyst.PT_2"
"GTCATCCTCGACGCGT"	"Cyst.PT_3"
"GTCATCCTCGGCCTTT"	"EC"
"GTCATCCTCGTGGACC"	"Cyst.TAL_1"
"GTCATGAAGATGGTCG"	"Cyst.TAL_1"
"GTCATGAAGCACTTTG"	"Cyst.PT_1"
"GTCATGACAGCAGGAT"	"Cyst.PT_3"
"GTCATGACATAGATCC"	"Cyst.TAL_2"
"GTCATGACATGTGCTA"	"Cyst.PT_2"
"GTCATGAGTACGATGG"	"Cyst.TAL_2"
"GTCATGAGTATCCTCC"	"Cyst.PT_2"
"GTCATGAGTGGTTTAC"	"Cyst.PT_1"
"GTCATGAGTTAGGGTG"	"Cyst.PC"
"GTCATGATCATCTACT"	"Cyst.TAL_1"
"GTCATTTGTGCCGGTT"	"Cyst.PT_1"
"GTCATTTGTTAAACCC"	"Cyst.PC"
"GTCATTTGTTGCATTG"	"Fibroblast"
"GTCATTTTCACCCATC"	":LowQual"
"GTCCACTAGCTAGCCC"	"Cyst.PT_1"
"GTCCACTTCAATCCGA"	"Mac"
"GTCCACTTCGCTTAAG"	"Cyst.TAL_2"
"GTCCACTTCGTGAGAG"	"T-cell"
"GTCCACTTCTGGAAGG"	"Cyst.TAL_1"
"GTCCCATAGCATGCAG"	"Cyst.PT_2"
"GTCCCATAGTCGTTAC"	"EC"
"GTCCCATAGTGGTTCT"	"EC"
"GTCCCATCAACCAATC"	"Podocytes"
"GTCCCATCAAGTTCCA"	"Podocytes"
"GTCCTCACAGAAGTGC"	"EC"
"GTCCTCACAGAGGAAA"	"Cyst.TAL_1"
"GTCCTCAGTATTCCTT"	"Cyst.IC-A1"
"GTCCTCAGTGGAAGTC"	"Cyst.PT_2"
"GTCCTCAGTTATCTTC"	"Cyst.PT_2"
"GTCCTCAGTTCTGACA"	"Cyst.PT_1"
"GTCCTCATCATTTACC"	"Cyst.PT_1"
"GTCCTCATCGGACCAC"	"Cyst.PT_1"
"GTCCTCATCTCCCATG"	"Podocytes"
"GTCGAATGTGGGTTGA"	"Cyst.TAL_1"
"GTCGAATTCAGCTTGA"	"Cyst.PT_1"
"GTCGAATTCCAAGCTA"	"vSMC"
"GTCGAATTCCGATGCG"	"Unk_1"
"GTCGAATTCGTCTCAC"	"Cyst.PT_1"
"GTCGAATTCTCGCCTA"	"Cyst.PT_3"
"GTCGAATTCTGGCTGG"	"Cyst.PT_1"
"GTCGCGACAAGATGTA"	"Cyst.TAL_2"
"GTCGCGACAGTTACCA"	"Cyst.TAL_1"
"GTCGCGACATACTGTG"	"Cyst.PT_3"
"GTCGCGACATTCTCCG"	"Cyst.PT_1"
"GTCGCGATCCCTCGTA"	"Cyst.PT_2"
"GTCGTAAAGATCGCCC"	"Unk_1"
"GTCGTAACAAGAGTTA"	"Cyst.PT_1"
"GTCGTAACAAGCACCC"	"Cyst.PT_1"
"GTCGTAACACTGTCGG"	"Cyst.PT_3"
"GTCGTAACAGACCTGC"	"Cyst.TAL_2"
"GTCGTAACAGCTACAT"	"vSMC"
"GTCGTAATCAAGCTGT"	"Podocytes"
"GTCGTAATCTGACAGT"	"Cyst.PT_3"
"GTCGTTCCACACCTTC"	"Cyst.PC"
"GTCGTTCTCCTACCAC"	"EC"
"GTCTACCAGATACGAT"	"Cyst.PT_3"
"GTCTACCAGCTCGCAC"	"Cyst.PT_1"
"GTCTACCCAAGACAAT"	"Cyst.TAL_1"
"GTCTACCCAGAAACCG"	"Cyst.TAL_2"
"GTCTACCCAGCACGAA"	"Cyst.PT_1"
"GTCTACCGTTCGATTG"	"Cyst.TAL_2"
"GTCTACCTCCATTGTT"	"T-cell"
"GTCTAGAAGAGGTCGT"	"Cyst.TAL_1"
"GTCTAGAAGCATCCTA"	"Cyst.PT_2"
"GTCTAGAAGGTGATAT"	"Fibroblast"
"GTCTAGACAACAGAGC"	"Cyst.PT_3"
"GTCTAGACAATTTCTC"	"Cyst.TAL_1"
"GTCTAGATCAACACGT"	"Cyst.PT_2"
"GTCTAGATCAGCCTTC"	"Fibroblast"
"GTCTAGATCCACTAGA"	"Cyst.TAL_1"
"GTCTAGATCCATCTCG"	"Cyst.IC-A1"
"GTCTCACAGCGGGTAT"	"Cyst.PT_1"
"GTCTCACAGCGTCTCG"	"Cyst.PT_3"
"GTCTCACAGTTGCGCC"	"Cyst.PT_1"
"GTCTCACCACGCCACA"	"Cyst.PT_2"
"GTCTCACCATTGACTG"	"Cyst.PT_3"
"GTCTCACGTGTGTCCG"	"Mac"
"GTCTCACTCCATACAG"	"Cyst.PT_1"
"GTCTCACTCTCCAATT"	"Cyst.PT_1"
"GTCTGTCAGGTCCGAA"	"Cyst.TAL_1"
"GTCTGTCAGTCTCTGA"	"Cyst.TAL_2"
"GTCTGTCCAACCAATC"	"Cyst.PT_1"
"GTCTGTCCACCCAATA"	"Cyst.PT_2"
"GTCTGTCTCAGACTGT"	"Cyst.PC"
"GTCTGTCTCGACGACC"	"EC"
"GTCTTTACACCACTGG"	"Cyst.TAL_1"
"GTCTTTACACGTCGGT"	"Cyst.TAL_2"
"GTCTTTATCCATAAGC"	"Mac"
"GTCTTTATCCATTGCC"	"Cyst.TAL_1"
"GTGACGCAGCTCGTGC"	"Cyst.TAL_1"
"GTGACGCAGGCAGGGA"	"Cyst.TAL_1"
"GTGACGCAGGTTCATC"	"vSMC"
"GTGACGCAGTCACTGT"	"Cyst.PT_1"
"GTGACGCGTGAGGAAA"	"Cyst.TAL_1"
"GTGACGCGTTACCGTA"	"Cyst.PT_2"
"GTGACGCTCATTCGGA"	"Cyst.PT_2"
"GTGACGCTCCACTAGA"	"INT"
"GTGACGCTCGTTCGCT"	"Cyst.PT_3"
"GTGAGCCCAAGGCAAC"	"Cyst.PT_3"
"GTGAGCCCAGACCATT"	"Cyst.PT_1"
"GTGAGCCGTCACCCTT"	"T-cell"
"GTGAGCCTCCCTGTTG"	"Cyst.PT_2"
"GTGAGGACAAGCCCAC"	"EC"
"GTGAGGAGTGAGTTGG"	"Cyst.TAL_2"
"GTGAGGAGTTATTCCT"	"Cyst.PT_2"
"GTGAGGATCTGAGCAT"	"Cyst.PT_2"
"GTGAGTTAGTCGGGAT"	"Cyst.PT_1"
"GTGAGTTCACATAACC"	"Cyst.PT_3"
"GTGAGTTCACTGGACC"	"Cyst.TAL_2"
"GTGAGTTCAGCTATTG"	"Cyst.PT_1"
"GTGAGTTGTAGCGATG"	"Cyst.PT_2"
"GTGAGTTGTGGGTCAA"	"Cyst.PT_1"
"GTGAGTTGTTATTCTC"	"Cyst.PT_2"
"GTGAGTTTCACCCTCA"	"Cyst.PT_1"
"GTGAGTTTCTAAGGAA"	"Cyst.TAL_1"
"GTGATGTAGGTCCGAA"	"Cyst.PT_1"
"GTGATGTAGTGGTTGG"	"Cyst.PT_1"
"GTGATGTGTCTCTCTG"	"Cyst.PC"
"GTGATGTGTTCAGCTA"	"Cyst.PC"
"GTGATGTTCACGGGCT"	"Cyst.PT_1"
"GTGCACGGTAGAAACT"	"Podocytes"
"GTGCACGTCATTGCCC"	"Cyst.TAL_1"
"GTGCACGTCCACGTCT"	"Cyst.PT_2"
"GTGCAGCAGCCGTCGT"	"EC"
"GTGCAGCAGGTTCAGG"	"EC"
"GTGCAGCGTTGCATCA"	"Cyst.ATL"
"GTGCAGCGTTTGTGGT"	"T-cell"
"GTGCAGCTCATAGACC"	"Cyst.TAL_2"
"GTGCAGCTCCGCAACG"	"Cyst.PT_2"
"GTGCAGCTCGTAGAGG"	"Cyst.PT_1"
"GTGCGTGGTCCTTTGC"	"Cyst.TAL_2"
"GTGCGTGGTCGTGTTA"	"Cyst.PT_2"
"GTGCGTGTCCGGTTCT"	"Cyst.PT_1"
"GTGCTGGCATAACGGG"	"Cyst.TAL_2"
"GTGCTGGGTACCGCGT"	"Cyst.TAL_1"
"GTGCTGGTCAAGGACG"	"Cyst.PT_3"
"GTGCTTCAGACTACCT"	"Cyst.PT_3"
"GTGCTTCAGTATGAAC"	"Cyst.PT_1"
"GTGCTTCAGTGCACTT"	"Cyst.PT_1"
"GTGCTTCCAGCTAACT"	"Cyst.PC"
"GTGCTTCCAGGTTTAC"	"EC"
"GTGCTTCGTCACTCGG"	"Cyst.PT_3"
"GTGCTTCGTTTCGATG"	"Cyst.PC"
"GTGCTTCTCACTGAAC"	"Cyst.PT_1"
"GTGCTTCTCTGCGTCT"	"Cyst.IC-A1"
"GTGGAAGAGTAGGGTC"	"Cyst.PT_1"
"GTGGAAGCAGCATGCC"	"Cyst.PT_1"
"GTGGAAGGTATTCCGA"	"Cyst.PT_1"
"GTGGAAGGTCACTGAT"	"Cyst.PT_1"
"GTGGAAGGTGGCGCTT"	"EC"
"GTGGAAGGTGTGAATA"	"Cyst.TAL_1"
"GTGGAAGGTTGCGGCT"	"Cyst.PC"
"GTGGAAGTCCGCAAAT"	"Mac"
"GTGGAGAAGCACCCAC"	"Cyst.TAL_1"
"GTGGAGAAGGATGCGT"	"EC"
"GTGGAGAAGTACTGTC"	"Cyst.PT_1"
"GTGGAGAGTCTTAGTG"	"Unk_2"
"GTGGAGAGTTGGGCCT"	"Cyst.PT_1"
"GTGGCGTAGGCACTCC"	"Cyst.TAL_1"
"GTGGCGTCACAGACGA"	"Cyst.TAL_1"
"GTGGCGTTCGACCAAT"	"Cyst.PT_1"
"GTGGCGTTCTCCCTAG"	"Cyst.PT_1"
"GTGGGAACAAAGGGTC"	"Cyst.TAL_1"
"GTGGGAACAGCATCTA"	"Cyst.PT_2"
"GTGGGAATCCGTTTCG"	"Cyst.TAL_1"
"GTGGTTAAGAATAGTC"	"Cyst.PT_3"
"GTGGTTAAGAGACAAG"	"Cyst.TAL_2"
"GTGGTTAAGTAGACAT"	"Cyst.IC-A1"
"GTGGTTACAAATGGAT"	"Cyst.PT_2"
"GTGGTTACAAGTGGCA"	":LowQual"
"GTGGTTACACCCTAAA"	"vSMC"
"GTGGTTAGTAAGTTAG"	"Cyst.PT_1"
"GTGGTTAGTACGTGTT"	"Cyst.TAL_1"
"GTGGTTAGTCGTGTTA"	"Cyst.PT_1"
"GTGGTTAGTCTTAGTG"	"Cyst.PT_1"
"GTGGTTAGTCTTTCTA"	"Cyst.PT_3"
"GTGGTTAGTTACGATC"	"Cyst.PT_3"
"GTGGTTATCTTTGCTA"	"Cyst.TAL_1"
"GTGTAACAGGTGAGAA"	"Cyst.TAL_2"
"GTGTAACGTACTGGGA"	"Cyst.TAL_2"
"GTGTAACTCTACGCAA"	"Cyst.TAL_1"
"GTGTAACTCTCCATAT"	"Cyst.PT_1"
"GTGTAACTCTTCACAT"	"Cyst.PT_1"
"GTGTCCTGTTGTCCCT"	"Cyst.PT_3"
"GTGTCCTTCAAATAGG"	"Podocytes"
"GTGTCCTTCCACCCTA"	"vSMC"
"GTGTGATCAAACAGGC"	"Cyst.TAL_1"
"GTGTGATCACGTCGGT"	"Cyst.IC-A1"
"GTGTGATCATTCACAG"	"vSMC"
"GTGTGATGTAAGGTCG"	"Cyst.PC"
"GTGTGATGTGTACATC"	"T-cell"
"GTGTGGCAGCAGTAAT"	"Cyst.PT_1"
"GTGTGGCAGGTATTGA"	"Cyst.PC"
"GTGTGGCCACGAAGAC"	"EC"
"GTGTGGCCATTCACCC"	"Cyst.PC"
"GTGTTAGAGTAAGAGG"	"Cyst.PT_1"
"GTGTTAGAGTTGCCCG"	"Cyst.PT_3"
"GTGTTAGCAACGTTAC"	":LowQual"
"GTGTTAGGTGCTGATT"	"Cyst.PC"
"GTGTTAGGTTAGAGTA"	"Cyst.TAL_2"
"GTGTTCCAGGTGCTTT"	"Cyst.PC"
"GTGTTCCCACGGCCAT"	"Cyst.TAL_2"
"GTGTTCCCATAGACTC"	"Cyst.PT_2"
"GTGTTCCCATGGAACG"	"EC"
"GTGTTCCGTAAGACCG"	"Cyst.PC"
"GTGTTCCGTGGTTTGT"	"Fibroblast"
"GTGTTCCGTTAAGAAC"	"Cyst.PT_2"
"GTGTTCCTCAGTCCGG"	"Cyst.TAL_1"
"GTTACAGAGGGACTGT"	"Cyst.PT_2"
"GTTACAGGTCGACTGC"	"Cyst.PT_3"
"GTTACAGGTTAGTTCG"	"Cyst.TAL_2"
"GTTACCCAGCAGATAT"	"Cyst.PT_1"
"GTTACCCCAAATCGTC"	"Cyst.PT_2"
"GTTACCCCAGGCGATA"	"Cyst.TAL_1"
"GTTACCCTCCAAACCA"	"Cyst.TAL_1"
"GTTACCCTCCCGAAAT"	"Cyst.TAL_2"
"GTTACGAAGTATAGGT"	"Cyst.TAL_2"
"GTTAGACAGATCGACG"	"Cyst.PT_1"
"GTTAGACCACCTCGTT"	"Cyst.PC"
"GTTAGACGTCAGACGA"	"Cyst.TAL_1"
"GTTAGACTCAGACTGT"	"Cyst.PT_2"
"GTTAGTGAGTTAACAG"	"Cyst.TAL_1"
"GTTAGTGCACACGCCA"	"Cyst.PT_1"
"GTTAGTGCATACCAGT"	"Cyst.PT_2"
"GTTAGTGGTTTCTATC"	"Cyst.PT_1"
"GTTAGTGTCCTTATGT"	"Cyst.PT_1"
"GTTAGTGTCTAAGAAG"	"Cyst.TAL_1"
"GTTATGGAGACCATGG"	"Cyst.PT_2"
"GTTATGGCAGAAGTTA"	"Cyst.PT_2"
"GTTATGGCATATGCGT"	"EC"
"GTTCATTAGGTATAGT"	"Cyst.TAL_1"
"GTTCATTCACCGGTCA"	"Cyst.TAL_1"
"GTTCATTCACTACCCT"	"Cyst.PT_1"
"GTTCATTCATAACGGG"	"Cyst.TAL_1"
"GTTCATTGTATCCCTC"	"Cyst.PT_1"
"GTTCATTTCTCAGTCC"	"Cyst.PT_2"
"GTTCATTTCTGACAGT"	"Cyst.PC"
"GTTCCGTAGACAAGCC"	"T-cell"
"GTTCCGTGTGACTCGC"	"Cyst.PT_3"
"GTTCCGTGTTTGCCGG"	"Cyst.PT_1"
"GTTCCGTTCTACAGGT"	"Cyst.PT_1"
"GTTCGCTAGATTGACA"	"Cyst.TAL_1"
"GTTCGCTAGCATGGGT"	"Cyst.PT_1"
"GTTCGCTAGCGCCTTG"	"Mac"
"GTTCGCTCAAGATGGC"	"Cyst.PT_1"
"GTTCGCTCATGAATAG"	"Cyst.TAL_2"
"GTTCGCTGTACACGCC"	"Cyst.TAL_1"
"GTTCGCTTCTCAAAGC"	"Cyst.PT_1"
"GTTCTATAGGTAGGCT"	"Cyst.PT_1"
"GTTCTATCACATGTTG"	"Cyst.PT_3"
"GTTCTATGTTATTCTC"	"Cyst.PT_3"
"GTTGAACAGTAAAGCT"	"Cyst.PT_3"
"GTTGAACCACAAAGTA"	"EC"
"GTTGAACGTACTCGAT"	"Cyst.PT_1"
"GTTGAACGTCCAGAAG"	"vSMC"
"GTTGAACGTCCTGGTG"	"Cyst.PT_3"
"GTTGAACTCAAGGTGG"	"Cyst.PT_3"
"GTTGAACTCCTTATGT"	"Cyst.TAL_2"
"GTTGCGGCATGGGTTT"	"Unk_2"
"GTTGCGGCATGTCAGT"	"Cyst.PT_3"
"GTTGCGGGTCAATCTG"	"Cyst.PT_1"
"GTTGCGGGTCTAGGCC"	"Cyst.PT_1"
"GTTGCGGTCAAGCCAT"	"Cyst.PT_1"
"GTTGCGGTCCAATCCC"	"Cyst.PC"
"GTTGCTCAGCCGGATA"	"Cyst.PT_1"
"GTTGCTCAGTAGGAAG"	"Cyst.TAL_2"
"GTTGCTCCACCCAAGC"	"Cyst.PT_1"
"GTTGCTCGTCGCTGCA"	"T-cell"
"GTTGCTCGTGTCCCTT"	"vSMC"
"GTTGCTCTCCATCTGC"	"Fibroblast"
"GTTGCTCTCGCAGTGC"	"Cyst.TAL_1"
"GTTGTAGCAGCGCGTT"	"Cyst.TAL_1"
"GTTGTAGGTACTCGAT"	"Cyst.PT_3"
"GTTGTAGGTCCTTTGC"	"Cyst.IC-A1"
"GTTGTAGGTGCCTTCT"	"Cyst.PT_2"
"GTTGTAGGTTGTAGCT"	"Cyst.PT_2"
"GTTGTCCAGCGGTAGT"	"Cyst.PT_2"
"GTTGTCCAGCGTGCTC"	"Cyst.TAL_2"
"GTTGTCCAGGCTCAAG"	"Cyst.TAL_1"
"GTTGTCCCAATTGGTC"	"Cyst.PT_1"
"GTTGTCCCAGCTTCGG"	"vSMC"
"GTTGTCCCAGTCAGTT"	"Cyst.PT_1"
"GTTGTCCTCGAACACT"	"T-cell"
"GTTGTCCTCTTGGAAC"	"Cyst.TAL_2"
"GTTGTGAAGTGCTCAT"	"Cyst.ATL"
"GTTGTGACAGTCGGAA"	"Cyst.PT_3"
"GTTGTGACATCGAGCC"	"Cyst.TAL_1"
"GTTGTGAGTGGAAATT"	"Cyst.TAL_2"
"GTTGTGATCTAAACGC"	"Mac"
"GTTGTGATCTAACGGT"	"Cyst.TAL_1"
"GTTTACTAGCACTTTG"	"Cyst.PT_3"
"GTTTACTCAATTCGTG"	"Cyst.PT_1"
"GTTTACTCACTCCGAG"	"Cyst.PT_2"
"GTTTACTCATTCTTCA"	"Cyst.TAL_2"
"GTTTACTGTCACTCAA"	"Cyst.TAL_1"
"GTTTACTTCAGCATTG"	"Cyst.PC"
"GTTTGGAAGTCCGTCG"	"Cyst.TAL_2"
"GTTTGGACAGAGTGTG"	"Cyst.PT_3"
"GTTTGGACAGGATCTT"	"vSMC"
"GTTTGGAGTTCCACAA"	"Cyst.PT_1"
"GTTTGGATCGACCAAT"	"Cyst.PT_3"
"GTTTGGATCGTTCAGA"	"Cyst.PT_2"
"TAACACGAGCGGGTAT"	"Cyst.PT_2"
"TAACACGCAAGAATAC"	"Cyst.PT_2"
"TAACACGCAGAATTCC"	"Podocytes"
"TAACACGCAGTTTCGA"	"Cyst.PT_1"
"TAACACGCATACTTTC"	"Cyst.PT_2"
"TAACACGGTTTGGAAA"	"vSMC"
"TAACACGTCAATCAGC"	"Podocytes"
"TAACCAGAGGATTTCC"	"Cyst.PT_1"
"TAACCAGGTTCCCACT"	"vSMC"
"TAACCAGTCCGCTTAC"	"Cyst.ATL"
"TAACCAGTCTCGGTAA"	"Cyst.TAL_2"
"TAACGACAGTGGTCAG"	"Cyst.PT_3"
"TAACGACCAAGCGAAC"	"Fibroblast"
"TAACGACCACACCAGC"	"Cyst.PT_1"
"TAACGACGTATGTGTC"	"Cyst.PT_2"
"TAACGACTCCTACAAG"	"Cyst.TAL_2"
"TAACGACTCGCTCCTA"	"Cyst.TAL_2"
"TAACTTCAGACGCTCC"	"Cyst.PC"
"TAACTTCAGCGAGTAC"	"Cyst.PT_1"
"TAACTTCCAGGACTAG"	"Cyst.PT_1"
"TAACTTCGTATCCTCC"	"Cyst.PT_2"
"TAACTTCTCAGTAGGG"	"Cyst.PT_3"
"TAAGCACAGCCATTCA"	":LowQual"
"TAAGCACCAGGGACTA"	"Cyst.TAL_2"
"TAAGCACCATTACGGT"	"Cyst.TAL_2"
"TAAGCACGTGCCGTAC"	"Cyst.PT_1"
"TAAGCACGTTCTATCT"	"Cyst.PT_3"
"TAAGCACTCAGTCAGT"	"EC"
"TAAGCACTCCTTTGAT"	"Cyst.PT_1"
"TAAGCACTCGCGTAGC"	"Cyst.PT_2"
"TAAGCACTCTCAAAGC"	"vSMC"
"TAAGCCAGTCATAACC"	"Cyst.TAL_1"
"TAAGCCAGTCGCATTA"	"vSMC"
"TAAGCGTAGGCTGAAC"	"Cyst.PC"
"TAAGCGTAGTATGTAG"	"Cyst.PT_3"
"TAAGCGTGTCAGATTC"	"Cyst.TAL_2"
"TAAGCGTGTGTATACC"	"Cyst.PC"
"TAAGCGTTCGATAACC"	"Cyst.PT_1"
"TAAGTCGCATCCCACT"	"Cyst.PT_2"
"TAATCTCAGCTTGTGT"	"Cyst.PT_2"
"TAATCTCCAAAGGCAC"	"Cyst.TAL_1"
"TAATCTCGTGGTATGG"	"Cyst.PT_1"
"TAATCTCTCCTTTAGT"	"Cyst.PT_1"
"TAATTCCAGAATAACC"	"Cyst.PT_2"
"TAATTCCAGTTTGAGA"	"Cyst.PT_1"
"TAATTCCCAACTGGTT"	"Cyst.TAL_1"
"TAATTCCGTAATGTGA"	"Cyst.PT_2"
"TAATTCCGTGCTCTCT"	"Cyst.PT_3"
"TAATTCCGTGGTCTCG"	"Cyst.PT_2"
"TAATTCCGTTAATGAG"	"Cyst.PT_3"
"TAATTCCGTTACACAC"	"Cyst.TAL_1"
"TAATTCCGTTTACTGG"	"Cyst.PT_2"
"TAATTCCTCACGACTA"	"Fibroblast"
"TAATTCCTCCGAGTGC"	"Fibroblast"
"TACAACGAGATTGTGA"	"Cyst.PT_2"
"TACAACGCACAAATGA"	"INT"
"TACAACGCACTCCCTA"	"EC"
"TACAACGGTACAGGTG"	"Unk_1"
"TACAACGGTCTGCAAT"	"Cyst.TAL_2"
"TACAACGGTGTAAACA"	":LowQual"
"TACAACGGTTATGGTC"	"Cyst.TAL_2"
"TACACCCAGTTGTACC"	"Cyst.PT_3"
"TACACCCCACACGCCA"	"Cyst.PT_1"
"TACACCCCAGAGACTG"	"Cyst.PT_1"
"TACACCCCATGACTAC"	"Cyst.PT_2"
"TACACCCGTAGGCTCC"	"Cyst.PT_1"
"TACACCCGTTGTAGCT"	"Cyst.PT_2"
"TACAGGTAGAGGTTAT"	"Cyst.PT_1"
"TACAGGTGTGGAATGC"	"Cyst.PT_1"
"TACAGGTTCATCTGTT"	"Cyst.PT_1"
"TACAGGTTCATTGCTT"	"Cyst.TAL_1"
"TACAGGTTCGTAACCA"	"Cyst.PT_1"
"TACAGGTTCGTTCTAT"	"Cyst.PT_1"
"TACAGGTTCTTTACAC"	"Unk_2"
"TACATTCAGCAATAAC"	"Cyst.PT_3"
"TACATTCCATCGAAGG"	"Cyst.PT_2"
"TACATTCGTCAGTCTA"	"Cyst.PT_1"
"TACATTCTCAAGAAAC"	"Cyst.TAL_2"
"TACATTCTCAGTCTTT"	"Fibroblast"
"TACCCACAGCATCAGG"	"Cyst.PC"
"TACCCACAGCATCCCG"	"T-cell"
"TACCCACAGGGTGAAA"	"Fibroblast"
"TACCCACAGTTGCGCC"	"Cyst.PT_3"
"TACCCACCAAATGCTC"	"Cyst.PT_2"
"TACCCACCACCGGTCA"	"Cyst.PT_3"
"TACCCACCAGTATACC"	"Podocytes"
"TACCCACGTAGGCAGT"	"Cyst.PT_1"
"TACCCACGTCCACGCA"	"Fibroblast"
"TACCCACGTGCCTTCT"	"Cyst.TAL_1"
"TACCCGTCACTTTAGG"	"Unk_2"
"TACCCGTCAGCTCCTT"	"Cyst.PT_1"
"TACCCGTGTCTGTGTA"	"Cyst.PT_1"
"TACCCGTGTTGCCGCA"	"Cyst.PT_2"
"TACCCGTTCCTATTTG"	"Cyst.PT_1"
"TACCCGTTCCTTCTTC"	"Fibroblast"
"TACCGAAAGATACGAT"	"Cyst.PT_1"
"TACCGAAAGTGTTCCA"	"vSMC"
"TACCGAACAATCACGT"	"Cyst.PT_2"
"TACCGAACACTGAGGA"	"Cyst.PT_1"
"TACCGAACATCCTAAG"	"Cyst.PT_2"
"TACCGAATCCAGTGTA"	"Cyst.TAL_2"
"TACCGAATCGAGAAAT"	"Cyst.ATL"
"TACCGAATCTCGCGTT"	"EC"
"TACCGGGAGCAAGCCA"	"Cyst.PT_2"
"TACCGGGAGCCTCAGC"	"Cyst.PT_2"
"TACCGGGCATCCGGCA"	"EC"
"TACCGGGGTATCACCA"	"Cyst.PT_1"
"TACCGGGGTCAAAGAT"	"Cyst.PT_1"
"TACCGGGGTTAGAGTA"	"Cyst.PT_3"
"TACCTCGGTCTAGATC"	"Cyst.PT_1"
"TACCTGCCACAAGGTG"	"Cyst.PT_1"
"TACCTGCTCCGCACTT"	"Cyst.TAL_2"
"TACCTGCTCCGTTTCG"	"Cyst.PT_1"
"TACCTGCTCTGGAGAG"	"Cyst.TAL_2"
"TACGCTCAGCCATTTG"	"Cyst.PT_3"
"TACGCTCAGGGAGGTG"	"vSMC"
"TACGCTCCAAGGGCAT"	"Cyst.PT_3"
"TACGCTCCACACCTAA"	"Podocytes"
"TACGCTCCACTGGAAG"	"Cyst.PT_1"
"TACGCTCCAGAGTGTG"	"vSMC"
"TACGCTCGTAACTTCG"	"Cyst.PT_1"
"TACGCTCGTGGCTACC"	"Cyst.PT_1"
"TACGCTCTCTCGCGTT"	"Cyst.PT_3"
"TACGGGCCACAATCTG"	"Cyst.PT_1"
"TACGGGCCACTTGGCG"	"Cyst.TAL_1"
"TACGGGCGTTGCCAAT"	"Cyst.PT_2"
"TACGGTAAGAAATTGC"	"Cyst.PT_3"
"TACGGTAAGCACCGTC"	"EC"
"TACGGTAAGCGTCGAA"	"Cyst.TAL_1"
"TACGGTAAGGTGATCG"	"Cyst.PT_2"
"TACGGTAGTAATCAGA"	"Cyst.TAL_2"
"TACGGTAGTAGGAGTC"	"Cyst.PC"
"TACGGTAGTCTAGGTT"	"Cyst.PT_2"
"TACGTCCAGGAACGTC"	"Cyst.PT_1"
"TACGTCCCAGGCTATT"	"Cyst.PT_1"
"TACGTCCGTGGCCTCA"	"Unk_2"
"TACTGCCAGATCGACG"	"Cyst.PT_2"
"TACTGCCAGTGCTAGG"	"Cyst.PT_1"
"TACTGCCCACAGTCGC"	"Cyst.PT_1"
"TACTGCCCACCCTGAG"	"Cyst.TAL_1"
"TACTGCCCAGGGAGAG"	"Cyst.PC"
"TACTGCCCATGGGAAC"	"Cyst.PT_2"
"TACTGCCGTGTATTGC"	"Cyst.PT_1"
"TACTTACAGACGCCCT"	"Cyst.TAL_2"
"TACTTACAGCGTATGG"	"Cyst.PT_1"
"TACTTACAGTACTCGT"	"Cyst.PT_1"
"TACTTACAGTGCCCGT"	"Cyst.PT_2"
"TACTTACAGTTGGAGC"	"T-cell"
"TACTTACCAAGTGACG"	"Cyst.PT_2"
"TACTTACCATCCTTGC"	"EC"
"TACTTACGTAGCGATG"	"Cyst.PC"
"TACTTACGTGTTAGCT"	"Cyst.TAL_2"
"TACTTCAAGCTAAGTA"	"Podocytes"
"TACTTCAAGTAACGAT"	"Cyst.PC"
"TACTTCAAGTATAACG"	"Cyst.PT_1"
"TACTTCACAAGCCATT"	"EC"
"TACTTCACATGGCCCA"	"Cyst.TAL_2"
"TACTTCACATTGACAC"	"Cyst.TAL_2"
"TACTTCAGTTACTCAG"	"Cyst.TAL_1"
"TACTTGTAGCATCAGG"	"Cyst.TAL_1"
"TACTTGTAGTATTGCC"	"Cyst.PT_2"
"TACTTGTCAAATGGAT"	"T-cell"
"TACTTGTGTGTCATCA"	"Fibroblast"
"TACTTGTTCACCTCGT"	"Cyst.PT_3"
"TACTTGTTCCATAGGT"	"Cyst.PT_1"
"TACTTGTTCTCGTGGG"	"vSMC"
"TACTTGTTCTGTAAGC"	"vSMC"
"TAGACCAGTTTGTTCT"	"Cyst.TAL_2"
"TAGACCATCCCGATCT"	"Cyst.PT_1"
"TAGACTGAGAGTTGAT"	"Cyst.PT_2"
"TAGACTGAGATCGCCC"	"Cyst.TAL_2"
"TAGACTGCAATGAACA"	"Cyst.TAL_2"
"TAGACTGCAGTTCACA"	"Cyst.PT_2"
"TAGACTGGTCACTTCC"	"Cyst.PT_1"
"TAGACTGTCCGACGGT"	"Cyst.PT_1"
"TAGACTGTCGAGTGGA"	"Cyst.PT_3"
"TAGACTGTCTGTCCGT"	"Cyst.PT_1"
"TAGAGTCAGGTGCCTC"	"Cyst.PC"
"TAGAGTCCACTGTCGG"	"Cyst.TAL_1"
"TAGAGTCCATAGCTGT"	"Cyst.TAL_2"
"TAGAGTCCATATTCGG"	"Cyst.PT_2"
"TAGAGTCTCTGTACAG"	"Cyst.TAL_2"
"TAGATCGAGCAACTCT"	"Cyst.PC"
"TAGATCGAGGTAGGCT"	"EC"
"TAGATCGAGTCGAAAT"	"Cyst.PT_3"
"TAGATCGCATCAGCAT"	"Cyst.PT_1"
"TAGATCGGTGTTATCG"	"Cyst.TAL_2"
"TAGATCGTCGTAGGGA"	"Cyst.ATL"
"TAGCACAAGCGAAACC"	"Cyst.PT_1"
"TAGCACAAGGCTCTAT"	"Cyst.PT_2"
"TAGCACACAATGAGCG"	"Cyst.PT_2"
"TAGCACACAGCTTCGG"	"Cyst.PT_1"
"TAGCACAGTGATGAAT"	"Cyst.TAL_1"
"TAGCACATCATCCCGT"	"Cyst.TAL_2"
"TAGCACATCGAGATAA"	"Cyst.PT_1"
"TAGCACATCGGTCGGT"	"vSMC"
"TAGGAGGAGACCGCCT"	"Cyst.TAL_2"
"TAGGAGGCACCATAAC"	"EC"
"TAGGAGGGTAGCTTTG"	"Cyst.PT_2"
"TAGGAGGGTAGTAAGT"	"Cyst.PT_2"
"TAGGAGGGTCGCGTTG"	"Cyst.PT_3"
"TAGGAGGGTGTAACGG"	"Cyst.PC"
"TAGGGTTCACCGGTCA"	"Cyst.PT_2"
"TAGGGTTCACTGCGTG"	"Fibroblast"
"TAGGGTTCATCGGCCA"	"Cyst.PT_1"
"TAGGTACAGCTAAACA"	"Cyst.PT_2"
"TAGGTACAGGTTACCT"	"Unk_1"
"TAGGTACAGTTGCCCG"	"Cyst.TAL_2"
"TAGGTACCACCCATAA"	"Cyst.PT_1"
"TAGGTACCACGTGAGA"	"Cyst.TAL_2"
"TAGGTACCAGGTTACT"	"Cyst.TAL_1"
"TAGGTACGTCGTAATC"	"Cyst.PT_1"
"TAGGTACGTTGGAGAC"	"Unk_1"
"TAGGTTGAGAGAGCAA"	"Cyst.PT_3"
"TAGGTTGAGTAACGTA"	"Cyst.TAL_1"
"TAGGTTGCAAAGGGCT"	"Cyst.IC-A1"
"TAGGTTGCAATGTCAC"	"Cyst.PC"
"TAGGTTGGTATGGGAC"	"Cyst.PT_2"
"TAGGTTGTCGCAGAGA"	"Cyst.PT_1"
"TAGTGCACATTGTCGA"	"Fibroblast"
"TAGTGCAGTACGGTTT"	"Cyst.PT_2"
"TAGTGCAGTCGGATTT"	"Cyst.PT_2"
"TAGTGCAGTGTTCCAA"	"Cyst.TAL_2"
"TATACCTAGGTCGTAG"	"Cyst.PC"
"TATACCTCAGCGGATA"	"Cyst.PT_1"
"TATACCTGTAGGAAAG"	"Unk_1"
"TATACCTGTTGCACGC"	"Cyst.PT_3"
"TATACCTTCAATCTTC"	"Podocytes"
"TATACCTTCAGCACCG"	"Cyst.PC"
"TATACCTTCGTAGGAG"	"Cyst.PT_2"
"TATACCTTCTACACAG"	"Cyst.PT_3"
"TATATCCAGTATTCCG"	"Cyst.TAL_1"
"TATATCCCACACGGAA"	"Cyst.PT_2"
"TATATCCGTTACGCCG"	"Cyst.TAL_2"
"TATATCCTCCGTGCGA"	"Cyst.PT_2"
"TATATCCTCGACCCAG"	"Cyst.PT_1"
"TATATCCTCTCATGCC"	"Cyst.TAL_2"
"TATCAGGAGCAACAAT"	"Cyst.TAL_1"
"TATCAGGAGCTACTAC"	"Mac"
"TATCAGGCACAGTCCG"	"Cyst.PT_2"
"TATCAGGCAGGGATAC"	"Cyst.TAL_1"
"TATCAGGGTATTGAGA"	"Cyst.PC"
"TATCAGGGTCCTGGGT"	"Cyst.PT_1"
"TATCAGGGTTACCCAA"	"Mac"
"TATCAGGGTTGTGTAC"	"Cyst.TAL_2"
"TATCAGGGTTTACTTC"	"Cyst.PT_3"
"TATCAGGTCCTCAGGG"	"Cyst.PT_2"
"TATCAGGTCGCCACTT"	"Cyst.PT_1"
"TATCAGGTCTTGGGCG"	"Cyst.PT_1"
"TATCCTAAGCGAATGC"	"Cyst.TAL_1"
"TATCCTACAGACCTAT"	"T-cell"
"TATCCTACATATGGCT"	"Cyst.PT_1"
"TATCCTAGTCAAACGG"	"EC"
"TATCCTAGTCCAAGAG"	"Cyst.PT_1"
"TATCCTAGTGCTGATT"	"Cyst.PT_3"
"TATCCTATCTACTGCC"	"Cyst.TAL_1"
"TATCGCCCAAAGACTA"	"Cyst.PT_3"
"TATCGCCGTACAGAAT"	"Cyst.PT_3"
"TATCGCCGTGTACAGG"	"Cyst.PT_1"
"TATCGCCGTTTCTATC"	"Cyst.PT_1"
"TATCGCCGTTTGAAAG"	"Cyst.PC"
"TATCTGTAGAGGATCC"	"Cyst.TAL_1"
"TATCTGTAGCTGGAGT"	"Cyst.TAL_2"
"TATCTGTCACAAAGCG"	"Cyst.TAL_1"
"TATCTGTCATGCAGGA"	"Cyst.TAL_1"
"TATCTGTTCCGAAGGA"	"vSMC"
"TATCTGTTCGCGGACT"	"Unk_2"
"TATCTTGAGCGGTAGT"	"Cyst.TAL_1"
"TATCTTGAGGAAAGGT"	"Cyst.PT_1"
"TATCTTGAGGCAGCTA"	"Cyst.PT_1"
"TATCTTGCACGTAGTT"	"Cyst.PT_2"
"TATCTTGCATCGCTCT"	"Cyst.PC"
"TATCTTGCATCTCGTC"	"Cyst.PT_2"
"TATCTTGGTGATAGAT"	"Cyst.PT_1"
"TATCTTGGTGGTTTAC"	"Cyst.PT_1"
"TATCTTGGTGTATTCG"	"Cyst.PT_1"
"TATCTTGTCGGAATGG"	"Cyst.PT_2"
"TATGTTCAGTCCTGCG"	"Cyst.PT_1"
"TATGTTCCATCGGAGA"	"Cyst.PT_2"
"TATGTTCGTAATTAGG"	"Cyst.PT_1"
"TATGTTCGTATCGGTT"	":LowQual"
"TATGTTCGTCGGCTAC"	"Cyst.TAL_2"
"TATGTTCGTGCCTTCT"	"Cyst.TAL_2"
"TATGTTCGTTTCGTGA"	"Cyst.PT_1"
"TATGTTCTCATTACGG"	"Cyst.PT_2"
"TATTCCAAGGACAACC"	"Cyst.TAL_2"
"TATTCCAGTGGCTGCT"	"Unk_1"
"TATTCCAGTGTGTCGC"	"Cyst.PT_1"
"TATTCCATCCTGCCAT"	"Unk_2"
"TATTCCATCGTCACCT"	"Cyst.PT_1"
"TATTGCTAGTTGCTGT"	"Cyst.TAL_2"
"TATTGCTGTCTGTAAC"	"EC"
"TATTGCTTCACCACAA"	"Cyst.PT_1"
"TATTGCTTCCAGGACC"	"Cyst.PT_1"
"TATTGCTTCGCTTAAG"	"Cyst.IC-A1"
"TATTGGGAGATTGAGT"	"Cyst.TAL_1"
"TATTGGGAGTCAGCGA"	"Cyst.PT_1"
"TATTGGGAGTGCACAG"	"Cyst.PT_1"
"TATTGGGCATAGGAGC"	"Cyst.TAL_1"
"TATTGGGGTAAGCGGT"	"Cyst.TAL_2"
"TATTGGGTCCGGACGT"	"vSMC"
"TATTGGGTCGCTGTCT"	"Cyst.PT_2"
"TATTTCGAGGCACCAA"	"Cyst.PT_2"
"TATTTCGAGTAAGAGG"	"Cyst.PT_2"
"TATTTCGCAGCTATAC"	"Podocytes"
"TATTTCGGTATCATGC"	"vSMC"
"TATTTCGGTGTAAACA"	"Cyst.TAL_1"
"TATTTCGTCGTTATCT"	"Cyst.PT_1"
"TCAAGACAGCCTGACC"	"Cyst.PT_1"
"TCAAGACAGGTTGGAC"	"Cyst.TAL_1"
"TCAAGACCAAAGGCGT"	"Mac"
"TCAAGACGTATGCTAC"	"Podocytes"
"TCAAGACGTCATATGC"	"Podocytes"
"TCAAGACGTGAGGCAT"	"Cyst.TAL_1"
"TCAAGACTCTACTATC"	"Cyst.PT_3"
"TCAAGCACACGGCACT"	"Podocytes"
"TCAAGCACAGTCCCGA"	"Cyst.TAL_1"
"TCAAGCATCACCACAA"	"Cyst.TAL_1"
"TCAAGCATCATGGCCG"	"EC"
"TCAAGTGAGATTAGAC"	"Cyst.PT_2"
"TCAAGTGCAAAGGGCT"	"Cyst.TAL_1"
"TCAAGTGCAGAGTTCT"	"Cyst.PC"
"TCAAGTGTCACTCGAA"	"Cyst.PT_1"
"TCAATCTAGAGGATCC"	"Cyst.PT_1"
"TCAATCTGTATGTCCA"	"vSMC"
"TCAATCTTCACTTTGT"	"Cyst.PT_3"
"TCAATCTTCATCGCTC"	"Cyst.TAL_2"
"TCAATCTTCTTTGATC"	"Cyst.TAL_2"
"TCAATTCAGCCTCAGC"	"Cyst.IC-A1"
"TCAATTCGTACGTGAG"	"Cyst.PT_2"
"TCAATTCGTTGGACCC"	"Cyst.PT_1"
"TCAATTCGTTGGCTAT"	"Cyst.PT_3"
"TCACAAGAGACCATGG"	"Cyst.PT_1"
"TCACAAGAGCAACTCT"	"Cyst.TAL_1"
"TCACAAGCAATCGCCG"	"Cyst.TAL_2"
"TCACAAGCAGACCAGA"	"Cyst.TAL_1"
"TCACAAGGTAGGCTCC"	"Fibroblast"
"TCACAAGGTGAATTAG"	"Cyst.TAL_1"
"TCACAAGTCGACACTA"	"Cyst.TAL_2"
"TCACACCAGGTCGTAG"	"Unk_2"
"TCACACCGTAGAGTTA"	"Cyst.PT_1"
"TCACACCGTTCGGCCA"	"vSMC"
"TCACACCGTTTCTATC"	"vSMC"
"TCACACCTCGGCCCAA"	"Cyst.TAL_2"
"TCACACCTCGTTAGAC"	"Cyst.PT_2"
"TCACATTCACACCGAC"	"Cyst.PT_3"
"TCACGCTAGAAAGTCT"	"Cyst.TAL_1"
"TCACGCTAGCACTGGA"	"Fibroblast"
"TCACGCTAGGCGATAC"	"Cyst.PC"
"TCACGCTAGTCAACAA"	"Cyst.PC"
"TCACGCTCAATTGAGA"	"Cyst.PT_1"
"TCACGCTGTAACATAG"	"Fibroblast"
"TCACGCTTCTACCTTA"	"Cyst.PT_1"
"TCACGGGAGCCGGAAT"	"EC"
"TCACGGGAGTCTGGTT"	"Unk_1"
"TCACGGGGTATGCAAA"	"Cyst.TAL_1"
"TCACGGGGTTCCAAAC"	"Cyst.PT_2"
"TCACGGGTCACTAGCA"	"Cyst.PT_2"
"TCACGGGTCATGGATC"	"Cyst.PT_1"
"TCACGGGTCGCTCCTA"	"Cyst.PT_1"
"TCACGGGTCGTGAGAG"	"Cyst.PT_1"
"TCACTATAGCACTGGA"	"Cyst.TAL_2"
"TCACTATCAAACTGCT"	"Cyst.TAL_1"
"TCACTATCAGCTCTGG"	"Cyst.PT_2"
"TCACTATGTACTGTTG"	"T-cell"
"TCACTATGTCAGGTGA"	"Cyst.PT_1"
"TCACTATGTCCCGGTA"	"Cyst.PT_2"
"TCACTATGTCGCTGCA"	"Cyst.TAL_1"
"TCACTATTCAAGAGGC"	"Cyst.PT_1"
"TCACTATTCGATACTG"	"vSMC"
"TCACTCGAGCACTGGA"	"Cyst.PT_3"
"TCACTCGCAATAGTGA"	"Cyst.TAL_1"
"TCACTCGCATGAGTAA"	"Cyst.TAL_2"
"TCACTCGGTATGCGTT"	"Cyst.IC-A1"
"TCACTCGTCGCCGAAC"	"Cyst.TAL_1"
"TCACTCGTCTTGGTGA"	"Cyst.PT_1"
"TCAGCAAAGAAACTAC"	"Cyst.PT_1"
"TCAGCAAAGATAGCAT"	"Cyst.PT_1"
"TCAGCAAAGGGTTTCT"	"Cyst.PT_2"
"TCAGCAACAAAGGGCT"	"vSMC"
"TCAGCAACACTATCCC"	"Cyst.PC"
"TCAGCAAGTACCCGCA"	"Cyst.PT_3"
"TCAGCAAGTACTTGTG"	"Cyst.PT_3"
"TCAGCAATCACCTGTC"	"Cyst.PT_1"
"TCAGCAATCGATGCTA"	"Cyst.TAL_2"
"TCAGCAATCGGACAAG"	"Cyst.PT_1"
"TCAGCAATCGTAGCTA"	"Fibroblast"
"TCAGCCTAGCCAGTAG"	"Cyst.TAL_2"
"TCAGCCTAGGTCACCC"	"Mac"
"TCAGCCTAGTAGCAAT"	"Cyst.PC"
"TCAGCCTCACTGTGAT"	"Cyst.PT_2"
"TCAGCCTCAGACGCTC"	"Cyst.PT_3"
"TCAGCCTGTGACTAAA"	"EC"
"TCAGCCTGTGTTGCCG"	"Cyst.PT_2"
"TCAGCCTTCCATAGAC"	"Cyst.TAL_1"
"TCAGCCTTCCATTTAC"	"T-cell"
"TCAGCCTTCCGAAATC"	"Cyst.PT_2"
"TCAGCCTTCTTAGCAG"	"vSMC"
"TCAGGGCAGTGGAAGA"	"Cyst.PT_2"
"TCAGGGCAGTTCTACG"	"INT"
"TCAGGGCCACGTAGTT"	"Mac"
"TCAGGGCCACGTCGGT"	"Cyst.PT_3"
"TCAGGGCCATCTATCT"	"Cyst.PT_1"
"TCAGGGCGTTCCTAGA"	"EC"
"TCAGGTAGTGTATTCG"	"Cyst.PT_3"
"TCAGGTATCGGTGTAT"	"Cyst.TAL_2"
"TCAGTCCAGCTGAAGC"	"Cyst.PT_3"
"TCAGTCCAGTTAGTGA"	"Cyst.TAL_2"
"TCAGTCCCACCCTTAC"	"Cyst.PT_2"
"TCAGTCCCAGTCGTTA"	"Cyst.TAL_2"
"TCAGTCCGTCACCTTC"	"Cyst.PT_1"
"TCAGTCCGTGCACAAG"	"Cyst.TAL_2"
"TCAGTCCGTTGCGAAG"	"Cyst.TAL_1"
"TCAGTCCTCACCGCTT"	"Fibroblast"
"TCAGTGAAGCCGTCGT"	"Cyst.PT_2"
"TCAGTGAAGCTGACTT"	"Cyst.TAL_1"
"TCAGTGAGTACGCGTC"	"Cyst.PT_2"
"TCAGTGATCCGTACGG"	"Cyst.IC-A1"
"TCAGTGATCTCCAATT"	"Cyst.PT_1"
"TCAGTGATCTGCGTCT"	"Unk_1"
"TCAGTTTAGCCTTTGA"	"Cyst.TAL_2"
"TCAGTTTCAACTGCCG"	"Cyst.PT_3"
"TCAGTTTGTAGAGCTG"	"Cyst.TAL_2"
"TCAGTTTTCGTCGCTT"	"Fibroblast"
"TCATACTAGTACAGAT"	"EC"
"TCATACTCAGCGTAGA"	"Podocytes"
"TCATACTCAGGAATAT"	"Cyst.PT_1"
"TCATACTCATTGAGGG"	"Cyst.PT_1"
"TCATACTGTGCTCTCT"	"Cyst.TAL_2"
"TCATACTGTTCGGCGT"	"Cyst.PT_3"
"TCATATCAGAGGGTCT"	":LowQual"
"TCATATCAGCGACATG"	"Cyst.PT_1"
"TCATATCAGTCATGAA"	"Cyst.TAL_1"
"TCATATCCACAATGCT"	"Cyst.PT_1"
"TCATATCCAGAGTGTG"	"Unk_1"
"TCATATCCAGTCGCTG"	"Cyst.TAL_2"
"TCATATCGTACGATTC"	"Cyst.PT_1"
"TCATATCGTAGAATAC"	"Cyst.TAL_1"
"TCATATCGTCGTCTCT"	"Cyst.TAL_2"
"TCATATCTCACTACTT"	"Cyst.TAL_2"
"TCATATCTCTGTAAGC"	"Cyst.PT_1"
"TCATCATAGATACGAT"	"Cyst.TAL_2"
"TCATCATCAACGGCTC"	"Cyst.PT_1"
"TCATCATGTATTGACC"	"Cyst.PT_1"
"TCATCATGTGACACGA"	"Cyst.PT_1"
"TCATCATTCAACTACG"	"vSMC"
"TCATCATTCAGCTTCC"	"Cyst.TAL_2"
"TCATCCGAGTAAACGT"	"Unk_1"
"TCATCCGCACACCTTC"	"Cyst.PT_3"
"TCATCCGCACGGTAGA"	"vSMC"
"TCATCCGCACGTCATA"	"Cyst.PT_1"
"TCATCCGCACTGTCCT"	"Mac"
"TCATCCGCATGGGCAA"	"Cyst.PT_1"
"TCATCCGGTTCCAGGC"	"Cyst.PT_3"
"TCATCCGGTTCCCACT"	"Cyst.PT_1"
"TCATCCGTCAATCCGA"	"Cyst.TAL_2"
"TCATGAGAGCGAGGAG"	"Cyst.TAL_2"
"TCATGAGCATCATCTT"	"Cyst.TAL_2"
"TCATGAGGTAATCAAG"	"Cyst.TAL_2"
"TCATGAGGTCTTCTAT"	"Cyst.PT_3"
"TCATGAGGTTTATGCG"	"Mac"
"TCATGAGTCATTCGGA"	"Cyst.PT_1"
"TCATGAGTCCGTTTCG"	"vSMC"
"TCATGCCAGAGGGTCT"	"Cyst.PT_1"
"TCATGCCAGCGCCCAT"	"Cyst.PT_1"
"TCATGCCAGGCCTGCT"	"Cyst.TAL_1"
"TCATGCCCACAGACGA"	"Cyst.PC"
"TCATGCCGTAAGATAC"	"Cyst.PT_3"
"TCATGCCGTGAGCAGT"	"Cyst.PC"
"TCATGCCTCAGGCGAA"	"Cyst.PT_2"
"TCATGCCTCCCGAGTG"	"Cyst.PT_1"
"TCATGCCTCGCTCCTA"	"Cyst.PT_1"
"TCATGGAAGGAATCGC"	"Fibroblast"
"TCATGGACACCCTTAC"	"Cyst.TAL_2"
"TCATGGACACCGTGGT"	"Cyst.PT_1"
"TCATGGAGTGTGTCGC"	"Cyst.PC"
"TCATGGATCAGCAGAG"	"Cyst.PT_1"
"TCATGTTCAAAGCGTG"	"Cyst.TAL_2"
"TCATGTTCAATACCCA"	"Cyst.PT_3"
"TCATGTTTCGCAGAGA"	"T-cell"
"TCATGTTTCGCATGAT"	"Cyst.PT_1"
"TCATGTTTCTACCACC"	"Mac"
"TCATTACAGACCTGGA"	"Fibroblast"
"TCATTACAGCTGCCTG"	"Cyst.PT_1"
"TCATTACAGGAGAGGC"	"Cyst.PT_2"
"TCATTACCACTTCATT"	"Cyst.PT_3"
"TCATTACTCGGTGCAC"	"Cyst.PT_3"
"TCATTACTCTTCACGC"	"Cyst.PT_2"
"TCATTCAAGCATCTTG"	"Cyst.TAL_1"
"TCATTCAAGCCTCATA"	"Cyst.PT_2"
"TCATTCACAAATGAGT"	"Cyst.PT_1"
"TCATTCACAATAGGAT"	"Cyst.TAL_1"
"TCATTCACAGAGGCTA"	"Fibroblast"
"TCATTCAGTACTGGGA"	"Cyst.TAL_2"
"TCATTCAGTCAGACGA"	"Cyst.PT_3"
"TCATTCAGTGAGTCAG"	"Cyst.PT_1"
"TCATTGTAGATACTGA"	"Mac"
"TCATTGTAGATCCCGC"	"Cyst.PC"
"TCATTGTAGCATTTCG"	"EC"
"TCATTGTCAAACACGG"	"Cyst.PT_1"
"TCATTGTGTTGCATGT"	"Mac"
"TCATTGTTCATGCCGG"	"vSMC"
"TCATTGTTCCACCTCA"	"Cyst.PT_3"
"TCATTTGCAACCGACC"	"Cyst.TAL_2"
"TCATTTGCATAGAAAC"	"Cyst.PC"
"TCATTTGCATCCCGTT"	"Cyst.PT_1"
"TCATTTGCATGTTACG"	"vSMC"
"TCATTTGTCCTCACTG"	"Cyst.PT_1"
"TCATTTGTCGGTCACG"	"EC"
"TCATTTGTCTCGTCGT"	"Cyst.PT_3"
"TCCACCAGTATCAGCT"	"Cyst.PT_2"
"TCCACCAGTGTACAGG"	"Cyst.TAL_1"
"TCCACCATCCGCATAA"	"Fibroblast"
"TCCACCATCCTAGCCT"	"Cyst.PT_1"
"TCCACGTAGATTCGCT"	"Cyst.PT_1"
"TCCACGTCAACAGAGC"	"Cyst.TAL_2"
"TCCACGTCACCTCGTT"	"vSMC"
"TCCACGTCAGATAAAC"	"Cyst.TAL_1"
"TCCACGTCAGGTCTCG"	"Cyst.PT_1"
"TCCACGTGTCGTGATT"	"Cyst.PT_1"
"TCCACGTGTGCCCACA"	"INT"
"TCCAGAAAGAGGGTCT"	"Cyst.TAL_1"
"TCCAGAACAATTGCGT"	"Cyst.PT_2"
"TCCAGAACACAGTCGC"	"vSMC"
"TCCAGAAGTAAGGCTG"	"T-cell"
"TCCAGAAGTATCGATC"	"Cyst.PT_3"
"TCCAGAAGTCGAATTC"	"Cyst.PT_1"
"TCCAGAATCCAATCCC"	"Cyst.PT_1"
"TCCATCGAGTGCGCTC"	"Cyst.PC"
"TCCATCGCAAAGGATT"	"Cyst.TAL_1"
"TCCATCGGTCTTCCGT"	"EC"
"TCCATCGTCAGCCTTC"	"Cyst.PT_2"
"TCCATCGTCCGAAATC"	"Cyst.PT_1"
"TCCATCGTCTCGAACA"	"vSMC"
"TCCATGCAGCACTCCG"	"EC"
"TCCATGCCAGTAGTTC"	"Unk_1"
"TCCATGCCATAAGCAA"	"Cyst.PC"
"TCCATGCGTAACAAGT"	"Cyst.TAL_1"
"TCCATGCGTATCGTGT"	"Cyst.PT_3"
"TCCATGCTCAAACCTG"	"Cyst.PT_1"
"TCCATGCTCAAGGCTT"	"Cyst.PT_1"
"TCCATGCTCCGAAATC"	"Cyst.PC"
"TCCATGCTCCTATTGT"	"Cyst.PT_1"
"TCCATGCTCGTTCCTG"	"Cyst.PT_1"
"TCCCACAAGGAGTCTG"	"Cyst.PT_2"
"TCCCACAAGTACAACA"	"Cyst.TAL_2"
"TCCCACACATCGTTCC"	"Cyst.PC"
"TCCCACAGTACTGCGC"	"Cyst.PT_1"
"TCCCACAGTGTTGACT"	"Cyst.PT_1"
"TCCCACAGTTCTCCTG"	"Cyst.PT_1"
"TCCCACAGTTGCATCA"	"Cyst.PT_3"
"TCCCACAGTTGTGCCG"	"Cyst.PT_2"
"TCCCACATCGGAAGGT"	"Cyst.PT_1"
"TCCCAGTAGCATGCAG"	"Cyst.TAL_2"
"TCCCAGTCAGGCTATT"	"Cyst.PC"
"TCCCAGTCAGTAGATA"	"Cyst.PT_1"
"TCCCAGTCATCGGTTA"	"Cyst.TAL_1"
"TCCCAGTCATTGAAGA"	"Mac"
"TCCCAGTGTAAGTAGT"	"Cyst.TAL_1"
"TCCCAGTGTACCCGAC"	"Cyst.PT_1"
"TCCCAGTGTAGGCTCC"	"Cyst.PT_3"
"TCCCAGTGTGACCTGC"	"Cyst.TAL_1"
"TCCCAGTGTTGCTCCT"	"Cyst.PT_3"
"TCCCAGTTCTGCTTTA"	"Cyst.PT_1"
"TCCCATGAGCAATAAC"	"EC"
"TCCCATGAGCAGCCTC"	"Cyst.PT_1"
"TCCCATGCAACCCTAA"	"Cyst.PT_2"
"TCCCATGCAACTCCCT"	"Cyst.TAL_2"
"TCCCATGTCTAGCAAC"	"Cyst.PT_1"
"TCCCATGTCTCGACCT"	"Cyst.PT_1"
"TCCCATGTCTCTCAAT"	"Cyst.PC"
"TCCCATGTCTCTTAAC"	"Cyst.ATL"
"TCCGAAAAGACATCCT"	"Cyst.TAL_1"
"TCCGAAAAGGAACGTC"	"Cyst.TAL_1"
"TCCGAAACAAACGTGG"	"Cyst.PC"
"TCCGAAACAGAAATCA"	"Cyst.PT_2"
"TCCGAAATCGGCATAT"	"Cyst.PT_3"
"TCCGAAATCTCAGGCG"	"Cyst.PT_1"
"TCCGATCAGAAAGCGA"	"Cyst.PT_1"
"TCCGATCGTGAGTAGC"	"Cyst.PT_3"
"TCCGATCGTTTGAACC"	"Cyst.PT_1"
"TCCGATCTCACCTGTC"	"Mac"
"TCCGATCTCGCCGAGT"	"Cyst.PT_1"
"TCCGATCTCTGCATAG"	"T-cell"
"TCCGGGAAGAGAGAAC"	"Cyst.PT_1"
"TCCGGGACACACAGCC"	":LowQual"
"TCCGGGACAGCTGTGC"	"Cyst.PT_1"
"TCCGTGTCAACACGTT"	"Cyst.PT_1"
"TCCGTGTCAGATCCTA"	"Cyst.PT_1"
"TCCGTGTCAGTAGGAC"	"vSMC"
"TCCGTGTCATGACTCA"	"EC"
"TCCGTGTGTAGCGCCT"	"Cyst.PT_1"
"TCCGTGTGTATGACAA"	"Fibroblast"
"TCCGTGTGTTTGAACC"	"Cyst.PT_2"
"TCCGTGTTCCGTGGGT"	"Cyst.PT_2"
"TCCGTGTTCTGTTGGA"	"Cyst.TAL_1"
"TCCTAATAGGATTCCT"	"Cyst.PT_2"
"TCCTAATAGTAATACG"	"Cyst.TAL_1"
"TCCTAATAGTATGGCG"	"Cyst.PT_3"
"TCCTAATCAGCTTTCC"	"Fibroblast"
"TCCTAATTCACGGGAA"	"Cyst.TAL_2"
"TCCTAATTCGACCCAG"	"Cyst.TAL_1"
"TCCTCCCCAGAGACTG"	"Cyst.TAL_2"
"TCCTCCCGTACCTAGT"	"vSMC"
"TCCTCCCGTCTTTCTA"	"Cyst.PT_3"
"TCCTCCCGTTAGAAGT"	"Cyst.PT_1"
"TCCTCCCGTTTGAAAG"	"Cyst.PT_1"
"TCCTCCCTCCTTCTGG"	"Cyst.TAL_2"
"TCCTCGAAGCCTCTTC"	"Cyst.PT_1"
"TCCTCGACAGATTTCG"	":LowQual"
"TCCTCGAGTGCAATGG"	"Cyst.PT_2"
"TCCTCGAGTTACCCTC"	"Cyst.PT_1"
"TCCTCGAGTTGTGGAG"	"Cyst.PC"
"TCCTCGATCAGTGCGC"	"Cyst.TAL_1"
"TCCTCGATCCCGAATA"	"Cyst.PC"
"TCCTCTTAGATGGTCG"	"Cyst.TAL_2"
"TCCTCTTCAAACTCTG"	"T-cell"
"TCCTCTTCAGGACAGT"	"Cyst.TAL_2"
"TCCTCTTCAGTGGGTA"	"Cyst.TAL_1"
"TCCTCTTCATCTAACG"	"Cyst.PT_3"
"TCCTCTTTCAGTGCGC"	"Cyst.PT_2"
"TCCTCTTTCTAGAGCT"	"Cyst.TAL_2"
"TCCTCTTTCTCTCTAA"	"Podocytes"
"TCCTGCAAGACTTAAG"	"Cyst.PT_1"
"TCCTGCAAGTAAGACT"	"Cyst.PT_3"
"TCCTGCAAGTTGAAAC"	"Cyst.PT_3"
"TCCTGCACAAATAGCA"	"Cyst.TAL_1"
"TCCTGCACAATCCTTT"	"Cyst.PT_1"
"TCCTGCACACGGCGTT"	"Cyst.PC"
"TCCTGCATCACTAGCA"	"Cyst.PT_1"
"TCCTGCATCATCAGTG"	"Cyst.TAL_2"
"TCCTGCATCATGGATC"	"Cyst.PT_2"
"TCCTGCATCCCTGTTG"	"Cyst.PT_1"
"TCCTGCATCGAAGCCC"	"Cyst.PT_2"
"TCCTGCATCGTGTTCC"	"Cyst.TAL_2"
"TCCTTCTAGTAGGAAG"	"Cyst.PT_1"
"TCCTTCTCAAGCCATT"	"Cyst.TAL_2"
"TCCTTCTCAAGTACCT"	"Cyst.PT_1"
"TCCTTCTGTATGTCAC"	"Cyst.TAL_1"
"TCCTTCTGTTCTCACC"	"Cyst.TAL_1"
"TCCTTCTTCCTTTGAT"	"Cyst.PT_1"
"TCCTTCTTCGTCTAAG"	"Cyst.PT_1"
"TCCTTTCGTAGGATAT"	"Cyst.TAL_1"
"TCCTTTCGTGCCTGAC"	"Cyst.TAL_2"
"TCCTTTCTCGAGGCAA"	"Cyst.TAL_2"
"TCCTTTCTCTCATTTG"	"Cyst.TAL_2"
"TCGAACAAGACCGCCT"	"Cyst.TAL_1"
"TCGAACACAAGTCATC"	"Cyst.PT_2"
"TCGAACACACGCAGTC"	"Cyst.TAL_1"
"TCGAACAGTGATAGTA"	"Unk_1"
"TCGAACATCATTCGGA"	":LowQual"
"TCGAACATCTTGGTGA"	"Cyst.PC"
"TCGAAGTAGACGTCGA"	"Cyst.PT_1"
"TCGAAGTAGGATGCGT"	"Cyst.TAL_1"
"TCGAAGTAGGCTATCT"	"Cyst.PT_1"
"TCGAAGTCAACGTAAA"	"Cyst.TAL_2"
"TCGACCTAGACGAGCT"	"vSMC"
"TCGACCTAGCATGCAG"	"Cyst.PT_1"
"TCGACCTCAAATGGAT"	"Cyst.PT_2"
"TCGACCTCACAAATAG"	"Cyst.PT_1"
"TCGACCTCAGTGACCC"	"Cyst.PT_1"
"TCGACCTGTCGTTGCG"	"Cyst.PT_1"
"TCGACCTGTGGTACAG"	"Cyst.TAL_2"
"TCGACCTTCACGGTCG"	"Cyst.PT_1"
"TCGACCTTCCTTATCA"	"Cyst.TAL_2"
"TCGACGGAGTTAGTGA"	"Cyst.PT_1"
"TCGACGGTCCTACGAA"	"Cyst.PT_2"
"TCGACGGTCGCTCTAC"	"Cyst.PT_1"
"TCGACGGTCTACGGTA"	"Cyst.TAL_2"
"TCGACGGTCTGTAACG"	"Mac"
"TCGATTTAGTACAGAT"	"Cyst.PT_2"
"TCGATTTCAACCGTGC"	"Cyst.TAL_1"
"TCGATTTCAAGAGTAT"	"Cyst.PT_2"
"TCGATTTGTCTGATAC"	"Cyst.PT_2"
"TCGATTTGTGTTCAGT"	"Cyst.PT_1"
"TCGCACTAGATGTTCC"	"Cyst.PT_1"
"TCGCACTAGGGCGAGA"	"Cyst.PT_3"
"TCGCACTAGGTGCAGT"	"Cyst.PT_2"
"TCGCACTGTCATCCGG"	"Fibroblast"
"TCGCACTGTGGTCTAT"	"Cyst.PT_1"
"TCGCACTTCACCATAG"	"Cyst.PT_3"
"TCGCACTTCACCGACG"	"Fibroblast"
"TCGCACTTCTGCCTGT"	"Cyst.PT_1"
"TCGCAGGAGCTATCCA"	"Cyst.PT_3"
"TCGCAGGTCTGCTTAT"	"Cyst.PT_1"
"TCGCTCACACGCGGTT"	"Cyst.PT_1"
"TCGCTCACAGAGGAAA"	"Cyst.TAL_1"
"TCGCTCATCGACCCAG"	"Cyst.PC"
"TCGCTTGAGTCATTGC"	"Cyst.TAL_1"
"TCGCTTGTCATGCGGC"	"Cyst.PT_3"
"TCGGATAAGTATGGAT"	"Cyst.TAL_2"
"TCGGATAAGTCCCGAC"	"Cyst.PT_1"
"TCGGATACAGACCATT"	"Unk_1"
"TCGGATACAGTGGCTC"	"Fibroblast"
"TCGGATACATCGTCCT"	"Cyst.PT_1"
"TCGGATAGTCGTTCAA"	":LowQual"
"TCGGATAGTGGATTTC"	"Cyst.PT_2"
"TCGGATATCGAGAAAT"	"Cyst.PT_3"
"TCGGGACAGACTACGG"	"Cyst.PT_3"
"TCGGGACCAGTCAGTT"	"Cyst.PT_2"
"TCGGGACCATTCAGGT"	"Cyst.TAL_2"
"TCGGGACGTGTGAGCA"	"Cyst.TAL_2"
"TCGGGACGTGTTCCAA"	"Cyst.PT_1"
"TCGGGACGTTGTTGTG"	"Cyst.PT_1"
"TCGGGACTCCAGTGCG"	"Fibroblast"
"TCGGGCACATGATAGA"	"Cyst.PT_3"
"TCGGGCAGTATTGCCA"	"Cyst.PT_3"
"TCGGGCATCTTAGCAG"	"Cyst.TAL_1"
"TCGGGTGAGCTGGTGA"	"Cyst.PT_3"
"TCGGGTGAGTACCCTA"	"Cyst.TAL_2"
"TCGGTCTAGGCTTCCG"	"Cyst.PT_2"
"TCGGTCTCAATGAAAC"	"Cyst.PT_2"
"TCGGTCTGTGAGTGAC"	"Unk_1"
"TCGTAGAAGGACACTG"	"Cyst.TAL_1"
"TCGTAGAAGTCAGCGA"	"Cyst.PT_1"
"TCGTAGACAGGGTCTC"	"Cyst.PT_1"
"TCGTAGAGTCAAGGCA"	"Cyst.PT_1"
"TCGTAGAGTTCTCAGA"	"Cyst.TAL_1"
"TCGTAGATCCATCTCG"	"Cyst.TAL_2"
"TCGTCCAAGGTAACTA"	"Cyst.TAL_2"
"TCGTCCACAGACATCT"	"Cyst.PT_1"
"TCGTCCAGTGTCCGGT"	"Cyst.PT_1"
"TCGTCCATCTCTCCGA"	"Cyst.TAL_2"
"TCGTCCATCTGGTCAA"	"Cyst.TAL_2"
"TCGTGCTCATTAGGCT"	"Cyst.PT_1"
"TCGTGCTGTGAGTCAG"	"Cyst.PC"
"TCGTGCTGTTGATGTC"	"Cyst.PT_2"
"TCGTGCTGTTTAGACC"	"Cyst.PT_3"
"TCGTGGGCATAGAGGC"	"Cyst.PT_1"
"TCGTGGGGTAGCTGAG"	"Cyst.TAL_2"
"TCTAACTAGAAGCTGC"	"Cyst.PT_1"
"TCTAACTCAATGCAAA"	"Podocytes"
"TCTAACTGTGAGGATC"	"Cyst.PT_1"
"TCTAACTGTTACACAC"	"Cyst.TAL_1"
"TCTAACTTCGCTTTAT"	"Cyst.PT_2"
"TCTAACTTCTGCACCT"	"Cyst.PC"
"TCTAACTTCTGGGCCA"	"Mac"
"TCTACATAGAGCCCAA"	"Cyst.TAL_1"
"TCTACATAGGATGTTA"	"Unk_1"
"TCTACATAGTCCCAAT"	"Unk_2"
"TCTACATCAAGACGAC"	"Cyst.PT_2"
"TCTACATGTACTAAGA"	"Cyst.TAL_2"
"TCTACATGTATGAGAT"	"Cyst.PT_1"
"TCTACATTCAAAGAAC"	"Cyst.PT_1"
"TCTACATTCTCCTGAC"	"Cyst.PT_1"
"TCTACCGAGAAACTGT"	"Cyst.PT_1"
"TCTACCGAGGATACCG"	"Cyst.PT_3"
"TCTACCGCAGCAAGAC"	":LowQual"
"TCTACCGCATTGAGCT"	"Cyst.PT_1"
"TCTACCGGTACCGTGC"	"Cyst.PT_3"
"TCTACCGGTCCCTGAG"	"Cyst.PC"
"TCTACCGGTTTAGTCG"	"Cyst.PT_1"
"TCTACCGGTTTCGATG"	"Cyst.PC"
"TCTATACAGCACACCC"	"Podocytes"
"TCTATACAGTACAACA"	"Cyst.TAL_1"
"TCTATACAGTTTCGGT"	"Fibroblast"
"TCTATACCACCGTACG"	"T-cell"
"TCTATACGTGAGCGAT"	"Cyst.TAL_1"
"TCTATACTCCGATAAC"	"Cyst.PT_3"
"TCTATCAAGCTGACCC"	"Cyst.PC"
"TCTATCAAGCTGGTGA"	"Cyst.PT_3"
"TCTATCACAATCCAGT"	"Cyst.TAL_2"
"TCTATCAGTACGTACT"	"vSMC"
"TCTATCAGTCCTGTTC"	"Fibroblast"
"TCTATCATCCGGACGT"	"Cyst.PC"
"TCTATCATCGTCAAAC"	"Cyst.TAL_1"
"TCTCACGAGCTGTTCA"	"Cyst.PT_3"
"TCTCACGGTAGTCTGT"	"Cyst.TAL_1"
"TCTCACGGTGCCGTTG"	"Cyst.PC"
"TCTCACGGTTGCCGCA"	"Cyst.TAL_1"
"TCTCACGTCAGAGTGG"	"vSMC"
"TCTCACGTCCTTCTAA"	"Cyst.TAL_2"
"TCTCACGTCTATACTC"	"Cyst.PT_1"
"TCTCACGTCTGTCCCA"	"Cyst.PT_1"
"TCTCAGCAGGCTTTCA"	"T-cell"
"TCTCAGCCAACGCATT"	"Cyst.PT_1"
"TCTCAGCCAAGAGGCT"	"Cyst.PT_2"
"TCTCAGCCAAGGTCTT"	"vSMC"
"TCTCAGCCAGGAAGTC"	"Cyst.TAL_2"
"TCTCAGCTCATTGCGA"	"Cyst.TAL_2"
"TCTCAGCTCCCTCTTT"	"Cyst.PT_2"
"TCTCCGAAGTCACAGG"	"Cyst.PT_2"
"TCTCCGAAGTCATAGA"	"Cyst.IC-A1"
"TCTCCGAAGTTGTACC"	"Cyst.TAL_2"
"TCTCCGACAAAGGTTA"	"Cyst.TAL_1"
"TCTCCGACAGCGGATA"	"EC"
"TCTCCGAGTACGACAG"	"Cyst.PT_1"
"TCTCCGAGTTTACACG"	"Cyst.TAL_1"
"TCTCTGGAGCGATGAC"	"Cyst.TAL_2"
"TCTCTGGGTAAGGCCA"	"Cyst.PT_1"
"TCTCTGGTCAATCTCT"	"Cyst.TAL_2"
"TCTGCCAAGTATAGAC"	"Cyst.PT_1"
"TCTGCCACAACAGCTT"	"Cyst.PT_1"
"TCTGCCAGTATCCTTT"	"Cyst.PT_1"
"TCTGCCAGTTCTAACG"	"Cyst.PC"
"TCTGGCTAGAAGAACG"	"Cyst.TAL_2"
"TCTGGCTCAACCGCTG"	"Cyst.PT_2"
"TCTGGCTCACGCTGTG"	"Cyst.PT_2"
"TCTGGCTCACGGCGTT"	"Cyst.PT_3"
"TCTGGCTGTCTTTCAT"	"Cyst.TAL_2"
"TCTGGCTGTTACTCAG"	"Cyst.PT_3"
"TCTGGCTGTTGCATTG"	"Cyst.TAL_2"
"TCTGGCTTCCCTGGTT"	"Cyst.PT_1"
"TCTGGCTTCCGTAGTA"	"vSMC"
"TCTGGCTTCTGCATGA"	"Cyst.PT_2"
"TCTGTCGAGACCAAAT"	"Cyst.PT_2"
"TCTGTCGCATTGACAC"	"Cyst.TAL_1"
"TCTGTCGGTACAGTCT"	"Cyst.PT_2"
"TCTGTCGGTTCGGCCA"	"Cyst.PT_3"
"TCTGTCGTCCAGTTCC"	"Cyst.TAL_1"
"TCTGTCGTCTGCAGCG"	"Cyst.TAL_2"
"TCTTAGTCACGTAACT"	"Cyst.PT_1"
"TCTTAGTCACTGTCGG"	"Cyst.TAL_1"
"TCTTAGTCAGTTCACA"	"Cyst.PT_3"
"TCTTAGTTCACCTGGG"	"Podocytes"
"TCTTAGTTCACTCACC"	"Cyst.PT_1"
"TCTTAGTTCCACTTTA"	"Cyst.TAL_1"
"TCTTAGTTCCGAAATC"	"Unk_1"
"TCTTCCTAGACCATAA"	"Cyst.PT_2"
"TCTTCCTAGGAAAGTG"	"INT"
"TCTTCCTCAGCCCACA"	"Cyst.PT_1"
"TCTTCCTCAGCGTTTA"	"Cyst.PT_1"
"TCTTCCTCATCCTTCG"	"Cyst.ATL"
"TCTTCCTGTACCTTCC"	"Fibroblast"
"TCTTGCGAGCCGTAAG"	"Cyst.PT_2"
"TCTTGCGCATTGCTTT"	"Cyst.PT_1"
"TCTTGCGGTAATTGGA"	"Cyst.PT_3"
"TCTTGCGGTAGGCTCC"	"Cyst.PT_3"
"TCTTGCGGTTTCGCTC"	"Cyst.PT_1"
"TCTTGCGTCTTCACGC"	"Mac"
"TCTTTGAAGTGACACG"	"Cyst.TAL_1"
"TCTTTGACACCGAATT"	"Cyst.TAL_1"
"TCTTTGACAGTTAAAG"	"Cyst.PT_2"
"TCTTTGACATAATCGC"	"Cyst.TAL_1"
"TCTTTGACATGACTAC"	"vSMC"
"TCTTTGATCATATGGC"	"Cyst.TAL_1"
"TCTTTGATCCTATTTG"	"Cyst.PT_2"
"TGAACGTAGGTGATCG"	"Cyst.PT_2"
"TGAACGTTCACTGTTT"	"EC"
"TGAACGTTCATGAGAA"	"vSMC"
"TGAACGTTCCCTGGTT"	"Cyst.PT_3"
"TGAACGTTCTAGTACG"	"Cyst.PT_1"
"TGAACGTTCTATGCCC"	"Cyst.TAL_2"
"TGAACGTTCTGCGGCA"	"Cyst.PT_2"
"TGAATCGAGAAGGGAT"	"Fibroblast"
"TGAATCGAGATGGCGT"	"vSMC"
"TGAATCGAGGCGAAGG"	"Cyst.TAL_1"
"TGAATCGAGTTAACAG"	"Cyst.PT_1"
"TGAATCGGTACGAAAT"	"Cyst.IC-A1"
"TGAATCGGTCCCGCAA"	"Cyst.PT_1"
"TGAATCGGTTACCTGA"	"Cyst.PT_1"
"TGAATCGTCAGGAAAT"	"Cyst.PT_1"
"TGAATCGTCCGTATGA"	"Cyst.TAL_1"
"TGAATCGTCCTCCACA"	"Cyst.PT_1"
"TGAATGCAGCAATAGT"	"Podocytes"
"TGAATGCAGGGTCACA"	"Cyst.TAL_1"
"TGAATGCCAGTTTGGT"	"Cyst.TAL_2"
"TGAATGCGTTTACGAC"	"Cyst.PT_3"
"TGAATGCTCGAGAACG"	"Cyst.TAL_1"
"TGACAGTAGAGTCACG"	"Cyst.TAL_2"
"TGACAGTAGAGTTCGG"	"Cyst.PT_1"
"TGACAGTCAGCTGTCG"	"Cyst.PT_3"
"TGACAGTGTGCCTGAC"	"Cyst.PT_1"
"TGACAGTTCACCTTAT"	"Cyst.TAL_1"
"TGACAGTTCAGTAGGG"	"Cyst.PT_1"
"TGACAGTTCATTATCC"	"Cyst.TAL_1"
"TGACAGTTCCATCCGT"	"Cyst.TAL_2"
"TGACCCTAGTGGAAGA"	"EC"
"TGACCCTGTAACGCGA"	"Cyst.PT_1"
"TGACCCTGTCATCCCT"	"Unk_2"
"TGACCCTTCGGTAGAG"	"Cyst.PT_1"
"TGACCCTTCTAAGAAG"	"Cyst.PT_1"
"TGACGCGAGAAGGTAG"	"Fibroblast"
"TGACGCGAGTATTGCC"	"Cyst.PC"
"TGACGCGCAAACTAGA"	"Cyst.PT_3"
"TGACGCGGTAATTAGG"	"Cyst.TAL_1"
"TGACGCGGTGTCCACG"	"Cyst.PT_2"
"TGACGCGGTGTGTGGA"	"Cyst.PT_1"
"TGACGCGTCACACCGG"	"Cyst.PT_2"
"TGACGCGTCAGCTAGT"	"Unk_1"
"TGACTCCCATGTGACT"	"Cyst.TAL_1"
"TGACTCCGTGCTCTCT"	"Cyst.TAL_1"
"TGACTCCTCGGAGCAA"	"Cyst.PT_2"
"TGACTCCTCTGTTGGA"	"Cyst.PC"
"TGAGACTAGAAGTGTT"	"Cyst.PT_3"
"TGAGACTCAAATGAGT"	"vSMC"
"TGAGACTCACCCTTGT"	"EC"
"TGAGACTCAGTCAACT"	"Cyst.PT_1"
"TGAGACTCATGCAGGA"	"Cyst.PT_1"
"TGAGACTGTAGTTCCA"	"Cyst.PT_1"
"TGAGACTGTCAAGCGA"	"Cyst.PT_2"
"TGAGACTGTGTATCCA"	"Cyst.PT_2"
"TGAGACTGTTAGGACG"	"Cyst.PT_3"
"TGAGACTTCCCTTGGT"	"Cyst.PT_1"
"TGAGACTTCGTTGTTT"	"Cyst.PT_1"
"TGAGACTTCTTCGATT"	"Cyst.PT_1"
"TGAGCATCAAGTTGGG"	"Cyst.PT_2"
"TGAGCATCACAGCGCT"	"Cyst.PT_2"
"TGAGCATCAGATTTCG"	"T-cell"
"TGAGCATCAGTGGGTA"	"INT"
"TGAGCATTCTCATTGT"	"T-cell"
"TGAGCGCCAATCTGCA"	"Cyst.PT_2"
"TGAGCGCCAATGGCCC"	"Cyst.PT_2"
"TGAGCGCCAGTTTCAG"	"Cyst.PT_2"
"TGAGCGCTCTCGCAGG"	"Cyst.PT_1"
"TGAGGAGAGCCGTAAG"	"Cyst.PC"
"TGAGGAGTCACCTGTC"	"Cyst.PT_1"
"TGAGGAGTCTTACCAT"	"Fibroblast"
"TGAGGAGTCTTAGGAC"	"vSMC"
"TGAGGGAAGGTCCGAA"	"Fibroblast"
"TGAGGGACATAACCCA"	"Cyst.PT_1"
"TGAGGGACATCTCATT"	"Cyst.PT_1"
"TGAGGGAGTGTAAATG"	"Cyst.PT_3"
"TGAGGGAGTTCGTTCC"	"Cyst.PT_1"
"TGAGGTTAGGCCTGAA"	"Cyst.PT_3"
"TGAGGTTCACATTGTG"	"Mac"
"TGAGGTTGTACCATAC"	"Cyst.TAL_1"
"TGAGGTTTCCCACAGG"	"Cyst.PC"
"TGAGGTTTCGGCTGTG"	"Cyst.PT_2"
"TGAGTCACACTTCAGA"	"Cyst.TAL_2"
"TGAGTCAGTAATGTGA"	"Podocytes"
"TGAGTCAGTTGCCGAC"	"Fibroblast"
"TGAGTCATCACTACGA"	"Cyst.PT_1"
"TGAGTCATCACTAGCA"	"Cyst.PT_2"
"TGAGTCATCGGTCGAC"	"Cyst.PT_3"
"TGAGTCATCTCGTGAA"	"Cyst.TAL_1"
"TGATCAGAGCTCAGAG"	"Fibroblast"
"TGATCAGCAACGGGTA"	"Cyst.PT_2"
"TGATCAGCACTTCCTG"	"Cyst.PC"
"TGATCAGGTTGTTGAC"	"EC"
"TGATCAGTCTCGGTCT"	"Cyst.TAL_2"
"TGATCTTGTCATCGCG"	"Cyst.PT_2"
"TGATCTTGTGAATAAC"	"Cyst.PT_2"
"TGATCTTGTGTCCCTT"	"Cyst.TAL_2"
"TGATCTTGTGTGTGGA"	"Cyst.PT_1"
"TGATCTTGTTATTCCT"	"Cyst.PT_1"
"TGATCTTGTTTAGACC"	"Cyst.TAL_1"
"TGATCTTTCGACTCCT"	"Cyst.PT_2"
"TGATGCAAGAACAAGG"	"EC"
"TGATGCAAGGGTTGCA"	"Cyst.PT_1"
"TGATGGTAGTGGACTG"	"Cyst.PT_2"
"TGATGGTCATGAAAGT"	"Cyst.PT_3"
"TGATGGTCATTGTGCA"	"Cyst.PT_2"
"TGATGGTGTGCATCTA"	"Cyst.PT_3"
"TGATGGTGTTGGAGGT"	"Cyst.TAL_2"
"TGATGGTTCGCCTAGG"	"Cyst.PT_2"
"TGATTCTCATCAGTGT"	"Cyst.TAL_2"
"TGATTCTGTACAATAG"	"Podocytes"
"TGATTCTTCCTTCACG"	"Cyst.TAL_2"
"TGATTTCCAGACCAGA"	"Cyst.PT_3"
"TGATTTCCAGAGACTG"	"Cyst.PT_2"
"TGATTTCGTATCGTTG"	"Cyst.PT_1"
"TGATTTCGTGGTGATG"	"Cyst.PT_1"
"TGATTTCTCCGTGTCT"	"Cyst.PT_3"
"TGATTTCTCGTAGTGT"	"Cyst.TAL_2"
"TGCACGGAGACACACG"	"Cyst.PT_1"
"TGCACGGAGAGTTCGG"	"Cyst.PT_2"
"TGCACGGAGCAGTACG"	"Cyst.PT_1"
"TGCACGGAGTGCCAGA"	"EC"
"TGCACGGCAGGTTCAT"	"Cyst.PT_1"
"TGCACGGGTATACAGA"	"Fibroblast"
"TGCACGGGTGAATATG"	"Cyst.PT_1"
"TGCACGGTCGCAATTG"	"Cyst.PT_1"
"TGCACGGTCGCAGTGC"	"Cyst.TAL_2"
"TGCACGGTCGCCACTT"	"Cyst.PT_1"
"TGCACGGTCGCTAGCG"	"EC"
"TGCAGATAGAGTTGAT"	"Cyst.TAL_2"
"TGCAGATAGCCTGAGA"	"Cyst.PT_2"
"TGCAGATCACTGTTCC"	"Cyst.PT_1"
"TGCAGATGTTGGTGTT"	"Cyst.PT_2"
"TGCAGATTCTCGCGTT"	"Mac"
"TGCAGGCAGACGCATG"	"Cyst.PT_1"
"TGCAGGCGTTACGATC"	"Cyst.PT_1"
"TGCAGGCGTTGAGGAC"	"EC"
"TGCAGGCGTTGTGTTG"	"Cyst.PT_1"
"TGCAGTACAGAAACCG"	"Cyst.PT_1"
"TGCAGTATCATCTGTT"	"Cyst.PT_1"
"TGCATCCAGCTGCGAA"	"Cyst.PT_3"
"TGCATCCGTTGCATGT"	"Cyst.PT_2"
"TGCATCCGTTGGAGAC"	"Cyst.PT_3"
"TGCATCCGTTTGCAGT"	"Cyst.PT_3"
"TGCATCCTCAGCTTCC"	"Cyst.TAL_1"
"TGCATCCTCGCAGTTA"	"Cyst.PT_2"
"TGCATGAAGCCAAGTG"	"Cyst.TAL_1"
"TGCATGACAAGTGTCT"	"Cyst.PT_1"
"TGCATGACATCCGTGG"	"Cyst.PT_2"
"TGCATGAGTGAGCTCC"	"Cyst.TAL_1"
"TGCATGAGTTATGTCG"	"Cyst.PT_2"
"TGCATGATCCATTGCC"	"Cyst.TAL_1"
"TGCATGATCCCATGGG"	"Cyst.PT_1"
"TGCATGATCTGCATGA"	"EC"
"TGCATGATCTTCCTAA"	"Mac"
"TGCCGAGCAAGCACAG"	"Cyst.PT_1"
"TGCCGAGCATCCTTGC"	"EC"
"TGCCGAGGTACCATAC"	"INT"
"TGCCGAGGTGTCCCTT"	"EC"
"TGCCGAGTCGCTCTCA"	"Cyst.PT_3"
"TGCCGAGTCTTGGTCC"	"Cyst.PC"
"TGCGACGAGTTGAATG"	"Cyst.PC"
"TGCGACGGTAGAAACT"	"Podocytes"
"TGCGACGGTCCGATCG"	"Cyst.PT_1"
"TGCGACGGTCTCCCTA"	"Cyst.TAL_1"
"TGCGACGTCGCTCATC"	"EC"
"TGCGATAAGGGTCTTT"	"Cyst.PT_1"
"TGCGATACAGGTGTGA"	"Cyst.PT_3"
"TGCGATATCACTTGGA"	"Cyst.PT_2"
"TGCGATATCGATGGAG"	"EC"
"TGCGGCAGTACCTGTA"	"Cyst.TAL_1"
"TGCGGCATCGCGCTGA"	"Cyst.PT_2"
"TGCGGGTAGAGCCGAT"	"Cyst.TAL_1"
"TGCGGGTCAACCAGAG"	"Cyst.PT_1"
"TGCGGGTCACATGACT"	"Cyst.TAL_1"
"TGCGGGTCAGCAGATG"	"Cyst.TAL_1"
"TGCGGGTTCGACCTAA"	"Cyst.TAL_2"
"TGCGGGTTCTGAGGTT"	"Cyst.PT_1"
"TGCTCCACAGGAATAT"	"Cyst.TAL_2"
"TGCTCCAGTACCCACG"	"Cyst.TAL_1"
"TGCTCCAGTCGGCACT"	"Cyst.TAL_2"
"TGCTCCAGTGGAAATT"	"Mac"
"TGCTCGTCACTTGGGC"	"Cyst.PT_1"
"TGCTCGTTCACCCATC"	"Cyst.PC"
"TGCTCGTTCTAGAACC"	"Cyst.PT_1"
"TGCTGAAAGAAGCCAC"	"Cyst.PC"
"TGCTGAAAGCTCGAAG"	"EC"
"TGCTGAAAGTCCGTCG"	"Cyst.PC"
"TGCTGAACAAAGACTA"	"Podocytes"
"TGCTGAACAATCGTCA"	"EC"
"TGCTGAACACAGCCTG"	"Fibroblast"
"TGCTGAAGTGACTCGC"	"Cyst.PT_1"
"TGCTGAAGTGACTGAG"	"Cyst.TAL_1"
"TGCTGAAGTTCCTAGA"	"Cyst.PT_1"
"TGCTTCGAGAGCAGTC"	"Cyst.PT_1"
"TGCTTCGAGGCATTTC"	"Fibroblast"
"TGCTTCGAGGTTAAAC"	"Cyst.PT_2"
"TGCTTCGCATAACGGG"	"Cyst.TAL_1"
"TGCTTCGCATGGCCAC"	"Unk_2"
"TGCTTCGGTATCACGT"	"Mac"
"TGCTTCGGTTGCGGCT"	"Cyst.PT_2"
"TGCTTGCAGCAATAAC"	"Cyst.PT_1"
"TGCTTGCCACAAATGA"	"Cyst.PT_1"
"TGCTTGCGTGATAGTA"	"Cyst.PT_2"
"TGCTTGCGTTATCTGG"	"Cyst.PT_2"
"TGCTTGCTCACCGGTG"	"Cyst.PT_2"
"TGCTTGCTCTCCTACG"	"Cyst.TAL_2"
"TGGAACTCACGTAGTT"	"Cyst.PT_2"
"TGGAACTCATCTATCT"	"EC"
"TGGAACTGTACGATGG"	"Cyst.PT_2"
"TGGAACTGTTGCTCCT"	"Cyst.PT_1"
"TGGAGAGAGTGTTCCA"	"Cyst.PC"
"TGGAGAGGTAGGATAT"	"Cyst.PC"
"TGGAGGACACTTCCTG"	"Cyst.PT_1"
"TGGAGGACAGAGGTAC"	"Cyst.PT_2"
"TGGAGGACATCCCACT"	"Cyst.PT_1"
"TGGAGGATCCTACCAC"	"vSMC"
"TGGAGGATCGCCGAAC"	"Fibroblast"
"TGGATCAAGCTAGCCC"	"Cyst.TAL_1"
"TGGATCAAGGTGCTGA"	"Cyst.PC"
"TGGATCACATCGGAAG"	"Cyst.TAL_1"
"TGGATCAGTGAAGCTG"	"Cyst.TAL_1"
"TGGATCATCCCGAATA"	"Cyst.PT_1"
"TGGATCATCCGCACTT"	"EC"
"TGGATCATCGTACACA"	"Fibroblast"
"TGGATCATCTATCCAT"	"Cyst.PC"
"TGGATGTAGTGTTCAC"	"Cyst.PT_2"
"TGGATGTAGTTTGAGA"	"Cyst.TAL_2"
"TGGATGTCAAATGCGG"	"Mac"
"TGGATGTCATAGTCGT"	"Cyst.TAL_2"
"TGGATGTCATGATAGA"	"Fibroblast"
"TGGATGTTCTCGTCGT"	"Fibroblast"
"TGGATGTTCTTGCAGA"	"Cyst.PT_3"
"TGGCGTGAGACGGTCA"	"Cyst.PT_1"
"TGGCGTGCACATATGC"	"Cyst.PT_1"
"TGGCGTGGTATCATGC"	"Cyst.PT_1"
"TGGCGTGTCGTCGACG"	"Cyst.PC"
"TGGGAAGAGAACCCGA"	"Fibroblast"
"TGGGAAGAGCATTTGC"	"vSMC"
"TGGGAAGAGTAGGATT"	"Mac"
"TGGGAAGTCGTTACCC"	"Cyst.TAL_2"
"TGGGAGACACCATATG"	"Cyst.PT_3"
"TGGGAGATCAGCGGAA"	"Cyst.TAL_2"
"TGGGATTCAGAGATTA"	"Cyst.PT_1"
"TGGGATTGTTTCCCAC"	"Cyst.PT_2"
"TGGGATTTCTGCGGCA"	"Cyst.TAL_2"
"TGGGCGTCAAGAGGCT"	"Cyst.TAL_1"
"TGGGCGTCAATCGTCA"	"Cyst.TAL_2"
"TGGGCGTGTCTTGCTC"	"Cyst.TAL_1"
"TGGGCGTGTGAGACCA"	"Cyst.PT_2"
"TGGGCGTTCTTCACGC"	"Cyst.PT_1"
"TGGGCTGAGAGCTGCA"	"EC"
"TGGGCTGCAATAACGA"	"Cyst.TAL_2"
"TGGGCTGCAATTGGTC"	"Cyst.PT_2"
"TGGGCTGGTATGATCC"	"Cyst.PT_2"
"TGGGCTGGTGTACAGG"	"Cyst.TAL_1"
"TGGGCTGTCATATGGC"	"Cyst.PT_2"
"TGGGCTGTCCGCATAA"	"Cyst.PT_1"
"TGGGCTGTCTCATTTG"	"Cyst.TAL_1"
"TGGGTTAAGATCCGAG"	"Cyst.PT_2"
"TGGGTTAAGGATAATC"	"Cyst.TAL_1"
"TGGGTTAAGTGAGTTA"	"Cyst.TAL_1"
"TGGGTTACAACCACGC"	"Podocytes"
"TGGGTTACACATACGT"	"vSMC"
"TGGGTTACATGCCGCA"	"Cyst.PT_3"
"TGGGTTACATTAAGCC"	"Cyst.TAL_1"
"TGGGTTAGTACCCGCA"	"Cyst.TAL_1"
"TGGTACAAGCGCGTTC"	"Fibroblast"
"TGGTACAAGGAAGTAG"	"vSMC"
"TGGTACAAGGGCTGAT"	"Cyst.PT_2"
"TGGTACACAACGGTAG"	"Cyst.PT_1"
"TGGTACACAGAGATTA"	"Cyst.PT_1"
"TGGTACAGTATCTCGA"	"Cyst.TAL_1"
"TGGTAGTAGTGTTCCA"	"Cyst.PT_1"
"TGGTAGTAGTTGTACC"	"Cyst.PT_1"
"TGGTAGTCATCCTCAC"	"Cyst.TAL_1"
"TGGTAGTGTCTGTGAT"	"Mac"
"TGGTAGTGTGATTGGG"	"Cyst.TAL_1"
"TGGTAGTTCACTGTCC"	"Unk_2"
"TGGTAGTTCGTCTACC"	"Cyst.TAL_1"
"TGGTAGTTCTCCTGCA"	"Cyst.PT_3"
"TGGTAGTTCTCTATAC"	"Cyst.PT_1"
"TGGTGATAGAAATGGG"	"Cyst.TAL_1"
"TGGTGATAGCTCAGAG"	"Cyst.TAL_2"
"TGGTGATCACATGAAA"	"Podocytes"
"TGGTGATTCATGCCGG"	"Cyst.PC"
"TGGTTAGTCGGCCTTT"	"Cyst.PC"
"TGTAACGAGAGGTTAT"	"Cyst.PT_2"
"TGTAACGCAACCTAAC"	"Fibroblast"
"TGTAACGCACGCTTAA"	"T-cell"
"TGTAACGCACTTCAGA"	"Cyst.PT_2"
"TGTAACGGTGAGTAGC"	"Cyst.PT_1"
"TGTAACGGTTATCTTC"	"Cyst.TAL_2"
"TGTAAGCAGATGCTAA"	"Cyst.PT_1"
"TGTAAGCCAGGAGGAG"	"Cyst.PT_2"
"TGTAAGCTCCATCACC"	"Cyst.PT_1"
"TGTAAGCTCCCTCTAG"	"Unk_1"
"TGTACAGCACACTTAG"	"Cyst.TAL_1"
"TGTACAGCACAGTCGC"	"Cyst.TAL_1"
"TGTACAGCACATTCGA"	"Cyst.TAL_2"
"TGTACAGCACTTCTCG"	"Cyst.PT_3"
"TGTACAGCAGAGCGTA"	"Cyst.PT_3"
"TGTACAGCATGGGCAA"	"Cyst.PT_1"
"TGTACAGGTGCGGATA"	"Podocytes"
"TGTACAGTCTGCATAG"	"Cyst.PT_1"
"TGTAGACAGCCAACCC"	"Cyst.PC"
"TGTAGACAGGGCCTCT"	"Cyst.PT_3"
"TGTAGACCATGTAACC"	"Cyst.PT_3"
"TGTAGACTCAAACTGC"	"Cyst.PT_1"
"TGTAGACTCATGCATG"	"Cyst.PT_3"
"TGTAGACTCTGTGCAA"	"Cyst.PT_1"
"TGTCAGAAGACGTCCC"	"Cyst.PT_1"
"TGTCAGACAACGCATT"	"Cyst.PT_1"
"TGTCAGACAACGGGTA"	"Cyst.PT_1"
"TGTCAGACAGACCATT"	"Cyst.PT_1"
"TGTCAGACATGCGTGC"	"Cyst.PT_3"
"TGTCAGAGTGGAACAC"	"Cyst.PT_1"
"TGTCCACCAAGTGCTT"	"Cyst.TAL_1"
"TGTCCACGTCTATGAC"	"Cyst.PT_1"
"TGTCCACTCCAAGAGG"	"Cyst.TAL_2"
"TGTCCCACAGCCCAGT"	"Cyst.PT_1"
"TGTCCCACAGTTAGAA"	"vSMC"
"TGTCCCAGTTCTCACC"	"Cyst.TAL_2"
"TGTCCCAGTTGTTTGG"	"Unk_2"
"TGTCCCATCTGAGAAA"	"Cyst.PT_1"
"TGTCCTGCAGTCTCTC"	"Cyst.PT_1"
"TGTCCTGTCTAGACAC"	"Cyst.TAL_2"
"TGTGAGTAGAGCTGCA"	"Cyst.PT_1"
"TGTGAGTAGAGGCGGA"	"Cyst.TAL_2"
"TGTGAGTAGCTTTCTT"	"Cyst.TAL_1"
"TGTGATGCAACTTGCA"	"Cyst.PC"
"TGTGATGCACTGAGTT"	"Cyst.PT_2"
"TGTGATGCAGGTACGA"	"vSMC"
"TGTGATGCATCAGCTA"	"Cyst.TAL_2"
"TGTGATGGTAACCCGC"	"Cyst.PT_2"
"TGTGATGGTACGAAAT"	"Cyst.PT_1"
"TGTGATGGTAGTCTGT"	"Podocytes"
"TGTGATGTCATCACAG"	"Cyst.TAL_2"
"TGTGCGGAGGAGTCTG"	"Cyst.PT_1"
"TGTGCGGAGGTTATAG"	"Cyst.TAL_2"
"TGTGCGGCAAACTAAG"	"Cyst.TAL_1"
"TGTGCGGCACAACGAG"	"Cyst.PT_1"
"TGTGCGGCACCCTTAC"	"vSMC"
"TGTGCGGCATCGTCCT"	"Cyst.PT_3"
"TGTGCGGTCTATCACT"	"Fibroblast"
"TGTGGCGAGTATTCCG"	"Cyst.PT_1"
"TGTGGCGAGTCGAAAT"	"vSMC"
"TGTGGCGAGTGACCTT"	"Cyst.TAL_2"
"TGTGGCGGTCGAACAG"	"Cyst.PT_2"
"TGTGGCGGTGCTGTCG"	"Cyst.PC"
"TGTGGCGTCCTCTTTC"	"Cyst.PC"
"TGTGGCGTCTCGACCT"	"Cyst.TAL_2"
"TGTGTGAAGATCGCTT"	"Unk_2"
"TGTGTGAAGGCTTCCG"	"Cyst.PT_3"
"TGTGTGAGTTCCTACC"	"Cyst.PT_2"
"TGTGTGAGTTTACGAC"	"Cyst.PT_2"
"TGTTACTAGATGCAGC"	"Cyst.PT_1"
"TGTTACTAGCCTAGGA"	"Cyst.PT_1"
"TGTTACTAGGCCGCTT"	"Cyst.TAL_2"
"TGTTACTCAGGTCAAG"	"Cyst.PT_2"
"TGTTACTCAGTATGAA"	"Cyst.PT_1"
"TGTTACTGTATTCCTT"	"Cyst.TAL_1"
"TGTTACTGTCCACAGC"	"Cyst.PT_1"
"TGTTACTGTGGACCTC"	"Cyst.TAL_1"
"TGTTACTTCAAAGGAT"	"Cyst.PT_1"
"TGTTCATAGCCGCTTG"	"Cyst.PT_2"
"TGTTCATCAGATGCGA"	"Mac"
"TGTTCATCAGGTTCAT"	"Cyst.PT_1"
"TGTTCATCAGTCGGAA"	"Cyst.PT_1"
"TGTTCATTCCATTTCA"	"Cyst.PT_3"
"TGTTCATTCTGGTCAA"	"Cyst.TAL_2"
"TGTTCCGAGATCGCCC"	"Cyst.TAL_2"
"TGTTCCGCACATTGTG"	"Cyst.TAL_1"
"TGTTCCGCAGTCTTCC"	"Cyst.PT_3"
"TGTTCCGGTCACTCAA"	"Cyst.PT_3"
"TGTTCCGGTGCCTTCT"	"Cyst.PT_1"
"TGTTCTACATGACTGT"	"Cyst.PT_3"
"TGTTCTAGTCCCTAAA"	"Cyst.TAL_1"
"TGTTCTAGTGTGACCC"	"Fibroblast"
"TGTTCTAGTTCCGCTT"	"Cyst.PT_2"
"TGTTCTATCATAAGGA"	"Cyst.PT_1"
"TGTTCTATCCCATGGG"	"Cyst.PT_1"
"TGTTGAGAGCAGCGAT"	"Cyst.ATL"
"TGTTGAGGTATGGTTC"	"Cyst.TAL_1"
"TGTTGAGGTCTCACAA"	"Cyst.TAL_1"
"TGTTGAGTCACAATGC"	"Cyst.PT_1"
"TGTTGGAAGCAGTAAT"	"Cyst.TAL_1"
"TGTTGGAAGTTGAATG"	"Cyst.PT_1"
"TGTTGGACAATCGAAA"	"Podocytes"
"TGTTGGACAGACCTGC"	"Cyst.PT_1"
"TGTTGGACATATAGCC"	"Cyst.TAL_2"
"TGTTGGAGTACTTGTG"	"Cyst.PT_1"
"TGTTGGAGTCAGTCCG"	"Cyst.PT_1"
"TGTTGGATCCATATGG"	"Cyst.PT_3"
"TGTTTGTAGCACACAG"	"EC"
"TGTTTGTCAGTTCCAA"	"Cyst.PT_1"
"TGTTTGTCATGGCGCT"	"Cyst.TAL_1"
"TGTTTGTGTACCTATG"	"Cyst.PT_1"
"TGTTTGTGTTCTCCCA"	"Cyst.PT_2"
"TGTTTGTTCGAGTGAG"	"Cyst.TAL_1"
"TTAATCCAGTCTCGTA"	"Cyst.PT_3"
"TTAATCCAGTCTTGGT"	"Cyst.PT_1"
"TTAATCCCATGTTCGA"	"Cyst.PT_2"
"TTAATCCGTCTGTGAT"	"Podocytes"
"TTAATCCGTTTCGATG"	"Cyst.PT_3"
"TTAATCCTCCGCGATG"	"Cyst.PT_3"
"TTAATCCTCTACACTT"	"Fibroblast"
"TTACAGGAGGATGCGT"	"Cyst.PT_1"
"TTACAGGCACTACCCT"	"Cyst.PT_3"
"TTACAGGGTCATCCCT"	"Cyst.PT_1"
"TTACAGGTCCCTGTTG"	"Cyst.TAL_2"
"TTACAGGTCGCAGTTA"	"EC"
"TTACAGGTCTCAGAAC"	"Cyst.PT_3"
"TTACCATAGAGAGCAA"	"EC"
"TTACCATAGAGTATAC"	"Podocytes"
"TTACCATAGCGTGTCC"	"Cyst.PT_1"
"TTACCATCAAATGCTC"	"Cyst.TAL_1"
"TTACCATCAAGCGATG"	"Cyst.PT_1"
"TTACCATGTATCGAAA"	"Cyst.TAL_2"
"TTACCATGTGAGTCAG"	"Cyst.PT_1"
"TTACCATGTTTGATCG"	"EC"
"TTACCATTCCGCACTT"	"Cyst.PT_3"
"TTACCATTCTCTATGT"	"Cyst.PT_1"
"TTACCGCAGCAGCCTC"	"Cyst.TAL_2"
"TTACCGCAGCCTCTGG"	"Cyst.PT_3"
"TTACCGCAGGCCACTC"	"Cyst.TAL_1"
"TTACCGCCACCGGTCA"	"Podocytes"
"TTACCGCCACTCCACT"	"Cyst.PT_2"
"TTACCGCCAGTCTACA"	"Cyst.PC"
"TTACCGCGTATGGAAT"	"Cyst.PT_2"
"TTACCGCGTGATGTAA"	"Fibroblast"
"TTACCGCTCTCGAGTA"	"Cyst.TAL_1"
"TTACGCCCATCGTGCG"	"Cyst.PT_2"
"TTACGTTAGCGAGTCA"	"Cyst.PT_3"
"TTACGTTAGGCACGAT"	"Cyst.PT_2"
"TTACGTTAGGGAACAA"	"Unk_2"
"TTACGTTAGTGCCAGA"	"Cyst.TAL_1"
"TTACGTTCACGACTAT"	"EC"
"TTACGTTGTCTTGGTA"	"Cyst.PT_1"
"TTACGTTGTGGACCTC"	"Cyst.PT_1"
"TTACGTTTCACCTGTC"	"Cyst.PT_3"
"TTACGTTTCTCATTGT"	"Cyst.PT_2"
"TTACTGTAGAACCCGA"	"Cyst.PT_1"
"TTACTGTAGCGGGTAT"	"Cyst.PT_3"
"TTACTGTGTAGCTTTG"	"Unk_2"
"TTACTGTGTGTTCGAT"	"Cyst.PT_2"
"TTACTGTTCAGCACCG"	"Cyst.PC"
"TTAGGCACATCTCGTC"	"Cyst.TAL_2"
"TTAGGCAGTGAATTAG"	"Cyst.PT_1"
"TTAGGCATCCCATGGG"	":LowQual"
"TTAGGGTAGGCTAGCA"	"Cyst.IC-A1"
"TTAGGGTCAAGGATGC"	"Cyst.PT_1"
"TTAGGGTCAGCACAGA"	"Cyst.PT_1"
"TTAGGGTGTTCCTAGA"	"EC"
"TTAGGGTGTTGGGATG"	"vSMC"
"TTAGGGTTCCGAGGCT"	"vSMC"
"TTAGGGTTCCTAAACG"	"Cyst.PT_1"
"TTAGGGTTCGAGAATA"	"Cyst.PT_3"
"TTAGGGTTCTCTTCAA"	"Cyst.TAL_2"
"TTAGTCTAGATGAAGG"	"Cyst.PT_3"
"TTAGTCTCAATCTCGA"	"Cyst.PT_2"
"TTAGTCTTCTTGAACG"	"Cyst.PT_3"
"TTAGTCTTCTTGTGCC"	"EC"
"TTATTGCAGCGACTGA"	"Cyst.PC"
"TTATTGCAGTGAGTTA"	"Cyst.PT_1"
"TTATTGCCAGCATTGT"	"Cyst.PT_1"
"TTATTGCCATACACCA"	"Cyst.PT_2"
"TTATTGCGTCACTACA"	"Cyst.TAL_1"
"TTATTGCTCAGAGCAG"	"Cyst.TAL_1"
"TTCAATCAGACCTTTG"	"Cyst.PT_1"
"TTCAATCAGGTATTGA"	"Cyst.PT_3"
"TTCAATCGTGGTGATG"	"Cyst.PT_1"
"TTCAATCGTTGCGTAT"	"Cyst.TAL_1"
"TTCAATCTCAAACTGC"	"Cyst.PT_1"
"TTCAATCTCTGTCCGT"	"Cyst.TAL_2"
"TTCACCGAGAGTTGCG"	"Cyst.PT_1"
"TTCACCGAGCGACATG"	"Cyst.PT_2"
"TTCACCGAGTCGAATA"	"Cyst.TAL_2"
"TTCACCGCACATGACT"	"Cyst.PT_2"
"TTCACCGCAGTTTCGA"	"Podocytes"
"TTCACCGGTAGATCCT"	"Cyst.PT_2"
"TTCACCGGTTTCCAAG"	"Cyst.TAL_1"
"TTCACCGTCGGCTGTG"	"Unk_1"
"TTCACGCCACGTTGGC"	"Cyst.TAL_1"
"TTCACGCCAGGCACAA"	"Cyst.PT_3"
"TTCACGCGTTCGTGCG"	"Cyst.TAL_2"
"TTCACGCTCCATTGTT"	"Unk_1"
"TTCAGGACAACGCCCA"	"Cyst.PT_1"
"TTCAGGACATCAACCA"	"Cyst.PT_2"
"TTCAGGAGTTGGAGGT"	"EC"
"TTCAGGATCGTGCATA"	"Cyst.PT_2"
"TTCATGTCAGGAGGTT"	"Cyst.PC"
"TTCATGTGTCGCAGTC"	"Cyst.TAL_1"
"TTCATGTGTGAAAGTT"	"EC"
"TTCATGTGTGAACGGT"	"Cyst.PT_1"
"TTCATGTTCAGACTGT"	"vSMC"
"TTCATGTTCCCTCAAC"	"Cyst.PT_3"
"TTCATGTTCTTCCACG"	"Cyst.ATL"
"TTCATTGAGCTAGTTC"	"Cyst.PT_1"
"TTCATTGAGTCTGCGC"	"vSMC"
"TTCATTGCAGTCAGAG"	"Cyst.TAL_1"
"TTCCAATCACAGTCCG"	"Cyst.TAL_2"
"TTCCAATCATAGGAGC"	"Cyst.IC-A1"
"TTCCAATGTCCTTTGC"	"Cyst.PT_1"
"TTCCAATGTCGATTTG"	"Cyst.PT_1"
"TTCCAATGTTGTCCCT"	"Mac"
"TTCCAATGTTTCCCAC"	"Cyst.PT_1"
"TTCCACGAGAATTGCA"	"Cyst.TAL_2"
"TTCCACGAGATTACCC"	"Cyst.TAL_2"
"TTCCACGAGGATAATC"	"Cyst.PT_1"
"TTCCACGCAGCCGTCA"	"Cyst.PT_1"
"TTCCACGTCAGCTTCC"	"Cyst.TAL_1"
"TTCCACGTCGTAGTGT"	"Cyst.PT_3"
"TTCCGGTAGGCCTTCG"	"Cyst.PT_1"
"TTCCGGTAGGGATCGT"	"Cyst.PT_3"
"TTCCGGTAGTATTCCG"	"Cyst.PT_1"
"TTCCGGTCAGTCTCTC"	"Cyst.PT_2"
"TTCCGGTGTAGCGTTT"	"vSMC"
"TTCCGGTGTCGCACAC"	"Cyst.PT_1"
"TTCCGGTGTTCCGCAG"	"Cyst.PT_1"
"TTCCGTGAGATGAATC"	"Cyst.PT_1"
"TTCCGTGCAGTTGTCA"	"Cyst.PT_2"
"TTCCGTGCATCGGCCA"	"Cyst.PC"
"TTCCGTGCATCTATCT"	"Cyst.PC"
"TTCCGTGGTGTGTGTT"	"Cyst.PT_2"
"TTCCGTGTCTATTGTC"	"Cyst.PT_2"
"TTCCTAAAGACACACG"	"Cyst.PT_2"
"TTCCTAAAGCATGCAG"	"Cyst.ATL"
"TTCCTAACAGAAGTGC"	"Cyst.PT_1"
"TTCCTAAGTATGGAAT"	":LowQual"
"TTCCTAAGTATGGTAA"	"vSMC"
"TTCCTAATCCTCAGAA"	"Cyst.PT_3"
"TTCCTAATCTCCGCAT"	"Cyst.TAL_1"
"TTCCTAATCTTCTAAC"	"Cyst.TAL_1"
"TTCCTCTAGACCTCAT"	"Cyst.PT_3"
"TTCCTCTAGGTCTTTG"	"Cyst.PT_1"
"TTCCTCTCAACAAAGT"	"EC"
"TTCCTCTCACTGGCCA"	"Cyst.PT_1"
"TTCCTCTGTATTCCGA"	"Cyst.TAL_2"
"TTCCTCTGTGCATTTG"	"Cyst.TAL_1"
"TTCCTCTGTTAGAGAT"	"vSMC"
"TTCCTCTGTTAGGCTT"	"Cyst.PT_1"
"TTCCTCTTCGTCCTCA"	"Cyst.TAL_1"
"TTCCTCTTCTCGCTTG"	"Cyst.PT_3"
"TTCCTCTTCTGAACGT"	"Cyst.PT_1"
"TTCCTTCAGGCCACTC"	"Cyst.PT_1"
"TTCCTTCCAGTTGCGC"	"Cyst.PT_3"
"TTCCTTCCATGGCCCA"	"Cyst.PT_2"
"TTCCTTCTCCGAGTGC"	"Unk_2"
"TTCCTTCTCTACTGCC"	"Cyst.PT_1"
"TTCCTTCTCTGGACCG"	"Mac"
"TTCGATTGTCCGTTTC"	"Cyst.PT_1"
"TTCGATTGTGCTGCAC"	"Cyst.PT_1"
"TTCGATTTCTAGTTCT"	"Cyst.PC"
"TTCGCTGCAATGCAGG"	"Mac"
"TTCGCTGGTGACACAG"	"Cyst.PT_1"
"TTCGCTGTCCCATAGA"	"Mac"
"TTCGGTCAGTTTGAGA"	"Cyst.PT_3"
"TTCGGTCCAGTTGTTG"	":LowQual"
"TTCGGTCTCAAGAGGC"	"Cyst.PT_2"
"TTCGGTCTCTGCTTTA"	"Cyst.PT_2"
"TTCTAACCACATCATG"	"Cyst.TAL_2"
"TTCTAACGTATCACCA"	"Cyst.PT_3"
"TTCTAACTCATTGGTG"	"Cyst.PT_1"
"TTCTAACTCTCGACCT"	"Cyst.PT_3"
"TTCTAACTCTCTAAGG"	"Cyst.TAL_2"
"TTCTAGTGTGTTCATG"	"Cyst.PT_3"
"TTCTAGTTCGCTCTCA"	"vSMC"
"TTCTCTCAGGGAGGGT"	"EC"
"TTCTCTCCAGATTAAG"	"Cyst.TAL_2"
"TTCTCTCCAGTTGGTT"	"Cyst.PT_1"
"TTCTCTCCATCGTTCC"	"Cyst.PT_1"
"TTCTCTCGTATGCTTG"	"Cyst.PT_1"
"TTCTCTCGTTGACGGA"	"Cyst.PT_2"
"TTCTGTAAGTATAGGT"	"Cyst.PT_1"
"TTCTGTACACGCTGAC"	"Cyst.PT_2"
"TTCTGTACACGTAGAG"	"vSMC"
"TTCTGTACATCCCGTT"	"Cyst.PT_3"
"TTCTGTACATGTGGCC"	"Cyst.PT_1"
"TTCTGTAGTTCCCACT"	"Cyst.PT_1"
"TTCTGTATCAGATTGC"	"Fibroblast"
"TTCTGTATCAGCTCTC"	"Cyst.PC"
"TTCTGTATCCCAGGAC"	"Unk_2"
"TTCTGTATCGGTCACG"	"EC"
"TTCTTCCAGCTTGTGT"	"Cyst.TAL_1"
"TTCTTCCAGTGGTTGG"	"Cyst.PT_1"
"TTCTTCCCATACTGTG"	"Cyst.PT_1"
"TTCTTCCGTCGATTCA"	"Cyst.TAL_2"
"TTCTTCCGTTGGGAAC"	"Cyst.TAL_1"
"TTCTTCCTCGGTAAGG"	"Cyst.PT_2"
"TTCTTGACAACCGTAT"	"Cyst.PT_1"
"TTCTTGACACCCAAGC"	"Cyst.TAL_1"
"TTCTTGACAGAGGCAT"	"Cyst.PT_1"
"TTCTTGAGTACAACGG"	"EC"
"TTCTTGAGTACAGGTG"	"Fibroblast"
"TTCTTGAGTTAGGACG"	"Cyst.PT_2"
"TTCTTGATCCAGTGCG"	"Cyst.TAL_2"
"TTCTTGATCGCGATCG"	"Cyst.PT_1"
"TTGAACGAGGACAACC"	"Podocytes"
"TTGAACGAGGTCCCTG"	"Cyst.TAL_2"
"TTGAACGTCCAACCAA"	"Cyst.PT_3"
"TTGAACGTCGGTCAGC"	"Cyst.PT_1"
"TTGACCCCATCAACCA"	"Cyst.TAL_1"
"TTGACCCGTTACCTTT"	"Unk_1"
"TTGACCCGTTCCACAA"	"Cyst.TAL_2"
"TTGACCCTCACCTGTC"	"Cyst.PT_2"
"TTGACCCTCGCGTGAC"	"Cyst.PT_2"
"TTGACCCTCGGTGTAT"	"Unk_1"
"TTGAGTGAGGTTGCCC"	"Cyst.PC"
"TTGAGTGGTGGCTTAT"	"Cyst.PT_2"
"TTGAGTGGTTCGGTTA"	"Cyst.PC"
"TTGATGGAGTGAGGTC"	"Cyst.PT_1"
"TTGATGGCAGACTGCC"	"Cyst.PC"
"TTGATGGGTATTTCTC"	"Cyst.PT_1"
"TTGATGGGTCAGGTGA"	"Cyst.TAL_2"
"TTGATGGTCGAAGAAT"	"Cyst.PC"
"TTGCATTAGATGTTAG"	"Cyst.PT_3"
"TTGCATTAGCCGATTT"	"Cyst.PT_1"
"TTGCATTAGGAAGAAC"	"Cyst.PC"
"TTGCATTCAAGACCTT"	"EC"
"TTGCATTCAATCGAAA"	"Cyst.PT_2"
"TTGCATTCAGGAGACT"	"Cyst.PT_2"
"TTGCATTCATGACACT"	"Cyst.TAL_2"
"TTGCATTTCAAAGAAC"	"Cyst.PT_2"
"TTGCATTTCAGGAGAC"	"Cyst.PT_1"
"TTGCATTTCCACGAAT"	"Cyst.PT_1"
"TTGCCTGAGTTAGAAC"	"T-cell"
"TTGCCTGGTGTGTGGA"	"Cyst.PT_3"
"TTGCGTCTCACCATAG"	"Cyst.TAL_2"
"TTGCGTCTCATGAGGG"	"Cyst.PT_2"
"TTGCGTCTCGATACAC"	"Cyst.PT_1"
"TTGCTGCAGTGAGGCT"	"Podocytes"
"TTGCTGCGTACAACGG"	"Cyst.PT_2"
"TTGCTGCGTTGCTGAT"	"Cyst.PC"
"TTGCTGCGTTTCGTGA"	"Cyst.TAL_2"
"TTGCTGCTCAGCCCAG"	"Cyst.PT_1"
"TTGCTGCTCCTAACAG"	"vSMC"
"TTGGATGAGTTAACGA"	"Cyst.PT_1"
"TTGGATGCACAATCTG"	"Cyst.TAL_2"
"TTGGATGGTCGCAACC"	"Cyst.TAL_2"
"TTGGATGTCATAAGGA"	"Cyst.PC"
"TTGGATGTCCTGTTGC"	"Cyst.PT_1"
"TTGGGATAGACTAGAT"	"Cyst.PT_1"
"TTGGGATAGAGTTGTA"	"Cyst.TAL_2"
"TTGGGATAGGACGCTA"	"Podocytes"
"TTGGGATAGTGACCTT"	"Unk_2"
"TTGGGATCAAGATTGA"	":LowQual"
"TTGGGATGTAAGCAAT"	"Fibroblast"
"TTGGGATGTGCTGCAC"	"Cyst.PC"
"TTGGGCGCAGCATGCC"	"Cyst.IC-A1"
"TTGGGCGCATTGAAGA"	"Cyst.PT_2"
"TTGGGCGGTTCGGACC"	"Cyst.PT_2"
"TTGGGCGGTTGTCTAG"	"Cyst.PT_1"
"TTGGGTAAGAGTGTGC"	"Cyst.PT_2"
"TTGGGTAAGCTAGAGC"	"Cyst.PC"
"TTGGGTACAATAGAGT"	"Cyst.PT_1"
"TTGGGTACAGTTAGAA"	"Fibroblast"
"TTGGGTAGTACGGTTT"	"Podocytes"
"TTGGGTAGTAGCTGAG"	"Cyst.PT_1"
"TTGGGTAGTAGGTAGC"	"Cyst.PT_3"
"TTGGGTAGTCCTTTGC"	"Cyst.PC"
"TTGGGTAGTTCTCGTC"	"Cyst.PC"
"TTGGTTTAGTCCCGAC"	"Cyst.TAL_2"
"TTGGTTTCACCGGAAA"	"Cyst.TAL_2"
"TTGGTTTCATCAGTGT"	"Cyst.TAL_2"
"TTGGTTTGTGATCATC"	"Cyst.PT_3"
"TTGGTTTGTGCGGCTT"	"Cyst.PT_1"
"TTGGTTTTCAAGCCAT"	"Unk_1"
"TTGTGGAAGAAGGCTC"	"Podocytes"
"TTGTGGACAGAGAGGG"	"Cyst.PT_3"
"TTGTGGACATTATGCG"	"Cyst.PT_1"
"TTGTGTTCAAATAAGC"	"Cyst.PT_2"
"TTGTGTTCACAGAGAC"	"vSMC"
"TTGTGTTCACTGCTTC"	"Cyst.TAL_1"
"TTGTGTTGTTGATCGT"	"Cyst.TAL_1"
"TTGTGTTTCACACGAT"	"Cyst.TAL_1"
"TTGTGTTTCCGTGGGT"	":LowQual"
"TTGTTCAAGGTAAGTT"	"Unk_1"
"TTGTTCACAAGAATAC"	"Mac"
"TTGTTCATCAGCTAGT"	"Cyst.PT_2"
"TTGTTCATCTTAGGAC"	"Cyst.PT_3"
"TTGTTGTAGATGATTG"	"EC"
"TTGTTGTCATGAAGGC"	"Cyst.PT_1"
"TTGTTGTGTCACCGCA"	"Cyst.TAL_1"
"TTGTTTGCAACGTTAC"	"Cyst.TAL_2"
"TTGTTTGCAAGTGGAC"	"Cyst.PT_2"
"TTGTTTGCACGTCGGT"	"Cyst.PT_3"
"TTGTTTGCACTCCCTA"	"Cyst.TAL_2"
"TTGTTTGTCGCACGAC"	"Cyst.PT_1"
"TTGTTTGTCTCGAGTA"	"Cyst.PT_1"
"TTTACCAAGAAACTCA"	"Cyst.PC"
"TTTACCAAGAATCGTA"	"Cyst.TAL_1"
"TTTACCAAGATGCCGA"	"Cyst.PT_3"
"TTTACCAAGATGCTTC"	"Cyst.PT_1"
"TTTACCAAGCCTAGGA"	"Mac"
"TTTACCAAGCTCTGTA"	"EC"
"TTTACCATCAACTGAC"	"Cyst.PT_1"
"TTTACCATCCACTTTA"	"vSMC"
"TTTACCATCCTTATCA"	"Cyst.PC"
"TTTACGTCACGAGGAT"	"Cyst.PT_3"
"TTTACGTGTGCAAGAC"	"Cyst.PT_2"
"TTTACGTGTTGCTTGA"	"Cyst.TAL_1"
"TTTACGTTCAACCTCC"	"EC"
"TTTACTGAGCAATAGT"	"Cyst.TAL_2"
"TTTACTGAGGCGAAGG"	"Cyst.PT_2"
"TTTACTGCAAGAGGTC"	"Cyst.PT_2"
"TTTACTGGTCGTGCCA"	"Cyst.TAL_2"
"TTTACTGGTGCTGTCG"	"Cyst.PT_1"
"TTTACTGTCGTGGGAA"	"Cyst.PT_2"
"TTTAGTCAGGCTCAAG"	"Cyst.TAL_2"
"TTTAGTCCACACGCCA"	"Cyst.TAL_1"
"TTTAGTCCAGTTGCGC"	"Cyst.ATL"
"TTTAGTCGTCACTCAA"	"Cyst.PT_3"
"TTTAGTCGTCTTCGAA"	"Cyst.PT_2"
"TTTAGTCTCCATAAGC"	"Cyst.PC"
"TTTAGTCTCCCTCTAG"	"Cyst.PT_1"
"TTTAGTCTCGCCATAA"	"Cyst.TAL_2"
"TTTAGTCTCTGCCCTA"	"Cyst.ATL"
"TTTATGCAGCGGATCA"	"EC"
"TTTATGCAGTCACTAC"	"Cyst.TAL_1"
"TTTATGCCAATTGCAC"	"Unk_2"
"TTTATGCGTATAGGAT"	"vSMC"
"TTTATGCGTTGTGCAT"	"Cyst.PT_1"
"TTTATGCTCGAGCCAC"	"Cyst.PT_3"
"TTTCACACACACCGCA"	"Cyst.TAL_2"
"TTTCACACAGATCCTA"	"Cyst.PT_3"
"TTTCACAGTCGAAGCA"	"Cyst.PT_3"
"TTTCACATCCTGTAGA"	"Cyst.PT_2"
"TTTCACATCCTTTAGT"	"Fibroblast"
"TTTCAGTAGATCCTAC"	"Cyst.PT_2"
"TTTCAGTAGCAACTCT"	"T-cell"
"TTTCAGTAGGACGCTA"	"Cyst.PT_2"
"TTTCAGTGTAATTGGA"	"Cyst.PT_3"
"TTTCAGTGTATACCTG"	"Fibroblast"
"TTTCATGCAAGAAACT"	"Cyst.TAL_1"
"TTTCATGCAGAACTCT"	"Cyst.PT_2"
"TTTCATGCAGTCAACT"	"Cyst.PT_1"
"TTTCATGGTATGAAGT"	"Cyst.PT_3"
"TTTCATGGTCACAGTT"	"Cyst.PT_1"
"TTTCATGGTTCTTGCC"	"T-cell"
"TTTCATGGTTTGTTGG"	"Cyst.PT_3"
"TTTCCTCAGGTGCAGT"	"Cyst.TAL_2"
"TTTCCTCCAGCCATTA"	"Mac"
"TTTCCTCGTTGCGGAA"	"Fibroblast"
"TTTCCTCTCACTGGGC"	"Cyst.PT_2"
"TTTCCTCTCGCCGTGA"	"Cyst.TAL_1"
"TTTCGATAGTCAGGGT"	"Mac"
"TTTCGATGTCGAGTTT"	"Cyst.PT_3"
"TTTCGATTCAGTCATG"	"vSMC"
"TTTGACTAGAGTCGAC"	"Cyst.TAL_1"
"TTTGACTAGGAATCGC"	"EC"
"TTTGACTCATTCACCC"	"Cyst.PT_1"
"TTTGACTGTATGTCCA"	"vSMC"
"TTTGACTGTGACGCCT"	"vSMC"
"TTTGACTGTTGGACCC"	"Cyst.PT_3"
"TTTGATCCACCAGACC"	"Fibroblast"
"TTTGATCCAGCAATTC"	"T-cell"
"TTTGATCCAGGCAATG"	"Cyst.TAL_2"
"TTTGATCGTATACCTG"	"EC"
"TTTGATCGTGGGTTGA"	"Cyst.PC"
"TTTGATCGTTATGTCG"	"Cyst.PT_3"
"TTTGATCGTTCGGCCA"	"Cyst.PT_3"
"TTTGATCTCACTGGGC"	"EC"
"TTTGGAGAGATGGCAC"	"Mac"
"TTTGGAGCAGGACAGT"	"Cyst.PT_1"
"TTTGGAGCAGTCGTTA"	"Cyst.PT_2"
"TTTGGAGGTTCTGACA"	"Unk_2"
"TTTGGAGTCCCTTCCC"	"vSMC"
"TTTGGTTAGACTAAGT"	"Cyst.PT_1"
"TTTGGTTAGCGAATGC"	"Cyst.PT_1"
"TTTGGTTGTCATCTAG"	"Cyst.PT_1"
"TTTGGTTGTGGCACTC"	"vSMC"
"TTTGGTTTCGTAACAC"	"Cyst.PT_1"
"TTTGTTGAGACAGTCG"	"Cyst.PT_3"
"TTTGTTGAGCGAGGAG"	"Cyst.TAL_2"
"TTTGTTGCAGCGGTTC"	"Cyst.PT_1"
"TTTGTTGCATCCTCAC"	"Cyst.PT_1"
"TTTGTTGGTGTACAGG"	"Cyst.PT_2"
"TTTGTTGGTTAATCGC"	"Cyst.PT_1"
"TTTGTTGTCCGCACGA"	"Cyst.PT_3"
"TTTGTTGTCCTGCCAT"	"Cyst.PT_1"
"TTTGTTGTCTAGAGCT"	"Cyst.ATL"
"TTTGTTGTCTAGCCAA"	"Cyst.TAL_2"
