""	"Ident"
"AAACCCACAAGCCTGC"	"Cyst.LOH,TAL-cell"
"AAACCCACATAGTCAC"	"Cyst.LOH,TAL-cell"
"AAACCCATCAGCTAGT"	"PEC"
"AAACCCATCGTAATGC"	"Mono/Mac"
"AAACGAACAATTGCCA"	"T-cell"
"AAACGAACATGGGAAC"	"Mono/Mac"
"AAACGAATCACTGTCC"	"EC"
"AAACGCTAGCACCTGC"	"Cyst.LOH,TAL-cell"
"AAACGCTGTAGTTCCA"	"Mast-cell"
"AAACGCTGTTGCGAAG"	"PEC"
"AAACGCTTCGTCCTCA"	"Cyst.IC-A"
"AAAGAACAGGGAGGTG"	"Cyst.LOH,TAL-cell"
"AAAGAACGTCGGCACT"	"Mono/Mac"
"AAAGGATAGACTCGAG"	"T-cell"
"AAAGGATCATCTTTCA"	"Cyst.LOH,TAL-cell"
"AAAGGATGTCGGTAAG"	"CTL/NK-cell"
"AAAGGATTCCTACACC"	"PEC"
"AAAGGGCAGCGATGAC"	"EC"
"AAAGGGCAGCTCCATA"	"Cyst.LOH,TAL-cell"
"AAAGGGCAGCTCGTGC"	"VSMC"
"AAAGGGCAGGTAGACC"	"EC"
"AAAGGGCCACCAAAGG"	"Mac"
"AAAGGGCCAGGCTATT"	"VSMC"
"AAAGGGCCAGTTCTAG"	"Fibroblast"
"AAAGGGCTCGCTCATC"	"Mono/Mac"
"AAAGGTAAGAGGTGCT"	"T-cell"
"AAAGGTAAGTAGCAAT"	"Cyst.LOH,TAL-cell"
"AAAGGTACAATTGCGT"	"VSMC"
"AAAGGTACACGTGAGA"	"STC_1"
"AAAGTCCAGCGTGTTT"	"T-cell"
"AAAGTCCCAAGTGGAC"	"VSMC"
"AAAGTCCCACCGGTCA"	"Cyst.LOH,TAL-cell"
"AAAGTCCTCCAATGCA"	"PEC"
"AAAGTCCTCGCTTACC"	"CTL/NK-cell"
"AAAGTCCTCTTTGCTA"	"PEC"
"AAAGTGACAGATTCGT"	"Cyst.LOH,TAL-cell"
"AAAGTGAGTATCACCA"	"T-cell"
"AAATGGAAGCGTGCCT"	"VSMC"
"AAATGGACAACCGTGC"	"STC_1"
"AAATGGACAATCTCGA"	"Cyst.LOH,TAL-cell"
"AAATGGACACGGGCTT"	"Cyst.LOH,TAL-cell"
"AAATGGAGTAGCACAG"	"Mono/Mac"
"AACAAAGCATTGGATC"	"B-cell"
"AACAAAGTCCACGTCT"	"VSMC"
"AACAAAGTCCCTTTGG"	"Mono/Mac"
"AACAAAGTCGTTCTAT"	"Cyst.PT"
"AACAACCAGCTACGTT"	"PEC"
"AACAACCCAATCGCCG"	"T-cell"
"AACAACCCAATGGCAG"	"T-cell"
"AACAACCCATCGGAAG"	"Cyst.PT"
"AACAACCTCCATAGAC"	"Cyst.LOH,TAL-cell"
"AACAACCTCCGGCAAC"	"Cyst.LOH,TAL-cell"
"AACAAGACAGAAGCTG"	"VSMC"
"AACAAGACATGGAATA"	"Cyst.LOH,TAL-cell"
"AACAAGAGTACACTCA"	"STC_1"
"AACAAGATCATTTCCA"	"EC"
"AACAAGATCTTAGTTC"	"PEC"
"AACACACCATTCCTAT"	"PEC"
"AACACACGTCATAAAG"	"B-cell"
"AACACACGTTTGCAGT"	"PEC"
"AACACACTCCTCAGAA"	"Mono/Mac"
"AACACACTCTCGTCAC"	"STC_1"
"AACAGGGAGCCAAGTG"	"Cyst.PT"
"AACAGGGCAATTGTGC"	"Mast-cell"
"AACAGGGGTAGTGCGA"	"STC_1"
"AACAGGGTCATGTCAG"	"Cyst.IC-A"
"AACCAACCAATCTCTT"	"Mac"
"AACCAACCATAACGGG"	"T-cell"
"AACCAACGTATCAAGA"	"PEC"
"AACCAACTCAGACCTA"	"Mast-cell"
"AACCACACAACTCCAA"	"VSMC"
"AACCACAGTATCGTTG"	"PEC"
"AACCATGGTATCCTCC"	"Fibroblast"
"AACCATGGTCGAGTTT"	"Cyst.PT"
"AACCATGGTCTTTCAT"	"EC"
"AACCCAAGTAATGTGA"	"PEC"
"AACCCAATCCATCACC"	"EC"
"AACCCAATCGAAACAA"	"PEC"
"AACCCAATCGACACCG"	"STC_1"
"AACCTGAAGGTTGGTG"	"VSMC"
"AACCTGAAGTTTCGAC"	"VSMC"
"AACCTGACACAATTCG"	"Cyst.PT"
"AACCTGACACGCTTAA"	"EC"
"AACCTGACATCTATCT"	"PEC"
"AACCTGACATGGCGCT"	"Cyst.LOH,TAL-cell"
"AACCTTTCAAGAGATT"	"VSMC"
"AACCTTTGTTATGGTC"	"T-cell"
"AACCTTTTCAACTTTC"	"Cyst.PT"
"AACCTTTTCCCGATCT"	"PEC"
"AACCTTTTCGCAGTTA"	"STC_1"
"AACCTTTTCTCCCTAG"	"Mac"
"AACGAAAAGTCAGCCC"	"PEC"
"AACGAAACACGGCCAT"	"VSMC"
"AACGAAAGTATGAGGC"	"Mono/Mac"
"AACGAAATCTTCGGAA"	"PEC"
"AACGGGACACATTGTG"	"CTL/NK-cell"
"AACGGGACAGCGTGCT"	"Mono/Mac"
"AACGGGAGTGCATGTT"	"PEC"
"AACGTCAAGTGTGTTC"	"Cyst.LOH,TAL-cell"
"AACGTCACAATCCTTT"	"Mono/Mac"
"AACGTCAGTGGCCTCA"	"T-cell"
"AACGTCAGTTCTCTAT"	"Cyst.PT"
"AACGTCATCGGTTCAA"	"Mac"
"AACTTCTCACACCGAC"	"Cyst.IC-A"
"AACTTCTGTGTCATTG"	"Cyst.PT"
"AAGAACAAGGTACCTT"	"PEC"
"AAGAACACACGCTGTG"	"B-cell"
"AAGAACATCATTACTC"	"Fibroblast"
"AAGAACATCGTTCGCT"	"Mac"
"AAGACAATCGTGCATA"	"EC"
"AAGACTCAGACATGCG"	"Cyst.PT"
"AAGACTCAGTGCAACG"	"T-cell"
"AAGACTCCAATTGCAC"	"STC_1"
"AAGACTCGTCACTCTC"	"Mac"
"AAGACTCGTTGCCTAA"	"Cyst.LOH,TAL-cell"
"AAGACTCTCGGTAACT"	"VSMC"
"AAGACTCTCTACGGTA"	"Mast-cell"
"AAGATAGAGTGGCGAT"	"T-cell"
"AAGATAGCACGTGTGC"	"PEC"
"AAGATAGCATACAGAA"	"T-cell"
"AAGATAGCATCTTAGG"	"STC_1"
"AAGCATCAGCACCGTC"	"VSMC"
"AAGCATCAGGGTCACA"	"PEC"
"AAGCATCAGTCCCAGC"	"Cyst.LOH,TAL-cell"
"AAGCATCCATGATAGA"	"PEC"
"AAGCATCGTAAGCAAT"	"STC_1"
"AAGCATCGTGGTAATA"	"Mac"
"AAGCCATAGCGCCTCA"	"PEC"
"AAGCCATCACGCTATA"	"Cyst.LOH,TAL-cell"
"AAGCCATGTCGACTTA"	"PEC"
"AAGCGAGAGCCGAATG"	"T-cell"
"AAGCGAGAGCGTCTCG"	"Fibroblast"
"AAGCGAGAGGATCATA"	"Cyst.PT"
"AAGCGAGCAATGGGTG"	"CTL/NK-cell"
"AAGCGAGTCATAGCAC"	"Cyst.LOH,TAL-cell"
"AAGCGAGTCGATACTG"	"Mono/Mac"
"AAGCGTTGTCATATGC"	"STC_1"
"AAGCGTTGTGTCGCTG"	"Mast-cell"
"AAGCGTTTCTCTGAGA"	"Mac"
"AAGGAATCATAAGCAA"	"T-cell"
"AAGGAATGTGTGTACT"	"CTL/NK-cell"
"AAGGAATTCTGATTCT"	"T-cell"
"AAGGTAAAGGTATAGT"	"Mono/Mac"
"AAGGTAACACTCCTTG"	"VSMC"
"AAGGTAAGTATCGCGC"	"T-cell"
"AAGTACCCAAGTGATA"	"Mac"
"AAGTACCCACAGTGAG"	"Cyst.PT"
"AAGTACCCATCCAATG"	"Mac"
"AAGTACCGTTCAGCGC"	"PEC"
"AAGTACCTCCAAGCCG"	"T-cell"
"AAGTCGTAGAGGTTAT"	"CTL/NK-cell"
"AAGTCGTAGGGCCCTT"	"CTL/NK-cell"
"AAGTCGTTCGGTAAGG"	"Fibroblast"
"AAGTGAAAGCCTCTCT"	"STC_1"
"AAGTGAACACGGTGAA"	"Mac"
"AAGTGAACACTCACTC"	"PEC"
"AAGTGAACAGCAGTCC"	"STC_1"
"AAGTGAAGTGTTAGCT"	"Cyst.PT"
"AAGTGAATCACCTCAC"	"Cyst.LOH,TAL-cell"
"AAGTGAATCGCCGTGA"	"T-cell"
"AAGTTCGAGATGTAGT"	"VSMC"
"AAGTTCGGTAACGGTG"	"Cyst.LOH,TAL-cell"
"AAGTTCGTCAATCCAG"	"Mac"
"AATAGAGCAACGACAG"	"Cyst.LOH,TAL-cell"
"AATAGAGCAGGCATTT"	"Cyst.PT"
"AATAGAGGTATCCCAA"	"STC_1"
"AATAGAGTCATGGGAG"	"Mast-cell"
"AATAGAGTCTAAGAAG"	"PEC"
"AATAGAGTCTCGCGTT"	"Mac"
"AATCACGAGGGATCAC"	"PEC"
"AATCACGAGTAGTCAA"	"Cyst.PT"
"AATCACGCAACGATTC"	"Mono/Mac"
"AATCACGCAGCAGATG"	"Cyst.LOH,TAL-cell"
"AATCACGCATTATGCG"	"PEC"
"AATCGACTCCGAACGC"	"T-cell"
"AATCGACTCCGTGGTG"	"STC_1"
"AATCGACTCCTAGAGT"	"VSMC"
"AATCGACTCGCTCTCA"	"CTL/NK-cell"
"AATCGTGCACTGCGTG"	"Mono/Mac"
"AATCGTGGTCGCTTAA"	"STC_1"
"AATCGTGGTTAACCTG"	"Cyst.PT"
"AATCGTGTCGGTTGTA"	"T-cell"
"AATCGTGTCGTCAACA"	"Cyst.LOH,TAL-cell"
"AATGAAGGTAGCCAGA"	"Cyst.LOH,TAL-cell"
"AATGAAGTCATCGCCT"	"Cyst.PT"
"AATGAAGTCGCGTGCA"	"PEC"
"AATGAAGTCTTTCCAA"	"CTL/NK-cell"
"AATGACCAGTAACGAT"	"T-cell"
"AATGACCGTTAAACAG"	"VSMC"
"AATGACCGTTGGGATG"	"Cyst.LOH,TAL-cell"
"AATGCCAAGATCGCCC"	"Cyst.LOH,TAL-cell"
"AATGCCACAATGTCTG"	"Cyst.LOH,TAL-cell"
"AATGCCATCAGACCCG"	"Cyst.PT"
"AATGGAACAGTAGAAT"	"VSMC"
"AATGGAATCCATCACC"	"PEC"
"AATGGCTCAAGAGTTA"	"Mac"
"AATGGCTCAAGGGCAT"	"EC"
"AATTCCTAGTGCCGAA"	"Cyst.LOH,TAL-cell"
"AATTCCTGTCGGCACT"	"Cyst.LOH,TAL-cell"
"ACAAAGAAGAGGTGCT"	"Cyst.LOH,TAL-cell"
"ACAAAGAAGTAAACTG"	"Mac"
"ACAAAGATCCGAACGC"	"Cyst.LOH,TAL-cell"
"ACAACCACAGAGTCTT"	"T-cell"
"ACAACCAGTGTCCAAT"	"Mono/Mac"
"ACAACCAGTTCTCGTC"	"T-cell"
"ACAACCATCCATGATG"	"Mono/Mac"
"ACAACCATCTTGCAGA"	"EC"
"ACAAGCTAGACGCATG"	"B-cell"
"ACACAGTCATCGAAGG"	"CTL/NK-cell"
"ACACAGTGTACGATGG"	"Cyst.LOH,TAL-cell"
"ACACAGTGTCATTGCA"	"Cyst.LOH,TAL-cell"
"ACACAGTGTTCGTACA"	"Cyst.LOH,TAL-cell"
"ACACAGTTCGTGAGAG"	"STC_2"
"ACACAGTTCTTACCGC"	"CTL/NK-cell"
"ACACCAAAGCCTTTGA"	"T-cell"
"ACACCAAAGGTTGAGC"	"T-cell"
"ACACCAATCATTACTC"	"PEC"
"ACACCAATCGTGTGGC"	"STC_1"
"ACACGCGCACCAGCTG"	"EC"
"ACACGCGCAGGCATTT"	"STC_1"
"ACACGCGGTACGCTTA"	"CTL/NK-cell"
"ACACTGAAGCAAGGAA"	"VSMC"
"ACACTGAAGCTGGCCT"	"PEC"
"ACACTGAAGTGATTCC"	"VSMC"
"ACACTGATCAAGGACG"	"EC"
"ACACTGATCCCTTGTG"	"STC_1"
"ACAGAAAAGCAGTACG"	"CTL/NK-cell"
"ACAGAAAAGCAGTCTT"	"CTL/NK-cell"
"ACAGAAAGTATCTCTT"	"STC_1"
"ACAGCCGAGGGTAATT"	"Mono/Mac"
"ACAGCCGCAACGTATC"	"PEC"
"ACAGCCGCATGGGTTT"	"CTL/NK-cell"
"ACAGCCGGTAAGGCTG"	"Cyst.LOH,TAL-cell"
"ACAGCCGTCACATACG"	"PEC"
"ACAGCCGTCTTACTGT"	"PEC"
"ACAGGGAAGATTGTGA"	"T-cell"
"ACAGGGACAAAGGTTA"	"T-cell"
"ACAGGGACATACGCAT"	"T-cell"
"ACATCCCAGAATCGCG"	"STC_2"
"ACATCCCCATAGAATG"	"PEC"
"ACATCGAAGCACACAG"	"Cyst.LOH,TAL-cell"
"ACATCGAGTGATACTC"	"VSMC"
"ACATCGATCTACTTCA"	"Cyst.LOH,TAL-cell"
"ACATGCACACAAACGG"	"PEC"
"ACATGCACAGATTAAG"	"B-cell"
"ACATGCACATTGCTGA"	"B-cell"
"ACATGCAGTACCTATG"	"Mac"
"ACATGCAGTTAGGGAC"	"Mac"
"ACATGCAGTTTACGAC"	"Cyst.LOH,TAL-cell"
"ACATGCATCTACTTCA"	"Cyst.PT"
"ACATTTCGTCGCGGTT"	"VSMC"
"ACATTTCGTTAACAGA"	"Mono/Mac"
"ACATTTCGTTTCGCTC"	"T-cell"
"ACATTTCTCAAGAAAC"	"T-cell"
"ACATTTCTCAGCGTCG"	"STC_1"
"ACATTTCTCGCGATCG"	"VSMC"
"ACCAAACAGGTTAAAC"	"VSMC"
"ACCAAACAGTGGAAGA"	"T-cell"
"ACCAAACCAAACGGCA"	"PEC"
"ACCAACAAGACAGCGT"	"PEC"
"ACCAACAAGAGAGAAC"	"T-cell"
"ACCAACAAGCGGGTTA"	"PEC"
"ACCAACAAGGAGTATT"	"PEC"
"ACCAACAGTTAACAGA"	"STC_1"
"ACCAACATCCAACTGA"	"VSMC"
"ACCAACATCCACAGCG"	"T-cell"
"ACCACAACACCGTGGT"	"Cyst.PT"
"ACCACAAGTATTGACC"	"STC_1"
"ACCACAATCAGTGCGC"	"B-cell"
"ACCACAATCTTCGCTG"	"T-cell"
"ACCACAATCTTCTGGC"	"T-cell"
"ACCATTTCACGAAGAC"	"Cyst.PT"
"ACCATTTCAGGCTACC"	"Cyst.LOH,TAL-cell"
"ACCATTTGTACCGTGC"	"T-cell"
"ACCATTTGTAGGGAGG"	"Cyst.LOH,TAL-cell"
"ACCATTTGTCCAAATC"	"Mac"
"ACCATTTGTTGTGCCG"	"T-cell"
"ACCATTTTCGCCGTGA"	"Cyst.PT"
"ACCCAAATCTAAGAAG"	"Mac"
"ACCCTCACAAGCCATT"	"Mac"
"ACCCTCACACTCTAGA"	"Cyst.PT"
"ACCCTCACAGGCCTGT"	"VSMC"
"ACCCTCAGTACGAAAT"	"Cyst.PT"
"ACCCTCAGTATTGAGA"	"T-cell"
"ACCCTCAGTCCGAAAG"	"Cyst.PT"
"ACCCTCATCGGTTGTA"	"T-cell"
"ACCCTCATCTACTCAT"	"PEC"
"ACCCTTGAGTGTGTTC"	"Mono/Mac"
"ACCCTTGCAGAGATTA"	"Cyst.LOH,TAL-cell"
"ACCCTTGGTTCTGACA"	"Cyst.LOH,TAL-cell"
"ACCCTTGTCTAGCCTC"	"STC_1"
"ACCGTTCCACATTGTG"	"Mono/Mac"
"ACCGTTCGTGGTCTGC"	"Fibroblast"
"ACCGTTCTCATTACGG"	"Cyst.LOH,TAL-cell"
"ACCTACCAGCTAAGTA"	"STC_1"
"ACCTACCCATGCAGCC"	"CTL/NK-cell"
"ACCTACCGTGCCCGTA"	"T-cell"
"ACCTACCGTGCCCTTT"	"PEC"
"ACCTACCGTTCCACAA"	"STC_1"
"ACCTACCTCGGACCAC"	"Cyst.PT"
"ACCTACCTCTGCGGGT"	"Mono/Mac"
"ACCTGAATCTAGGAAA"	"T-cell"
"ACCTGAATCTGTCGCT"	"STC_1"
"ACCTGTCAGTAGACAT"	"STC_1"
"ACCTGTCAGTAGGATT"	"VSMC"
"ACCTGTCCACACACGC"	"Cyst.LOH,TAL-cell"
"ACCTGTCCATTAAAGG"	"B-cell"
"ACCTGTCGTTCTCAGA"	"T-cell"
"ACGATCACACTGTCGG"	"Cyst.LOH,TAL-cell"
"ACGATCACAGACACCC"	"PEC"
"ACGATCAGTGCAATGG"	"T-cell"
"ACGATCAGTGGTAATA"	"Cyst.PT"
"ACGATGTAGGCACGAT"	"Mono/Mac"
"ACGATGTAGGTACAGC"	"Cyst.LOH,TAL-cell"
"ACGATGTTCGAGTGGA"	"Mono/Mac"
"ACGCACGAGGTGGTTG"	"Mac"
"ACGCACGGTACCGGCT"	"STC_1"
"ACGGAAGAGGCATTTC"	"Mac"
"ACGGAAGAGTAGGATT"	"EC"
"ACGGAAGCATAGAGGC"	"Cyst.LOH,TAL-cell"
"ACGGAAGGTCTCCCTA"	"STC_1"
"ACGGAAGGTCTTGAAC"	"Mac"
"ACGGAAGGTGGTAACG"	"Mono/Mac"
"ACGGAAGTCGATTTCT"	"Cyst.PT"
"ACGGGTCAGGTGCTTT"	"STC_2"
"ACGGGTCAGGTTAGTA"	"VSMC"
"ACGGGTCAGTCAGCCC"	"Mac"
"ACGGGTCCAGCAAGAC"	"Cyst.PT"
"ACGGGTCCATAGAAAC"	"Fibroblast"
"ACGGGTCGTCTACACA"	"Mono/Mac"
"ACGGGTCGTTCCGGTG"	"Mac"
"ACGGGTCTCAATGCAC"	"T-cell"
"ACGGGTCTCACTGGGC"	"Mono/Mac"
"ACGGGTCTCTCCGCAT"	"PEC"
"ACGGTCGAGCCAAGCA"	"Mac"
"ACGGTCGCACTGGAAG"	"EC"
"ACGGTCGGTATCGAGG"	"Mono/Mac"
"ACGGTCGGTCTCAGGC"	"Mono/Mac"
"ACGGTCGTCAGCTAGT"	"Mono/Mac"
"ACGGTCGTCCATCGTC"	"Cyst.PT"
"ACGGTCGTCGTAGCCG"	"Cyst.PT"
"ACGGTCGTCTGCATAG"	"Mac"
"ACGGTTAAGATGCAGC"	"T-cell"
"ACGGTTACAAAGGCAC"	"T-cell"
"ACGGTTAGTTGATCGT"	"Mono/Mac"
"ACGGTTATCTGTGCGG"	"VSMC"
"ACGTAACGTCGGCACT"	"PEC"
"ACGTAACGTGGCTTAT"	"STC_2"
"ACGTAACTCAAGCGTT"	"T-cell"
"ACGTAACTCGTGGTAT"	"STC_1"
"ACGTACAAGTCGTTAC"	"T-cell"
"ACGTAGTAGATTAGAC"	"Mac"
"ACGTAGTAGCGTTGTT"	"T-cell"
"ACGTAGTCATCTAGAC"	"Cyst.IC-A"
"ACGTAGTGTCTACATG"	"T-cell"
"ACGTAGTGTTATGTGC"	"T-cell"
"ACGTAGTTCGCGTAGC"	"Mac"
"ACGTCCTAGAGCAAGA"	"Cyst.PT"
"ACGTCCTAGTTGAAGT"	"Mac"
"ACGTCCTCATCCGTTC"	"EC"
"ACGTCCTGTCTACAGT"	"T-cell"
"ACGTCCTTCAAACGTC"	"Cyst.LOH,TAL-cell"
"ACGTTCCCAATCTCGA"	"Cyst.PT"
"ACGTTCCCAATGAAAC"	"Cyst.PT"
"ACGTTCCGTCAGGTAG"	"CTL/NK-cell"
"ACGTTCCGTCTGATAC"	"Cyst.PT"
"ACGTTCCTCACGTCCT"	"T-cell"
"ACGTTCCTCGGCGATC"	"Cyst.LOH,TAL-cell"
"ACGTTCCTCTCGCCTA"	"Mac"
"ACTACGACATGGTACT"	"Mono/Mac"
"ACTACGAGTGTTAACC"	"Mac"
"ACTACGATCCACGTCT"	"EC"
"ACTATCTAGCACCGTC"	"STC_1"
"ACTATCTCAACAGTGG"	"Mac"
"ACTATCTGTACTGAGG"	"Cyst.PT"
"ACTATCTGTCTAACTG"	"CTL/NK-cell"
"ACTATCTTCACCTTGC"	"T-cell"
"ACTATGGAGGGAGGGT"	"PEC"
"ACTATGGGTAGTGGCA"	"VSMC"
"ACTATGGGTATCGAGG"	"T-cell"
"ACTATGGGTTCATCTT"	"Mac"
"ACTATGGTCATCACAG"	"VSMC"
"ACTATTCAGTTGGCTT"	"Cyst.PT"
"ACTATTCGTAGCTCGC"	"T-cell"
"ACTATTCTCCGATCGG"	"VSMC"
"ACTCCCACAACTGCCG"	"VSMC"
"ACTCCCACACTAGGCC"	"Mast-cell"
"ACTCCCAGTAAGATTG"	"PEC"
"ACTCCCAGTAGCTAAA"	"Cyst.LOH,TAL-cell"
"ACTCCCAGTCTGTAGT"	"Cyst.LOH,TAL-cell"
"ACTCCCATCCTCAGAA"	"Cyst.PT"
"ACTCTCGAGCCTGGAA"	"Cyst.PT"
"ACTGATGCACCGCTAG"	"STC_1"
"ACTGATGTCTGACAGT"	"Cyst.LOH,TAL-cell"
"ACTGCAACAACGTATC"	"Mono/Mac"
"ACTGCAACAACTCATG"	"Cyst.PT"
"ACTGCAAGTAGGAGTC"	"EC"
"ACTGCAAGTGGTAATA"	"T-cell"
"ACTGTCCAGTAAGGGA"	"Mac"
"ACTGTCCCAAAGGATT"	"Mono/Mac"
"ACTGTCCCATCTGCGG"	"STC_2"
"ACTGTCCTCCGCACGA"	"T-cell"
"ACTGTCCTCGCTTGAA"	"T-cell"
"ACTGTGAAGACACACG"	"T-cell"
"ACTGTGAAGTGCAAAT"	"PEC"
"ACTGTGAGTAGAAACT"	"T-cell"
"ACTGTGAGTGATGTAA"	"Mono/Mac"
"ACTTAGGAGACCTGGA"	"Mono/Mac"
"ACTTAGGGTATGGAAT"	"Mono/Mac"
"ACTTAGGGTCATCACA"	"T-cell"
"ACTTAGGGTCGAGCTC"	"Mac"
"ACTTATCCATCCTATT"	"STC_1"
"ACTTATCGTAGTCACT"	"VSMC"
"ACTTCCGAGATCCCAT"	"PEC"
"ACTTCCGAGGTAGACC"	"T-cell"
"ACTTCCGCAATCTGCA"	"PEC"
"ACTTCCGCAGATTTCG"	"STC_1"
"ACTTCCGGTAGTCGTT"	"Mono/Mac"
"ACTTCCGGTGCCTACG"	"STC_1"
"ACTTCCGTCTCGCGTT"	"STC_1"
"ACTTCGCAGTGGTGGT"	"STC_1"
"ACTTTCAAGGTTCACT"	"Cyst.LOH,TAL-cell"
"ACTTTCAGTAGTTACC"	"STC_1"
"ACTTTCATCAGACCGC"	"PEC"
"ACTTTCATCTTACCGC"	"Mast-cell"
"ACTTTGTAGCCGTCGT"	"Cyst.LOH,TAL-cell"
"ACTTTGTCACGTATAC"	"T-cell"
"ACTTTGTCATTCTCCG"	"EC"
"ACTTTGTGTGCATACT"	"T-cell"
"ACTTTGTGTTTCGCTC"	"Cyst.LOH,TAL-cell"
"AGAAATGAGGTCTACT"	"PEC"
"AGAAATGCATAACAGA"	"Cyst.LOH,TAL-cell"
"AGAAATGGTCGAGTGA"	"EC"
"AGAAATGTCGCAGTTA"	"Mac"
"AGAAATGTCGTTGCCT"	"Cyst.PT"
"AGAAATGTCTCACGAA"	"T-cell"
"AGAACCTAGACCAAGC"	"VSMC"
"AGAACCTAGATGGCGT"	"Cyst.LOH,TAL-cell"
"AGAACCTAGCCGTCGT"	"Cyst.PT"
"AGAACCTCACTTTATC"	"VSMC"
"AGAACCTGTTAAGAAC"	"Fibroblast"
"AGAACCTTCGAAGAAT"	"Mono/Mac"
"AGAAGCGAGCTGGCTC"	"Cyst.PT"
"AGAAGCGGTATGCTAC"	"VSMC"
"AGAAGCGGTTGGAGAC"	"Mac"
"AGAAGCGTCCACTTTA"	"STC_1"
"AGAAGCGTCGCCAATA"	"STC_1"
"AGAAGTAAGTTCCGTA"	"CTL/NK-cell"
"AGAAGTACAAAGGCGT"	"Cyst.IC-A"
"AGAAGTAGTCTAGTGT"	"T-cell"
"AGAAGTATCGTAGGAG"	"STC_1"
"AGACAAACAACAACAA"	"Cyst.LOH,TAL-cell"
"AGACAAACAGAGGCAT"	"Mono/Mac"
"AGACAAATCAGCAATC"	"STC_1"
"AGACAAATCCGTCAAA"	"Cyst.LOH,TAL-cell"
"AGACAAATCTCTTAAC"	"T-cell"
"AGACACTAGATAGGGA"	"T-cell"
"AGACACTCACACACTA"	"T-cell"
"AGACACTTCAAAGCCT"	"T-cell"
"AGACACTTCCTGGTCT"	"Cyst.LOH,TAL-cell"
"AGACAGGAGCCATTCA"	"STC_1"
"AGACAGGAGCGTATGG"	"STC_1"
"AGACAGGTCGCTATTT"	"T-cell"
"AGACCATAGGATCACG"	"B-cell"
"AGACCATGTGCTGTCG"	"Cyst.LOH,TAL-cell"
"AGACCATGTTCTCTCG"	"EC"
"AGACCATTCGTCAGAT"	"T-cell"
"AGACCATTCGTGGGAA"	"Cyst.LOH,TAL-cell"
"AGACCCGAGACCATTC"	"EC"
"AGACCCGCAAGCGATG"	"Cyst.LOH,TAL-cell"
"AGACCCGCAAGTGGAC"	"T-cell"
"AGACCCGGTACAGCGA"	"Mac"
"AGACCCGGTGTCCAAT"	"VSMC"
"AGACCCGTCAGCGGAA"	"CTL/NK-cell"
"AGACCCGTCCTCTAAT"	"Cyst.PT"
"AGACTCAAGACCGCCT"	"B-cell"
"AGACTCAGTAGCTGAG"	"Cyst.PT"
"AGACTCAGTATTTCCT"	"STC_1"
"AGACTCAGTTGCATAC"	"T-cell"
"AGACTCATCCTTCGAC"	"STC_1"
"AGAGAATGTAGAGCTG"	"T-cell"
"AGAGAATTCCAAGAGG"	"Cyst.PT"
"AGAGAGCCATGTACGT"	"Cyst.PT"
"AGAGAGCGTCAGATTC"	"Fibroblast"
"AGAGCAGAGAACGCGT"	"Mono/Mac"
"AGAGCAGCACCTGAAT"	"VSMC"
"AGAGCAGCAGACCAGA"	"Cyst.LOH,TAL-cell"
"AGAGCAGGTGACTGAG"	"Cyst.PT"
"AGAGCAGGTTGCAAGG"	"VSMC"
"AGAGCCCCAACTTCTT"	"Mono/Mac"
"AGAGCCCCAGCTGAAG"	"STC_1"
"AGAGCCCTCTCTATGT"	"Cyst.PT"
"AGATAGAAGACTCTTG"	"T-cell"
"AGATAGACACGAAGAC"	"EC"
"AGATAGACACGCGTCA"	"Cyst.PT"
"AGATAGATCGGCTTGG"	"VSMC"
"AGATAGATCTTTGATC"	"CTL/NK-cell"
"AGATCCACATAGCACT"	"T-cell"
"AGATCCACATATCTCT"	"STC_1"
"AGATCCAGTCCGGACT"	"STC_1"
"AGATCCAGTCGATTCA"	"Mac"
"AGATCCAGTCTCACGG"	"CTL/NK-cell"
"AGATCCATCCAGCAAT"	"Cyst.PT"
"AGATCGTAGAGCAGAA"	"STC_1"
"AGATCGTCAGAGTCTT"	"PEC"
"AGATCGTCAGCTGTAT"	"Mac"
"AGATCGTTCCACGGAC"	"Mac"
"AGATCGTTCTCTCTTC"	"T-cell"
"AGATGAACAGATACTC"	"Cyst.PT"
"AGATGAAGTGGCAACA"	"PEC"
"AGATGCTAGTATAGAC"	"PEC"
"AGATGCTCAAGATTGA"	"Cyst.LOH,TAL-cell"
"AGATGCTCACGGATCC"	"Cyst.LOH,TAL-cell"
"AGATGCTCATTGAAAG"	"Mono/Mac"
"AGCATCAAGAGTAACT"	"STC_1"
"AGCATCACACGTCGTG"	"Mono/Mac"
"AGCATCACACTAGTAC"	"T-cell"
"AGCATCATCGGCATAT"	"Mono/Mac"
"AGCCAATCAGATAAAC"	"Cyst.LOH,TAL-cell"
"AGCCAATGTGATGTAA"	"Mac"
"AGCCACGCACAAATCC"	"STC_1"
"AGCCACGCAGAGTGTG"	"Mono/Mac"
"AGCCACGCAGCTGAGA"	"STC_1"
"AGCCACGGTGAACTAA"	"EC"
"AGCCACGGTGGAGAAA"	"Cyst.LOH,TAL-cell"
"AGCCACGGTTATCTTC"	"Cyst.LOH,TAL-cell"
"AGCCAGCAGCAGGGAG"	"STC_1"
"AGCCAGCCACATACTG"	"T-cell"
"AGCCAGCGTGATTCAC"	"Mac"
"AGCCAGCTCCACGGAC"	"T-cell"
"AGCCAGCTCGTCGATA"	"T-cell"
"AGCGATTAGACTTCAC"	"T-cell"
"AGCGATTGTCATCGCG"	"T-cell"
"AGCGATTTCCAGCAAT"	"T-cell"
"AGCGATTTCTACCTTA"	"T-cell"
"AGCGCCATCTTACGTT"	"Mono/Mac"
"AGCGCTGCAGGCATGA"	"Mast-cell"
"AGCGCTGGTTCAGTAC"	"VSMC"
"AGCGCTGTCTGTGTGA"	"Cyst.LOH,TAL-cell"
"AGCGTATCATGGCTGC"	"STC_1"
"AGCGTATTCCGACAGC"	"Mono/Mac"
"AGCGTCGGTTGTCATG"	"STC_1"
"AGCTACAAGGACGGAG"	"CTL/NK-cell"
"AGCTACACAAATGCTC"	"T-cell"
"AGCTACAGTTGCAAGG"	"VSMC"
"AGCTCAATCCCATAAG"	"CTL/NK-cell"
"AGCTTCCGTACCCACG"	"Mac"
"AGCTTCCGTTGCATGT"	"VSMC"
"AGCTTCCTCGCTCTCA"	"VSMC"
"AGGAAATAGGGTCAAC"	"B-cell"
"AGGAAATCACCGCTAG"	"T-cell"
"AGGAAATCATCGTTCC"	"T-cell"
"AGGAAATGTGCTCTCT"	"T-cell"
"AGGAAATTCAACGTGT"	"Cyst.PT"
"AGGAATACAGTTAAAG"	"Cyst.LOH,TAL-cell"
"AGGAATAGTTGCCGAC"	"Mac"
"AGGACGACAAACTAAG"	"EC"
"AGGACGACACTGAATC"	"Cyst.PT"
"AGGACGACAGCACAAG"	"Cyst.LOH,TAL-cell"
"AGGACTTAGGTAATCA"	"Mac"
"AGGACTTAGGTCACTT"	"Cyst.PT"
"AGGACTTCATGCCATA"	"Cyst.PT"
"AGGACTTGTAACAAGT"	"EC"
"AGGACTTGTTGTGCCG"	"Cyst.IC-A"
"AGGAGGTAGACGCTCC"	"Mono/Mac"
"AGGAGGTAGTAGGATT"	"Cyst.LOH,TAL-cell"
"AGGAGGTCATGGGTCC"	"VSMC"
"AGGATAAAGCAAGGAA"	"T-cell"
"AGGATAACAGTTGTCA"	"VSMC"
"AGGATAATCAGCTAGT"	"Mono/Mac"
"AGGATCTCAGGTCAAG"	"STC_1"
"AGGATCTGTACTAGCT"	"Cyst.LOH,TAL-cell"
"AGGATCTTCGAAGTGG"	"VSMC"
"AGGCATTCAACCAACT"	"Mast-cell"
"AGGCATTTCGTAGGGA"	"Cyst.LOH,TAL-cell"
"AGGCCACCACATACTG"	"T-cell"
"AGGCCACCATGCCGCA"	"Cyst.LOH,TAL-cell"
"AGGCCACGTACTAACC"	"Mono/Mac"
"AGGCCACGTTACGCCG"	"Mac"
"AGGCCACTCGTGACTA"	"STC_1"
"AGGCCACTCTCCAATT"	"T-cell"
"AGGCTGCTCCAAGCCG"	"STC_1"
"AGGCTGCTCCGATAGT"	"T-cell"
"AGGGAGTAGGAACGTC"	"VSMC"
"AGGGAGTAGTTTCGAC"	"Mono/Mac"
"AGGGAGTCAAGGCCTC"	"T-cell"
"AGGGAGTCAGTCAGCC"	"T-cell"
"AGGGAGTCATGACTCA"	"Cyst.LOH,TAL-cell"
"AGGGAGTGTGGCGCTT"	"Mono/Mac"
"AGGGAGTTCCACTGAA"	"Mono/Mac"
"AGGGCCTAGTCCCGGT"	"CTL/NK-cell"
"AGGGCCTCAATGTCAC"	"T-cell"
"AGGGCTCAGACCATAA"	"STC_1"
"AGGGCTCCATGTGGTT"	"VSMC"
"AGGGTCCCAATACCTG"	"CTL/NK-cell"
"AGGGTCCCACCAGCGT"	"STC_1"
"AGGGTCCCACGGTGCT"	"EC"
"AGGGTCCGTGTTCCTC"	"PEC"
"AGGGTGAAGGGCAGAG"	"VSMC"
"AGGGTGACAATAGAGT"	"Mac"
"AGGGTGACACATTGTG"	"PEC"
"AGGGTTTAGGCTCCCA"	"EC"
"AGGGTTTCAAACTCTG"	"VSMC"
"AGGGTTTGTTAACCTG"	"Cyst.PT"
"AGGGTTTTCGTGGGAA"	"Cyst.PT"
"AGGGTTTTCTCAGAAC"	"Cyst.PT"
"AGGGTTTTCTTGCGCT"	"PEC"
"AGGTAGGAGCCTCAGC"	"VSMC"
"AGGTAGGAGTTGTAAG"	"T-cell"
"AGGTAGGTCCACGGGT"	"T-cell"
"AGGTAGGTCTTCCGTG"	"PEC"
"AGGTCATAGATGAAGG"	"PEC"
"AGGTCATAGTTGTAGA"	"Cyst.PT"
"AGGTCATCATAATGCC"	"Cyst.LOH,TAL-cell"
"AGGTCATGTAGCTGAG"	"CTL/NK-cell"
"AGGTCATTCGCCGATG"	"Cyst.LOH,TAL-cell"
"AGGTCTAAGCACTCAT"	"T-cell"
"AGGTCTAAGCCGGATA"	"EC"
"AGGTCTAAGTCTCTGA"	"EC"
"AGGTCTACAAATCGGG"	"STC_1"
"AGGTCTACAGGCACTC"	"VSMC"
"AGGTGTTCAGACGGAT"	"Cyst.LOH,TAL-cell"
"AGGTGTTCAGGTGAGT"	"Cyst.LOH,TAL-cell"
"AGGTGTTGTGGCTCTG"	"VSMC"
"AGGTGTTTCCGAGAAG"	"PEC"
"AGGTTACAGGTAAGAG"	"T-cell"
"AGGTTACGTCATTGCA"	"Cyst.LOH,TAL-cell"
"AGGTTACGTCGTGATT"	"Cyst.IC-A"
"AGGTTACTCGCCGAAC"	"Mono/Mac"
"AGGTTGTAGTGAGGTC"	"T-cell"
"AGGTTGTCAATCTCTT"	"Fibroblast"
"AGGTTGTCACGCCACA"	"B-cell"
"AGGTTGTCATTGTCGA"	"Mac"
"AGGTTGTGTACGGTTT"	"VSMC"
"AGGTTGTGTCACATTG"	"T-cell"
"AGTAACCAGATGTTAG"	"CTL/NK-cell"
"AGTAACCAGCAGTACG"	"T-cell"
"AGTAACCCAAGGCCTC"	"Fibroblast"
"AGTAACCTCCCGAATA"	"CTL/NK-cell"
"AGTACCAAGATTGTGA"	"VSMC"
"AGTACCACACTGGCGT"	"PEC"
"AGTACCAGTCCTGTCT"	"CTL/NK-cell"
"AGTACCATCAAGCTGT"	"Cyst.PT"
"AGTACCATCTGCTGAA"	"STC_1"
"AGTACCATCTTCGGAA"	"T-cell"
"AGTACTGGTCGAGTTT"	"Mac"
"AGTAGCTGTAACATAG"	"T-cell"
"AGTAGCTGTAGTGGCA"	"STC_1"
"AGTAGCTGTATCGTGT"	"Cyst.LOH,TAL-cell"
"AGTAGCTGTTTACACG"	"T-cell"
"AGTAGTCAGGGTAATT"	"VSMC"
"AGTAGTCCAACCCTCT"	"VSMC"
"AGTAGTCCAATAAGGT"	"PEC"
"AGTAGTCCACAGCATT"	"CTL/NK-cell"
"AGTAGTCCACTGGCGT"	"T-cell"
"AGTAGTCTCATTCGGA"	"Mac"
"AGTAGTCTCCTCACTG"	"Cyst.PT"
"AGTCAACAGGCACTCC"	"T-cell"
"AGTCAACGTATCTCGA"	"Cyst.PT"
"AGTCAACGTCTACGAT"	"VSMC"
"AGTCACAGTGGCTACC"	"PEC"
"AGTCACAGTGTAGGAC"	"Mono/Mac"
"AGTCACAGTTCTCACC"	"PEC"
"AGTCATGCACGGTAGA"	"T-cell"
"AGTCATGCATCGGATT"	"Cyst.LOH,TAL-cell"
"AGTCATGGTTCGAAGG"	"Cyst.PT"
"AGTCTCCGTAGTAAGT"	"Mono/Mac"
"AGTCTCCTCGCATTAG"	"STC_1"
"AGTCTCCTCGGCCTTT"	"CTL/NK-cell"
"AGTGACTAGGACTGGT"	"Cyst.PT"
"AGTGACTAGTTTGGCT"	"Cyst.PT"
"AGTGACTGTCGCACAC"	"PEC"
"AGTGACTGTCTTGGTA"	"VSMC"
"AGTGACTGTGGCTCTG"	"T-cell"
"AGTGACTGTTCAAGGG"	"Mono/Mac"
"AGTGATCAGCTACAAA"	"Mac"
"AGTGATCCACAGAGCA"	"CTL/NK-cell"
"AGTGATCCATATCTGG"	"T-cell"
"AGTGATCCATCGAGCC"	"Cyst.PT"
"AGTGATCCATGTGGTT"	"T-cell"
"AGTGATCGTAAGTCAA"	"CTL/NK-cell"
"AGTGATCGTCTATGAC"	"VSMC"
"AGTGATCGTTCTAAGC"	"PEC"
"AGTGATCTCCGAAATC"	"Mono/Mac"
"AGTGCCGAGAACGCGT"	"Mac"
"AGTGCCGAGCCTCAAT"	"T-cell"
"AGTGCCGAGGCGTTGA"	"CTL/NK-cell"
"AGTGCCGCAACTCCCT"	"Mac"
"AGTGCCGCAGGTGTTT"	"Cyst.LOH,TAL-cell"
"AGTGCCGGTATTCCTT"	"Fibroblast"
"AGTGCCGGTCGGAAAC"	"EC"
"AGTGCCGGTCGTTGGC"	"VSMC"
"AGTGTTGAGATCGGTG"	"T-cell"
"AGTGTTGCATGCCATA"	"Cyst.LOH,TAL-cell"
"AGTGTTGTCTGCTCTG"	"T-cell"
"AGTGTTGTCTGGTGGC"	"Cyst.LOH,TAL-cell"
"AGTTAGCGTGCATACT"	"T-cell"
"AGTTAGCTCTACTTCA"	"CTL/NK-cell"
"AGTTAGCTCTCGTCGT"	"Cyst.LOH,TAL-cell"
"AGTTCCCCAAGTGATA"	"Cyst.PT"
"AGTTCCCGTTTCGTGA"	"STC_1"
"AGTTCCCTCCGTGCGA"	"STC_1"
"AGTTCCCTCTCGCAGG"	"Mac"
"AGTTCGACAATGGCAG"	"T-cell"
"AGTTCGAGTATGTGTC"	"Mac"
"AGTTCGATCAAGCCAT"	"EC"
"ATACCGAAGAAAGTCT"	"T-cell"
"ATACCGACATAGTCGT"	"T-cell"
"ATACCGACATTGAAAG"	"PEC"
"ATACCGAGTGCCCAGT"	"VSMC"
"ATACCTTAGGAATTAC"	"B-cell"
"ATACCTTCAAATTGGA"	"Cyst.LOH,TAL-cell"
"ATACCTTCATACATCG"	"T-cell"
"ATACCTTTCACTGTCC"	"Mono/Mac"
"ATACCTTTCGTTCGCT"	"EC"
"ATACTTCAGTAGTGCG"	"T-cell"
"ATACTTCCACGCCACA"	"T-cell"
"ATACTTCCAGTCCCGA"	"Cyst.IC-A"
"ATACTTCTCCGCACTT"	"T-cell"
"ATAGACCCAGATTTCG"	"T-cell"
"ATAGACCCAGCAGTGA"	"Mac"
"ATAGACCGTAGCGTCC"	"CTL/NK-cell"
"ATAGACCGTATTGACC"	"STC_1"
"ATAGACCTCCGCAACG"	"VSMC"
"ATAGACCTCTAGAACC"	"Mac"
"ATAGAGAAGCATTTCG"	"CTL/NK-cell"
"ATAGAGAAGGGTCACA"	"T-cell"
"ATAGAGAAGTACTCGT"	"T-cell"
"ATAGAGACAAATCGTC"	"Mac"
"ATAGAGAGTTGGTAGG"	"T-cell"
"ATAGAGATCTGGGAGA"	"Mac"
"ATAGGCTAGAGCCGTA"	"STC_1"
"ATAGGCTCAGAGAAAG"	"Mac"
"ATAGGCTCAGCGATTT"	"STC_1"
"ATAGGCTGTCGCGTTG"	"PEC"
"ATATCCTAGGGTGAAA"	"Cyst.PT"
"ATATCCTCAACGGGTA"	"T-cell"
"ATATCCTGTCGTATTG"	"Cyst.PT"
"ATATCCTGTGCCTAAT"	"Cyst.LOH,TAL-cell"
"ATATCCTTCAGGAACG"	"T-cell"
"ATCACAGCAACTACGT"	"Cyst.LOH,TAL-cell"
"ATCACAGTCTTCTGGC"	"T-cell"
"ATCACGAAGCTCACTA"	"Mono/Mac"
"ATCACGACACTGAGGA"	"Mono/Mac"
"ATCACGACACTTTATC"	"VSMC"
"ATCACGAGTTAGTCGT"	"Cyst.PT"
"ATCACGATCGAAGCAG"	"Mono/Mac"
"ATCACGATCTTTGCGC"	"Cyst.PT"
"ATCACTTAGCAAACAT"	"PEC"
"ATCACTTGTCATCGCG"	"Mono/Mac"
"ATCACTTGTGCGACAA"	"Cyst.PT"
"ATCAGGTGTAGATGTA"	"VSMC"
"ATCAGGTGTGCCCACA"	"Cyst.PT"
"ATCAGGTGTTCTCTCG"	"T-cell"
"ATCATTCAGGTTGAGC"	"Cyst.PT"
"ATCATTCCATATGGCT"	"Mono/Mac"
"ATCATTCGTACTAACC"	"Mac"
"ATCATTCTCTCGAGTA"	"T-cell"
"ATCCACCAGGCCTTGC"	"T-cell"
"ATCCACCGTCACTCTC"	"Cyst.LOH,TAL-cell"
"ATCCATTAGTAAACTG"	"Mono/Mac"
"ATCCCTGGTATAGCTC"	"PEC"
"ATCCGTCAGAAACCCG"	"T-cell"
"ATCCGTCAGACTAGAT"	"VSMC"
"ATCCGTCCACCGGAAA"	"Mac"
"ATCCGTCCAGGTACGA"	"PEC"
"ATCCGTCCAGTTAGAA"	"PEC"
"ATCCGTCCATGCGTGC"	"Cyst.IC-A"
"ATCCGTCTCTGCTAGA"	"Mast-cell"
"ATCCTATAGATCCGAG"	"Cyst.PT"
"ATCCTATAGCACTAGG"	"CTL/NK-cell"
"ATCCTATAGCATCAAA"	"Cyst.LOH,TAL-cell"
"ATCCTATAGGGTCACA"	"PEC"
"ATCCTATCACCACATA"	"T-cell"
"ATCCTATCAGACCGCT"	"Mono/Mac"
"ATCCTATTCCATTGTT"	"Cyst.LOH,TAL-cell"
"ATCCTATTCGGTGAAG"	"EC"
"ATCGATGAGACATAGT"	"STC_1"
"ATCGATGAGCGATGAC"	"Cyst.LOH,TAL-cell"
"ATCGATGAGTGCGCTC"	"Mast-cell"
"ATCGATGCAGGCACAA"	"T-cell"
"ATCGATGCATCATCTT"	"EC"
"ATCGATGGTCTACTGA"	"Fibroblast"
"ATCGATGTCACGGTCG"	"PEC"
"ATCGATGTCTAAGAAG"	"Cyst.PT"
"ATCGCCTCACGCCACA"	"T-cell"
"ATCGCCTCAGTGTGCC"	"PEC"
"ATCGCCTTCACACCGG"	"EC"
"ATCGGATCAAATTGGA"	"Cyst.LOH,TAL-cell"
"ATCGGATGTACGTTCA"	"T-cell"
"ATCGGATGTCTTCGAA"	"VSMC"
"ATCGGATTCTGACCCT"	"Cyst.LOH,TAL-cell"
"ATCGGCGCAATGTCAC"	"T-cell"
"ATCGGCGGTAACAGGC"	"PEC"
"ATCGGCGGTCTAATCG"	"T-cell"
"ATCGTAGCACGGCGTT"	"Mac"
"ATCGTAGGTATGATCC"	"CTL/NK-cell"
"ATCGTAGGTCCACAGC"	"T-cell"
"ATCGTAGTCCTATGGA"	"Cyst.PT"
"ATCGTAGTCGTTGTAG"	"CTL/NK-cell"
"ATCGTCCGTAGACAGC"	"Cyst.LOH,TAL-cell"
"ATCGTCCGTCCTTTGC"	"Mono/Mac"
"ATCGTCCGTGATACAA"	"VSMC"
"ATCGTCCTCCGATAAC"	"STC_1"
"ATCGTGAAGGTACCTT"	"Cyst.PT"
"ATCGTGAAGTCCTACA"	"STC_1"
"ATCGTGAAGTCTTCCC"	"CTL/NK-cell"
"ATCTCTAAGGGCCAAT"	"VSMC"
"ATCTCTACAACCTATG"	"Cyst.PT"
"ATCTCTACAGCAGACA"	"PEC"
"ATCTCTATCTCCTGCA"	"CTL/NK-cell"
"ATCTTCAAGGCGATAC"	"STC_1"
"ATCTTCAAGTCTGGTT"	"PEC"
"ATCTTCAGTGGACCTC"	"Mono/Mac"
"ATCTTCAGTGGGCTTC"	"T-cell"
"ATGAAAGAGACCTGGA"	"STC_1"
"ATGAAAGTCCCGATCT"	"T-cell"
"ATGAAAGTCCTATGGA"	"T-cell"
"ATGACCACAATGGCAG"	"T-cell"
"ATGACCAGTCTGTTAG"	"Cyst.PT"
"ATGACCAGTGATGTAA"	"Cyst.PT"
"ATGACCATCCAAAGGG"	"Mac"
"ATGACCATCCGAAGGA"	"Mast-cell"
"ATGAGGGAGATCACCT"	"CTL/NK-cell"
"ATGAGGGAGCCTCATA"	"T-cell"
"ATGAGGGAGCGAGGAG"	"T-cell"
"ATGAGGGCAGGCCTGT"	"Fibroblast"
"ATGAGGGGTAGCTCGC"	"PEC"
"ATGAGGGGTCAGACTT"	"STC_1"
"ATGAGGGGTTGCATAC"	"STC_2"
"ATGAGGGTCAGATTGC"	"VSMC"
"ATGAGTCAGACGAAGA"	"Cyst.PT"
"ATGAGTCAGTGCAACG"	"EC"
"ATGAGTCCACACCTGG"	"T-cell"
"ATGAGTCGTAGCGTCC"	"PEC"
"ATGAGTCGTCAAAGTA"	"CTL/NK-cell"
"ATGAGTCGTCGAAACG"	"T-cell"
"ATGAGTCGTGAGCAGT"	"Cyst.LOH,TAL-cell"
"ATGAGTCGTGCGTTTA"	"Cyst.LOH,TAL-cell"
"ATGATCGCACAGTGTT"	"T-cell"
"ATGATCGCATTACGGT"	"VSMC"
"ATGATCGTCACAACCA"	"Cyst.LOH,TAL-cell"
"ATGATCGTCAGACCGC"	"VSMC"
"ATGATCGTCAGTGTTG"	"T-cell"
"ATGCATGAGAATCGTA"	"PEC"
"ATGCATGAGCATCCCG"	"CTL/NK-cell"
"ATGCATGCATGAATAG"	"STC_1"
"ATGCATGGTGTATTGC"	"Cyst.PT"
"ATGCCTCCAAAGAACT"	"STC_1"
"ATGCCTCCACGGTAGA"	"STC_1"
"ATGCCTCCACTACCCT"	"Cyst.PT"
"ATGCCTCCAGTTCCAA"	"CTL/NK-cell"
"ATGCCTCTCCAACCAA"	"STC_2"
"ATGCCTCTCTTCTAAC"	"T-cell"
"ATGCGATAGGGCAATC"	"PEC"
"ATGCGATAGTAACAGT"	"Mac"
"ATGCGATCAACAACAA"	"Mono/Mac"
"ATGCGATCATCGTGGC"	"Mac"
"ATGCGATGTCAGCTTA"	"Mac"
"ATGCGATGTGCTGTCG"	"T-cell"
"ATGGAGGCAGTTGTTG"	"T-cell"
"ATGGAGGGTGGAAGTC"	"Cyst.PT"
"ATGGAGGTCCACACCT"	"STC_1"
"ATGGAGGTCGGCATCG"	"Cyst.PT"
"ATGGATCCAACGACAG"	"Cyst.LOH,TAL-cell"
"ATGGATCCAGGACATG"	"Cyst.PT"
"ATGGATCGTAGTAAGT"	"STC_1"
"ATGGATCGTTGAATCC"	"Fibroblast"
"ATGGATCTCGTTAGAC"	"CTL/NK-cell"
"ATGGGAGAGTTACGAA"	"STC_1"
"ATGGGAGGTTACGGAG"	"VSMC"
"ATGGGAGTCCCTCAAC"	"Mono/Mac"
"ATGGGTTGTCTACATG"	"T-cell"
"ATGGGTTTCCCGAGGT"	"Cyst.LOH,TAL-cell"
"ATGGGTTTCTTCGCTG"	"VSMC"
"ATGGTTGAGTGACCTT"	"EC"
"ATGGTTGCATTGCTGA"	"T-cell"
"ATGGTTGTCGACCATA"	"T-cell"
"ATGTCCCCAACTCCCT"	"Cyst.PT"
"ATGTCCCCAAGGTTGG"	"CTL/NK-cell"
"ATGTCCCCAGTTCACA"	"Mono/Mac"
"ATGTCCCGTCTCAAGT"	"Mono/Mac"
"ATGTCCCGTTACCTTT"	"Cyst.LOH,TAL-cell"
"ATGTCCCTCACCTTGC"	"CTL/NK-cell"
"ATGTCCCTCCGTTTCG"	"Mono/Mac"
"ATGTCTTAGCTGTTAC"	"T-cell"
"ATGTCTTAGTACAACA"	"CTL/NK-cell"
"ATGTCTTCACTCGATA"	"EC"
"ATGTCTTGTATAGGAT"	"STC_1"
"ATGTCTTGTTAATCGC"	"Cyst.PT"
"ATGTCTTTCCGCATAA"	"T-cell"
"ATTACCTAGCATGTTC"	"Mono/Mac"
"ATTACCTAGGTTCACT"	"VSMC"
"ATTACCTCACTAAACC"	"Mast-cell"
"ATTACCTGTCGACGCT"	"STC_1"
"ATTACTCCACGGATCC"	"VSMC"
"ATTACTCGTGTGTCCG"	"Mono/Mac"
"ATTACTCGTTACCTGA"	"Mono/Mac"
"ATTATCCAGTTTGGCT"	"STC_1"
"ATTATCCCAAAGAGTT"	"PEC"
"ATTATCCCAGAACCGA"	"T-cell"
"ATTATCCTCTTAATCC"	"T-cell"
"ATTCACTAGGCGACAT"	"Cyst.LOH,TAL-cell"
"ATTCACTCAGACTGCC"	"Mono/Mac"
"ATTCACTGTTGCGTAT"	"Cyst.LOH,TAL-cell"
"ATTCACTTCATTCACT"	"Mac"
"ATTCAGGCAAAGAACT"	"Mac"
"ATTCAGGTCTTCCGTG"	"STC_1"
"ATTCATCGTCGTCTCT"	"T-cell"
"ATTCATCTCAACACCA"	"Mac"
"ATTCATCTCTAATTCC"	"Cyst.LOH,TAL-cell"
"ATTCCATGTTCTTAGG"	"VSMC"
"ATTCCATTCATTACTC"	"STC_2"
"ATTCCATTCTCGAGTA"	"Mono/Mac"
"ATTCCATTCTGCTGAA"	"T-cell"
"ATTCCCGCAAATAAGC"	"PEC"
"ATTCCCGCAGCTATTG"	"Mac"
"ATTCCCGCATCTTTCA"	"VSMC"
"ATTCCCGGTACGACTT"	"Cyst.LOH,TAL-cell"
"ATTCCTAAGATGCAGC"	"Cyst.LOH,TAL-cell"
"ATTCCTAAGGCTGAAC"	"T-cell"
"ATTCCTACAACACAAA"	"Fibroblast"
"ATTCCTACAGACAAGC"	"EC"
"ATTCCTACAGCATGCC"	"Mac"
"ATTCCTACAGCGCTTG"	"Mono/Mac"
"ATTCCTAGTGTTTACG"	"Mac"
"ATTCGTTAGCACTAGG"	"Mono/Mac"
"ATTCGTTAGTGTGTTC"	"T-cell"
"ATTCGTTGTGCCTGAC"	"Cyst.LOH,TAL-cell"
"ATTCGTTGTGTGTTTG"	"T-cell"
"ATTCGTTTCGTTCGCT"	"Mono/Mac"
"ATTCTACAGCACTTTG"	"PEC"
"ATTCTACAGGCGCTTC"	"PEC"
"ATTCTACCACAACGCC"	"CTL/NK-cell"
"ATTCTACTCCCAGGCA"	"PEC"
"ATTCTTGCAATCTCGA"	"T-cell"
"ATTCTTGGTATAGCTC"	"T-cell"
"ATTCTTGGTCAGGTGA"	"EC"
"ATTCTTGGTGGCAGAT"	"T-cell"
"ATTCTTGGTGGTCTGC"	"Cyst.PT"
"ATTCTTGTCATATGGC"	"PEC"
"ATTGGGTAGTTGGCTT"	"VSMC"
"ATTGGGTCACTTGAGT"	"Cyst.PT"
"ATTGGGTGTTCCGCAG"	"T-cell"
"ATTGGGTTCCCAACTC"	"T-cell"
"ATTGGGTTCCCATTTA"	"T-cell"
"ATTGTTCAGAGTTGAT"	"Mono/Mac"
"ATTGTTCAGGTATAGT"	"Cyst.LOH,TAL-cell"
"ATTGTTCCATGAATAG"	"STC_1"
"ATTGTTCGTACTGCCG"	"PEC"
"ATTGTTCGTTATGGTC"	"Cyst.LOH,TAL-cell"
"ATTGTTCTCTTCCTAA"	"T-cell"
"ATTTACCCAAGATGGC"	"Cyst.LOH,TAL-cell"
"ATTTACCCACACCAGC"	"T-cell"
"ATTTACCGTGATCGTT"	"Mac"
"ATTTACCGTGTTACAC"	"Cyst.PT"
"ATTTCACGTACGATCT"	"Mono/Mac"
"ATTTCACTCCGAAATC"	"Mac"
"ATTTCACTCTCATGGA"	"CTL/NK-cell"
"ATTTCTGAGAGCCGTA"	"Cyst.LOH,TAL-cell"
"ATTTCTGGTGCAGATG"	"Cyst.LOH,TAL-cell"
"ATTTCTGTCCGACATA"	"PEC"
"CAAAGAAAGCTGACTT"	"Cyst.LOH,TAL-cell"
"CAAAGAACAGACCTAT"	"STC_1"
"CAAAGAACATGCGGTC"	"Mac"
"CAAAGAATCCGGTTCT"	"Cyst.LOH,TAL-cell"
"CAAAGAATCGATTTCT"	"Cyst.PT"
"CAACAACAGAAGGCTC"	"PEC"
"CAACAACAGCAAGTCG"	"T-cell"
"CAACAACAGGCCTTGC"	"Cyst.PT"
"CAACAACCACGGTAGA"	"T-cell"
"CAACAACTCCTGCTAC"	"Mono/Mac"
"CAACAGTAGGGAGGTG"	"T-cell"
"CAACCAAAGATCCGAG"	"Mono/Mac"
"CAACCAACAGCTCATA"	"PEC"
"CAACCAATCCAAATGC"	"Cyst.LOH,TAL-cell"
"CAACCTCAGGTAAACT"	"T-cell"
"CAACCTCCACCGTACG"	"CTL/NK-cell"
"CAACCTCGTAGCCAGA"	"STC_1"
"CAACCTCGTCCGGTGT"	"Cyst.PT"
"CAACCTCTCCCACAGG"	"B-cell"
"CAACCTCTCCCATGGG"	"STC_1"
"CAACGATAGTACGAGC"	"Mac"
"CAACGATGTTCTCGTC"	"Cyst.LOH,TAL-cell"
"CAACGATGTTGCCGAC"	"Cyst.LOH,TAL-cell"
"CAACGGCAGGCCCGTT"	"Mono/Mac"
"CAACGGCGTACAAGCG"	"VSMC"
"CAACGGCGTACTAACC"	"T-cell"
"CAACGGCGTTCAGGTT"	"STC_1"
"CAACGGCTCGCGTGAC"	"Mac"
"CAAGACTAGGTAGTCG"	"T-cell"
"CAAGACTCACCTGAAT"	"STC_1"
"CAAGACTGTATACGGG"	"CTL/NK-cell"
"CAAGACTTCGCCTCTA"	"PEC"
"CAAGAGGAGCGCCTAC"	"T-cell"
"CAAGAGGCAATCGCCG"	"Mono/Mac"
"CAAGAGGGTAACGGTG"	"B-cell"
"CAAGAGGGTAATGATG"	"Mac"
"CAAGAGGTCGATACTG"	"Mono/Mac"
"CAAGAGGTCTTCGTGC"	"PEC"
"CAAGCTAAGGCTTCCG"	"Cyst.PT"
"CAAGCTAGTGTTACTG"	"Mono/Mac"
"CAAGCTATCGTGTCAA"	"Cyst.PT"
"CAAGCTATCTTACTGT"	"Mac"
"CAAGGGACATGGAACG"	"Mono/Mac"
"CAAGGGATCATTCATC"	"VSMC"
"CAATACGAGAATCGTA"	"VSMC"
"CAATACGGTAGGAGTC"	"STC_1"
"CAATACGGTTATGTCG"	"PEC"
"CAATACGTCGACATAC"	"Cyst.LOH,TAL-cell"
"CAATCGAAGCTCGTGC"	"EC"
"CAATCGAAGGAGAATG"	"STC_1"
"CAATCGAGTAATTAGG"	"CTL/NK-cell"
"CAATCGAGTTGCCGCA"	"T-cell"
"CAATCGATCGAGAACG"	"STC_1"
"CAATCGATCGTGTTCC"	"Mac"
"CAATGACAGACGCCAA"	"PEC"
"CAATGACAGCTATCCA"	"T-cell"
"CAATGACAGTAGTCCT"	"Cyst.PT"
"CAATGACTCGTGGAAG"	"T-cell"
"CAATTTCAGCACCTGC"	"T-cell"
"CAATTTCAGGAGTCTG"	"Cyst.PT"
"CAATTTCAGGTACATA"	"Cyst.LOH,TAL-cell"
"CAATTTCCACACGTGC"	"PEC"
"CAATTTCCATCGATCA"	"Cyst.LOH,TAL-cell"
"CACAACAAGAGCCTGA"	"Mac"
"CACAACACACAGCCTG"	"Cyst.PT"
"CACAACACACCGGTCA"	"STC_1"
"CACACAACATACTGTG"	"Cyst.LOH,TAL-cell"
"CACACAATCACTTGGA"	"STC_1"
"CACAGATAGTGATAAC"	"Mac"
"CACAGATAGTTCCAGT"	"T-cell"
"CACAGATGTAGCCAGA"	"STC_1"
"CACAGATGTGCCGGTT"	"Mac"
"CACAGATGTGCTTATG"	"PEC"
"CACAGGCAGGAGGCAG"	"CTL/NK-cell"
"CACAGGCCAATTGCAC"	"Cyst.LOH,TAL-cell"
"CACAGGCCAGCGGTCT"	"VSMC"
"CACAGGCTCGACATCA"	"VSMC"
"CACATGAGTAACGCGA"	"Cyst.PT"
"CACATGATCAATGCAC"	"Mac"
"CACCAAAAGTTCATGC"	"Cyst.LOH,TAL-cell"
"CACCAAACATCCAACA"	"T-cell"
"CACCAAAGTAAGTAGT"	"STC_1"
"CACCAAAGTAAGTTAG"	"Cyst.LOH,TAL-cell"
"CACCAAAGTCATCGGC"	"CTL/NK-cell"
"CACCAAAGTGAGAGGG"	"Mac"
"CACCAAAGTGCGAACA"	"PEC"
"CACCAAATCCCTCGAT"	"Cyst.LOH,TAL-cell"
"CACCAAATCTGAGTCA"	"Mast-cell"
"CACCGTTAGGCGTTGA"	"STC_1"
"CACCGTTCATCCGATA"	"Mac"
"CACCGTTGTAACAGTA"	"Mac"
"CACCGTTGTGCGCTCA"	"STC_1"
"CACGAATGTGTGTACT"	"PEC"
"CACGGGTAGGCGATAC"	"T-cell"
"CACGGGTGTGCTGTCG"	"STC_2"
"CACGGGTGTTTCGATG"	"CTL/NK-cell"
"CACGTGGAGCGTGCCT"	"EC"
"CACGTGGCACCTGAAT"	"VSMC"
"CACGTGGCAGGACATG"	"T-cell"
"CACGTGGTCATGCCGG"	"Mac"
"CACGTTCAGACTAGAT"	"T-cell"
"CACGTTCAGTCGAAAT"	"T-cell"
"CACGTTCCAAGACCGA"	"PEC"
"CACGTTCCACCAGGTC"	"STC_1"
"CACGTTCCATAGAAAC"	"Cyst.LOH,TAL-cell"
"CACGTTCGTATGTCAC"	"CTL/NK-cell"
"CACGTTCGTGGAACAC"	"Cyst.LOH,TAL-cell"
"CACGTTCGTGGACTAG"	"Mast-cell"
"CACTAAGAGCGTATGG"	"VSMC"
"CACTAAGAGTGCACAG"	"Mac"
"CACTAAGCAGCAGTAG"	"Mono/Mac"
"CACTAAGGTAGGAAAG"	"T-cell"
"CACTAAGGTGACACGA"	"Mono/Mac"
"CACTAAGGTGGACTGA"	"Mono/Mac"
"CACTGAACAGACCGCT"	"Cyst.LOH,TAL-cell"
"CACTGAACATCAGCAT"	"T-cell"
"CACTGAACATGTCTAG"	"T-cell"
"CACTGAAGTGATAGAT"	"VSMC"
"CACTGAATCACTCACC"	"Cyst.PT"
"CACTGAATCGTTAGTG"	"STC_1"
"CACTGGGCACACCGCA"	"Cyst.LOH,TAL-cell"
"CACTGGGCACCGGCTA"	"T-cell"
"CACTGGGCATACAGCT"	"Cyst.PT"
"CACTGGGGTCTCCTGT"	"Mac"
"CACTGTCAGCACCCAC"	"CTL/NK-cell"
"CACTGTCCAACTCATG"	"Cyst.LOH,TAL-cell"
"CACTGTCCACAGAAGC"	"VSMC"
"CACTGTCGTCCAAAGG"	"CTL/NK-cell"
"CACTGTCGTGAGTGAC"	"T-cell"
"CACTGTCGTGCCTGCA"	"PEC"
"CACTGTCGTTCCTTGC"	"T-cell"
"CACTGTCTCCACCTGT"	"Cyst.LOH,TAL-cell"
"CACTGTCTCTCTATGT"	"Cyst.PT"
"CACTTCGAGAACGCGT"	"Mono/Mac"
"CACTTCGAGGTAGTCG"	"PEC"
"CACTTCGAGTACTGTC"	"STC_2"
"CAGAGCCCAGTTAAAG"	"Mono/Mac"
"CAGAGCCCATGGAGAC"	"EC"
"CAGAGCCTCTATTTCG"	"VSMC"
"CAGATACAGCCTGTGC"	"Cyst.LOH,TAL-cell"
"CAGATACAGCGCACAA"	"EC"
"CAGATACTCTAGCATG"	"PEC"
"CAGATACTCTCCTACG"	"EC"
"CAGATCAAGACGCATG"	"Cyst.PT"
"CAGATCACAATACAGA"	"Cyst.PT"
"CAGATCAGTGCCGAAA"	"Cyst.PT"
"CAGATTGAGCATAGGC"	"Cyst.PT"
"CAGATTGCAACCAACT"	"Mac"
"CAGATTGTCCATCTCG"	"CTL/NK-cell"
"CAGCAATAGGGTGAAA"	"T-cell"
"CAGCAATGTCATCTAG"	"T-cell"
"CAGCAATGTGAGTAAT"	"T-cell"
"CAGCAATTCCTACACC"	"T-cell"
"CAGCACGAGCTGAGCA"	"Cyst.LOH,TAL-cell"
"CAGCACGCAACACAGG"	"T-cell"
"CAGCACGCATAGCACT"	"EC"
"CAGCACGTCCGTCACT"	"Mac"
"CAGCAGCAGAGGCGGA"	"Cyst.LOH,TAL-cell"
"CAGCAGCAGAGGTCGT"	"Fibroblast"
"CAGCAGCCAAGCACAG"	"VSMC"
"CAGCAGCTCCCACAGG"	"Cyst.PT"
"CAGCAGCTCCCTTGGT"	"VSMC"
"CAGCAGCTCCGTCCTA"	"Fibroblast"
"CAGCCAGCAACATCGT"	"Cyst.LOH,TAL-cell"
"CAGCCAGCAACCAATC"	"Mac"
"CAGCCAGCATGGACAG"	"STC_1"
"CAGCCAGTCTGTGTGA"	"VSMC"
"CAGCGTGAGAAATTGC"	"PEC"
"CAGGCCAAGCGTGAGT"	"Mono/Mac"
"CAGGCCAAGGTCTTTG"	"Mono/Mac"
"CAGGCCAAGTGATTCC"	"Cyst.IC-A"
"CAGGCCAGTACAAGCG"	"STC_1"
"CAGGCCAGTAGGAGGG"	"B-cell"
"CAGGCCAGTCGAACGA"	"Cyst.LOH,TAL-cell"
"CAGGCCATCGCGGTAC"	"Cyst.LOH,TAL-cell"
"CAGGGCTAGCTGGCTC"	"Mono/Mac"
"CAGGGCTCAAAGGTTA"	"Mac"
"CAGGGCTCACTACACA"	"T-cell"
"CAGGGCTCATGACAGG"	"PEC"
"CAGGGCTGTCCAAGAG"	"VSMC"
"CAGGTATAGTGGATAT"	"CTL/NK-cell"
"CAGGTATGTCTTGAGT"	"EC"
"CAGTGCGCAAAGAACT"	"Cyst.IC-A"
"CAGTGCGCACTCTGCT"	"STC_1"
"CAGTGCGTCGTCTAAG"	"Cyst.LOH,TAL-cell"
"CAGTGCGTCTGCAGCG"	"Mono/Mac"
"CAGTTAGAGCGTGTTT"	"VSMC"
"CAGTTAGCACGAAAGC"	"T-cell"
"CAGTTCCAGAAACCCG"	"Cyst.PT"
"CAGTTCCAGACTACCT"	"T-cell"
"CAGTTCCAGATTGTGA"	"T-cell"
"CAGTTCCTCCACATAG"	"VSMC"
"CAGTTCCTCCATGATG"	"CTL/NK-cell"
"CAGTTCCTCCTCTAAT"	"B-cell"
"CATAAGCAGACGCAGT"	"Cyst.PT"
"CATAAGCCATGTCTAG"	"T-cell"
"CATACAGAGAATTGCA"	"STC_1"
"CATACCCAGGATGCGT"	"Mono/Mac"
"CATACCCAGGCTGGAT"	"STC_1"
"CATACCCCAGCAGATG"	"Mono/Mac"
"CATACCCGTTCCTAAG"	"EC"
"CATACCCTCGCCCAGA"	"VSMC"
"CATACCCTCTCCATAT"	"VSMC"
"CATACTTAGTCGGCAA"	"Mono/Mac"
"CATACTTCAAAGACGC"	"Cyst.LOH,TAL-cell"
"CATACTTCATTGAAGA"	"VSMC"
"CATACTTGTGGCAACA"	"Cyst.LOH,TAL-cell"
"CATAGACAGAGATCGC"	"Cyst.LOH,TAL-cell"
"CATAGACGTAGATCGG"	"Cyst.LOH,TAL-cell"
"CATAGACTCCCTAGGG"	"T-cell"
"CATCAAGAGCGTCAGA"	"T-cell"
"CATCAAGAGCTTGTGT"	"T-cell"
"CATCAAGCAGCCCAGT"	"Mono/Mac"
"CATCAAGGTGAGTTTC"	"VSMC"
"CATCAAGTCCACAAGT"	"Fibroblast"
"CATCAAGTCTCTTGCG"	"STC_1"
"CATCCACCAGGAGACT"	"Cyst.LOH,TAL-cell"
"CATCCACGTAGATTGA"	"Cyst.PT"
"CATCCACTCCACAAGT"	"EC"
"CATCCCACACAACCGC"	"Cyst.LOH,TAL-cell"
"CATCCCACACTAGTAC"	"VSMC"
"CATCCCAGTTAATCGC"	"STC_1"
"CATCCCAGTTTCCATT"	"Mono/Mac"
"CATCCGTCACAAGCTT"	"Cyst.PT"
"CATCCGTCAGGGAGAG"	"VSMC"
"CATCCGTGTCTGATCA"	"B-cell"
"CATCGCTAGAAACCAT"	"T-cell"
"CATCGCTAGCCTCTTC"	"STC_1"
"CATCGGGGTCTGTAGT"	"STC_1"
"CATCGGGTCCGATGTA"	"T-cell"
"CATCGGGTCTCTCGCA"	"STC_1"
"CATCGTCAGACTGGGT"	"T-cell"
"CATCGTCAGAGCCGTA"	"Cyst.PT"
"CATCGTCCAACCACGC"	"Mono/Mac"
"CATCGTCGTCAATGGG"	"Fibroblast"
"CATCGTCGTCGAAACG"	"Mast-cell"
"CATCGTCGTTAGGGTG"	"CTL/NK-cell"
"CATCGTCTCAGCGCAC"	"Cyst.LOH,TAL-cell"
"CATGAGTAGACTCCGC"	"T-cell"
"CATGAGTAGCAGGGAG"	"Cyst.PT"
"CATGAGTCAGGTACGA"	"T-cell"
"CATGAGTGTATCGCAT"	"STC_1"
"CATGAGTTCCTAGCGG"	"VSMC"
"CATGAGTTCCTCAGAA"	"Cyst.PT"
"CATGCAAGTGGCCTCA"	"STC_1"
"CATGCAAGTTAACAGA"	"PEC"
"CATGCAATCAAGGTGG"	"T-cell"
"CATGCCTAGGGCAATC"	"T-cell"
"CATGCCTCAACGGCCT"	"T-cell"
"CATGCCTCATCCTTCG"	"Mono/Mac"
"CATGCCTTCTGGGTCG"	"Mast-cell"
"CATGCGGAGTAGTGCG"	"Cyst.LOH,TAL-cell"
"CATGCGGAGTGCTAGG"	"Mac"
"CATGCGGGTACTGGGA"	"Mono/Mac"
"CATGCGGGTGACGTCC"	"Cyst.LOH,TAL-cell"
"CATGCGGTCTCTTAAC"	"PEC"
"CATGCGGTCTGCATAG"	"Cyst.LOH,TAL-cell"
"CATGCTCAGAGGCGGA"	"Cyst.LOH,TAL-cell"
"CATGCTCAGTGCTCAT"	"Cyst.LOH,TAL-cell"
"CATGCTCGTCCTGGTG"	"Cyst.PT"
"CATGCTCTCGTCGACG"	"Mac"
"CATGGATGTGGCTGCT"	"T-cell"
"CATGGATTCAACTGGT"	"EC"
"CATGGTAAGAACGTGC"	"Cyst.PT"
"CATGGTAAGCTCGTGC"	"CTL/NK-cell"
"CATGGTACAACCAACT"	"STC_1"
"CATGGTACAGTAACGG"	"Cyst.LOH,TAL-cell"
"CATGGTACATCCTAAG"	"T-cell"
"CATTCATAGCACAAAT"	"T-cell"
"CATTCATCACAAGCCC"	"VSMC"
"CATTCATGTTGTGGAG"	"Cyst.PT"
"CATTCATTCTCATGCC"	"Mono/Mac"
"CATTCCGAGCCTGAGA"	"PEC"
"CATTCCGCACAATGCT"	"PEC"
"CATTCCGCACTGTGTA"	"Mono/Mac"
"CATTCCGTCGGTCAGC"	"Cyst.LOH,TAL-cell"
"CATTCTAAGGTCCCTG"	"PEC"
"CATTCTACAAACTAAG"	"Fibroblast"
"CATTCTAGTGTTTGCA"	"PEC"
"CATTCTAGTTAAGAAC"	"STC_1"
"CATTCTATCAAACGTC"	"Cyst.LOH,TAL-cell"
"CATTCTATCTGAGAGG"	"T-cell"
"CATTGAGCAGACATCT"	"Mac"
"CATTGAGCATGTACGT"	"STC_2"
"CATTGCCCATCTCATT"	"Cyst.LOH,TAL-cell"
"CATTGTTAGCGATGAC"	"Cyst.LOH,TAL-cell"
"CATTGTTCACTCTCGT"	"STC_1"
"CATTGTTGTAAGCTCT"	"Cyst.LOH,TAL-cell"
"CATTGTTGTGGATACG"	"Mac"
"CATTGTTTCTGGCTGG"	"Cyst.LOH,TAL-cell"
"CATTTCACAAACTGCT"	"PEC"
"CCAAGCGTCCGATCGG"	"STC_1"
"CCAATGAAGACGTCGA"	"Cyst.LOH,TAL-cell"
"CCAATGACAAGAATAC"	"T-cell"
"CCAATGATCCACGGGT"	"T-cell"
"CCAATTTGTACCACGC"	"PEC"
"CCACAAAAGATGTTCC"	"T-cell"
"CCACAAACAATTGAAG"	"Fibroblast"
"CCACAAAGTGTTACTG"	"STC_1"
"CCACAAATCATGAGGG"	"CTL/NK-cell"
"CCACAAATCTATCGGA"	"T-cell"
"CCACACTAGCCTATTG"	"Mac"
"CCACACTAGGGATGTC"	"PEC"
"CCACACTCAAATCCCA"	"VSMC"
"CCACACTGTTTAGTCG"	"Mast-cell"
"CCACACTTCCCGAATA"	"T-cell"
"CCACACTTCCGTTGGG"	"STC_1"
"CCACACTTCCTTCACG"	"Mono/Mac"
"CCACACTTCGGTAGAG"	"Cyst.LOH,TAL-cell"
"CCACCATAGAAATTCG"	"Cyst.LOH,TAL-cell"
"CCACCATAGAACAAGG"	"VSMC"
"CCACCATAGATGGCGT"	"Fibroblast"
"CCACCATAGCTATCTG"	"STC_1"
"CCACCATCACCCTAGG"	"T-cell"
"CCACCATGTGGCCCAT"	"Cyst.LOH,TAL-cell"
"CCACGAGAGACAACAT"	"Cyst.PT"
"CCACGAGAGAGTGGCT"	"STC_1"
"CCACGAGAGGGTGGGA"	"Mac"
"CCACGAGCACCACTGG"	"T-cell"
"CCACGAGGTTAAGGGC"	"STC_1"
"CCACGAGTCGTTGTGA"	"EC"
"CCACGAGTCTGGGATT"	"T-cell"
"CCACGTTCAGCTTCGG"	"Cyst.LOH,TAL-cell"
"CCACGTTGTTGCAAGG"	"STC_1"
"CCACGTTTCTCTGCTG"	"T-cell"
"CCACTTGCACAGGATG"	"Mast-cell"
"CCACTTGCACTGAGTT"	"B-cell"
"CCACTTGTCCATAGAC"	"EC"
"CCACTTGTCGAGTGGA"	"Mono/Mac"
"CCATAAGCACGAGGTA"	"Mac"
"CCATAAGTCAGGGTAG"	"PEC"
"CCATAAGTCGATTTCT"	"Cyst.PT"
"CCATCACAGGTTTACC"	"Mast-cell"
"CCATCACGTATCAAGA"	"Mono/Mac"
"CCATCACGTATTCCTT"	"STC_1"
"CCATCACGTCGCTTAA"	"Mac"
"CCATCACGTGAGGATC"	"PEC"
"CCATCACGTGGTCCGT"	"Mac"
"CCATCACTCCATCTAT"	"T-cell"
"CCCAACTCAGGCAATG"	"Mac"
"CCCAACTCATGACAGG"	"Mono/Mac"
"CCCAACTGTAAGCAAT"	"T-cell"
"CCCAACTGTCTGTGCG"	"Cyst.LOH,TAL-cell"
"CCCATTGCACGTTGGC"	"PEC"
"CCCATTGCAGCTACCG"	"Mono/Mac"
"CCCATTGGTCGTATGT"	"Cyst.PT"
"CCCGAAGAGTGGATTA"	"STC_1"
"CCCGAAGCATGTTCGA"	"STC_1"
"CCCGAAGTCCCTGGTT"	"Mono/Mac"
"CCCGGAACATAGACTC"	"Cyst.PT"
"CCCGGAACATTGGCAT"	"PEC"
"CCCTAACAGCAGCAGT"	"PEC"
"CCCTAACCAACTACGT"	"T-cell"
"CCCTAACCACGTACTA"	"STC_1"
"CCCTAACGTGCACAAG"	"Cyst.PT"
"CCCTAACTCACCGACG"	"T-cell"
"CCCTAACTCGAGCCAC"	"Cyst.PT"
"CCCTCAACAGATAAAC"	"VSMC"
"CCCTCTCTCCCGTAAA"	"Mac"
"CCCTGATAGGCCATAG"	"T-cell"
"CCCTGATCAATGCAGG"	"Cyst.LOH,TAL-cell"
"CCCTGATGTCAGCGTC"	"Mac"
"CCCTGATTCCAGTGTA"	"T-cell"
"CCCTTAGAGCCTCAAT"	"T-cell"
"CCCTTAGAGCGTTAGG"	"T-cell"
"CCCTTAGAGGCAGCTA"	"Mono/Mac"
"CCCTTAGTCAAACCTG"	"Mono/Mac"
"CCCTTAGTCAATCCAG"	"Cyst.LOH,TAL-cell"
"CCCTTAGTCTGATGGT"	"STC_1"
"CCGAACGTCGACGCGT"	"Cyst.IC-A"
"CCGAACGTCTCACGAA"	"VSMC"
"CCGAACGTCTGTCCCA"	"Mac"
"CCGATCTGTATGTCTG"	"Cyst.PT"
"CCGATCTTCAAACCTG"	"Mac"
"CCGATGGAGGGTTTCT"	"STC_1"
"CCGATGGCAGTTAAAG"	"STC_1"
"CCGATGGGTGATTCTG"	"T-cell"
"CCGCAAGCAAAGTATG"	"Cyst.LOH,TAL-cell"
"CCGCAAGCAACGCATT"	"T-cell"
"CCGCAAGCATGCCATA"	"Cyst.LOH,TAL-cell"
"CCGCAAGGTAGAGTTA"	"Cyst.LOH,TAL-cell"
"CCGCAAGGTCCCTGAG"	"CTL/NK-cell"
"CCGGACACAATTCTCT"	"Cyst.PT"
"CCGGGTACAACTCATG"	"T-cell"
"CCGGGTACACATGACT"	"Mono/Mac"
"CCGGGTACAGTTAGAA"	"STC_1"
"CCGGGTATCGCAAGAG"	"PEC"
"CCGGTGAAGGTTTGAA"	"Cyst.LOH,TAL-cell"
"CCGGTGAGTCTCCTGT"	"VSMC"
"CCGTAGGCACTGCTTC"	"Mono/Mac"
"CCGTAGGTCTGAATCG"	"Mono/Mac"
"CCGTGAGAGGGTACAC"	"T-cell"
"CCGTGAGCACCTGCTT"	"VSMC"
"CCGTGAGCAGGCTACC"	"T-cell"
"CCGTGAGCATAGAGGC"	"Mac"
"CCGTGAGGTCCCTAAA"	"Fibroblast"
"CCGTGAGGTGACTGAG"	"STC_1"
"CCGTGAGGTGGTCCGT"	"Fibroblast"
"CCGTTCAAGATGAAGG"	"B-cell"
"CCGTTCAAGCCAGTAG"	"T-cell"
"CCGTTCACAGGAGACT"	"Mono/Mac"
"CCGTTCATCGATACGT"	"Mono/Mac"
"CCGTTCATCTTCTAAC"	"Cyst.LOH,TAL-cell"
"CCTAACCCACAAATAG"	"B-cell"
"CCTAACCTCTTGAGCA"	"Cyst.LOH,TAL-cell"
"CCTAAGAAGGACGGAG"	"Mono/Mac"
"CCTAAGACAAATGCTC"	"Mono/Mac"
"CCTAAGAGTGCCCTTT"	"T-cell"
"CCTACGTAGCCTAGGA"	"T-cell"
"CCTACGTGTATCCCAA"	"Mac"
"CCTACGTTCGTAGTCA"	"VSMC"
"CCTATCGCACTGTTCC"	"CTL/NK-cell"
"CCTATCGCAGTTCACA"	"Cyst.LOH,TAL-cell"
"CCTATCGGTCCGAAAG"	"EC"
"CCTATCGTCGCACTCT"	"STC_1"
"CCTATCGTCTGCCCTA"	"Cyst.LOH,TAL-cell"
"CCTCAACAGAGCATCG"	"Mono/Mac"
"CCTCAACCAACCGCTG"	"EC"
"CCTCACAAGATCGCCC"	"Cyst.LOH,TAL-cell"
"CCTCACAAGTAACCTC"	"Cyst.LOH,TAL-cell"
"CCTCACACAAGTGCAG"	"Cyst.IC-A"
"CCTCACACAGTTTGGT"	"Mast-cell"
"CCTCACAGTAACCCTA"	"Cyst.PT"
"CCTCAGTCAGTTTCGA"	"Cyst.LOH,TAL-cell"
"CCTCAGTCATCGGTTA"	"Mono/Mac"
"CCTCAGTCATGAATAG"	"Cyst.IC-A"
"CCTCAGTGTCACGCTG"	"PEC"
"CCTCAGTGTTCGTTCC"	"Mono/Mac"
"CCTCAGTTCACCTGGG"	"PEC"
"CCTCATGAGACCAACG"	"T-cell"
"CCTCATGTCCATACAG"	"T-cell"
"CCTCCAAGTCACCACG"	"STC_2"
"CCTCCAATCTGCATGA"	"T-cell"
"CCTCCAATCTTGGATG"	"T-cell"
"CCTCCTCCAGCCATTA"	"STC_1"
"CCTCCTCCATACTTTC"	"Mast-cell"
"CCTCCTCGTGCTGATT"	"Mac"
"CCTCCTCGTGTCTTAG"	"Cyst.LOH,TAL-cell"
"CCTCCTCGTTATAGCC"	"T-cell"
"CCTCTAGAGATAGTGT"	"T-cell"
"CCTCTAGAGGATTTGA"	"Mast-cell"
"CCTCTAGCAGACCCGT"	"PEC"
"CCTCTAGGTATGACAA"	"STC_1"
"CCTCTAGGTCACAGTT"	"Mono/Mac"
"CCTCTAGGTGAATGTA"	"VSMC"
"CCTCTCCAGGCAGGGA"	"Cyst.LOH,TAL-cell"
"CCTCTCCCATGGCCAC"	"Cyst.LOH,TAL-cell"
"CCTCTCCCATTCACAG"	"Mono/Mac"
"CCTCTCCGTCACAGTT"	"Cyst.PT"
"CCTCTCCGTGAGTGAC"	"VSMC"
"CCTCTCCTCAAACTGC"	"STC_2"
"CCTCTCCTCGCAGTCG"	"Fibroblast"
"CCTGCATAGTGAGGCT"	"Cyst.PT"
"CCTGCATCAATAACCC"	"Mac"
"CCTGCATCACAAACGG"	"Mono/Mac"
"CCTGCATCACTCCGGA"	"CTL/NK-cell"
"CCTGCATCAGCGAGTA"	"VSMC"
"CCTGCATGTAACATCC"	"VSMC"
"CCTGCATTCCGGACGT"	"VSMC"
"CCTGTTGCAGTAGGAC"	"B-cell"
"CCTGTTGCATCATTTC"	"VSMC"
"CCTGTTGCATTGAGGG"	"Cyst.PT"
"CCTGTTGGTACCAATC"	"Mac"
"CCTGTTGGTGGGTCAA"	"PEC"
"CCTGTTGTCAATCTCT"	"Cyst.PT"
"CCTGTTGTCGTTGCCT"	"VSMC"
"CCTTCAGAGACGTCGA"	"STC_1"
"CCTTCAGAGCTACAAA"	"Cyst.LOH,TAL-cell"
"CCTTCAGAGGACAAGA"	"T-cell"
"CCTTCAGCATGGACAG"	"Cyst.LOH,TAL-cell"
"CCTTCAGTCGCCAACG"	"Cyst.PT"
"CCTTGTGGTTAGCTAC"	"CTL/NK-cell"
"CCTTTGGCAGTGCGCT"	"STC_1"
"CCTTTGGGTCGCAGTC"	"PEC"
"CCTTTGGGTGGATCGA"	"T-cell"
"CCTTTGGTCGCCTCTA"	"Cyst.PT"
"CGAAGGACAGAAGCTG"	"Fibroblast"
"CGAAGGATCGTGTGGC"	"Cyst.PT"
"CGAAGTTGTTCCAAAC"	"VSMC"
"CGAATTGAGATCCGAG"	"CTL/NK-cell"
"CGAATTGAGGCTCACC"	"Cyst.LOH,TAL-cell"
"CGAATTGAGGGATCTG"	"Cyst.LOH,TAL-cell"
"CGAATTGCAATCAGCT"	"PEC"
"CGAATTGGTGGATCGA"	"Cyst.LOH,TAL-cell"
"CGACAGCTCTCCTACG"	"T-cell"
"CGAGAAGAGAGTGGCT"	"PEC"
"CGAGAAGAGCTCCGAC"	"T-cell"
"CGAGAAGAGCTGTTCA"	"Cyst.PT"
"CGAGAAGCACTGAGTT"	"Cyst.LOH,TAL-cell"
"CGAGAAGCATCAGCTA"	"Cyst.PT"
"CGAGAAGCATGGGCAA"	"Mono/Mac"
"CGAGAAGTCCGCACGA"	"Cyst.LOH,TAL-cell"
"CGAGAAGTCTCTCTTC"	"Cyst.LOH,TAL-cell"
"CGAGGAAAGGCATCTT"	"STC_1"
"CGAGGAACACTGATTG"	"Fibroblast"
"CGAGGAAGTCTGTTAG"	"PEC"
"CGAGGAATCCGGTAGC"	"CTL/NK-cell"
"CGAGGCTTCACTGATG"	"Cyst.PT"
"CGAGGCTTCTGCGAGC"	"Cyst.LOH,TAL-cell"
"CGAGTGCAGATAGTGT"	"T-cell"
"CGAGTGCCATACCGTA"	"EC"
"CGAGTGCGTTGTGGCC"	"T-cell"
"CGAGTGCTCACTCCGT"	"PEC"
"CGAGTGCTCGCCTCTA"	"STC_1"
"CGAGTTAAGTGGAATT"	"Cyst.LOH,TAL-cell"
"CGAGTTAGTATTGACC"	"EC"
"CGAGTTAGTTAGGGTG"	"STC_1"
"CGAGTTATCATTGCGA"	"T-cell"
"CGATCGGAGCACCGAA"	"T-cell"
"CGATCGGGTAAGGCCA"	"STC_2"
"CGATGCGAGTCGTCTA"	"Mono/Mac"
"CGATGCGCATACTTTC"	"Cyst.LOH,TAL-cell"
"CGATGGCAGACGAAGA"	"PEC"
"CGATGGCAGCTTGTTG"	"STC_1"
"CGCAGGTCACATCATG"	"VSMC"
"CGCAGGTTCGAACACT"	"Cyst.PT"
"CGCATAAAGCCTCTGG"	"Cyst.PT"
"CGCATAATCGCTTGCT"	"Mac"
"CGCATGGAGGCTTAGG"	"VSMC"
"CGCATGGCACGACGAA"	"STC_1"
"CGCATGGCATAACTCG"	"T-cell"
"CGCATGGGTGAGTGAC"	"EC"
"CGCCAGAAGCACTCTA"	"CTL/NK-cell"
"CGCCAGAAGTTGCGAG"	"STC_1"
"CGCCAGAGTGTCTCCT"	"Mac"
"CGCCATTAGCACACCC"	"STC_1"
"CGCCATTCAGTATTCG"	"PEC"
"CGCCATTTCGAGGCAA"	"STC_2"
"CGCCATTTCTGTCCCA"	"Mac"
"CGCGTGACAGGTTACT"	"VSMC"
"CGCGTGATCCATACAG"	"Cyst.PT"
"CGCGTGATCGCTACAA"	"CTL/NK-cell"
"CGCGTGATCTGCTAGA"	"Cyst.IC-A"
"CGGAACCAGGATACCG"	"Cyst.PT"
"CGGAACCAGTTAACGA"	"VSMC"
"CGGAACCGTTACGCCG"	"STC_1"
"CGGAACCTCATCGACA"	"Cyst.LOH,TAL-cell"
"CGGACACCAAAGTATG"	"Cyst.LOH,TAL-cell"
"CGGACACGTAACATGA"	"T-cell"
"CGGACACGTATTCTCT"	"T-cell"
"CGGACACGTCGAGCAA"	"CTL/NK-cell"
"CGGACACGTGATAGTA"	"CTL/NK-cell"
"CGGACACTCGTTCATT"	"PEC"
"CGGAGAACACAGTGAG"	"T-cell"
"CGGAGAACAGCAGTCC"	"Mono/Mac"
"CGGAGAACATGCACTA"	"Cyst.LOH,TAL-cell"
"CGGAGAACATGTGGCC"	"Mono/Mac"
"CGGAGAAGTGCCTGAC"	"VSMC"
"CGGCAGTAGAACGCGT"	"T-cell"
"CGGCAGTAGACTTAAG"	"CTL/NK-cell"
"CGGCAGTAGGTGGTTG"	"Cyst.LOH,TAL-cell"
"CGGCAGTCATCCGGCA"	"STC_1"
"CGGCAGTCATGCTGCG"	"T-cell"
"CGGCAGTGTCACGCTG"	"Mono/Mac"
"CGGCAGTGTCCTACAA"	"T-cell"
"CGGGACTAGTCTTCCC"	"Cyst.LOH,TAL-cell"
"CGGGACTCATGCCGGT"	"STC_1"
"CGGGCATAGCGAGTAC"	"VSMC"
"CGGGCATCAAGGCCTC"	"STC_1"
"CGGGCATGTGAGATAT"	"Mono/Mac"
"CGGGCATGTGTGCTTA"	"STC_1"
"CGGGCATGTTGTTGAC"	"Cyst.LOH,TAL-cell"
"CGGGTCAAGCCATCCG"	"T-cell"
"CGGGTCACAACTGTGT"	"Cyst.LOH,TAL-cell"
"CGGGTCACAGTCGGAA"	"Cyst.PT"
"CGGGTCAGTACGTAGG"	"T-cell"
"CGGGTCAGTCCGGCAT"	"Cyst.PT"
"CGGGTGTCACCCTGTT"	"PEC"
"CGGGTGTCACCTCTGT"	"Cyst.PT"
"CGGGTGTCAGAGAATT"	"Cyst.PT"
"CGGGTGTGTTCAACGT"	"Mono/Mac"
"CGGGTGTTCTGTCCGT"	"Mono/Mac"
"CGGTCAGAGGTAGACC"	"Mast-cell"
"CGGTCAGCAAACAGGC"	"PEC"
"CGGTCAGCACCTGATA"	"Mono/Mac"
"CGGTCAGTCGCTCTCA"	"Mono/Mac"
"CGTAAGTGTGGAACAC"	"Cyst.PT"
"CGTAAGTTCGTTTACT"	"STC_1"
"CGTAATGCAGACGATG"	"Cyst.LOH,TAL-cell"
"CGTAATGGTCGCAGTC"	"PEC"
"CGTAATGTCCGAGAAG"	"Cyst.LOH,TAL-cell"
"CGTAGTAAGAAAGTCT"	"Cyst.LOH,TAL-cell"
"CGTAGTAAGATAACAC"	"VSMC"
"CGTAGTAAGGTATAGT"	"T-cell"
"CGTAGTACACTTGTGA"	"VSMC"
"CGTAGTACAGCCTTCT"	"Mono/Mac"
"CGTAGTACATCCGTTC"	"EC"
"CGTAGTACATCTCATT"	"VSMC"
"CGTAGTAGTCCGACGT"	"Mono/Mac"
"CGTCAAACATCTCCCA"	"T-cell"
"CGTCAAACATGGAAGC"	"T-cell"
"CGTCAAACATTACGGT"	"VSMC"
"CGTCAAAGTAGGATAT"	"Fibroblast"
"CGTCAAAGTATGTCCA"	"CTL/NK-cell"
"CGTCAAATCGTTGTGA"	"Cyst.PT"
"CGTCAAATCTTGGGCG"	"VSMC"
"CGTCCATAGAGAGCGG"	"STC_2"
"CGTCCATAGCACGTCC"	"STC_1"
"CGTGAATAGACCGCCT"	"VSMC"
"CGTGAATCACAGCCAC"	"T-cell"
"CGTGAATGTCAGGTGA"	"Mac"
"CGTGAATTCCCTCTTT"	"Mono/Mac"
"CGTGATACACCCATAA"	"Mac"
"CGTGATACATGGCTAT"	"Cyst.PT"
"CGTGCTTAGGTACAGC"	"CTL/NK-cell"
"CGTGCTTAGGTGCCTC"	"Fibroblast"
"CGTGCTTCATCCTTGC"	"CTL/NK-cell"
"CGTGCTTGTGAACTAA"	"VSMC"
"CGTGTCTCACGGCACT"	"EC"
"CGTGTCTCAGCAGATG"	"T-cell"
"CGTGTCTGTTCTCGTC"	"Cyst.PT"
"CGTGTCTTCAAACCTG"	"VSMC"
"CGTTAGAAGGGACAGG"	"CTL/NK-cell"
"CGTTAGACAACCAGAG"	"Cyst.LOH,TAL-cell"
"CGTTAGAGTCTACAGT"	"Cyst.LOH,TAL-cell"
"CGTTAGATCTAGGCAT"	"STC_1"
"CGTTCTGAGTTCATGC"	"T-cell"
"CGTTCTGCACATAACC"	"Cyst.PT"
"CGTTCTGGTAATGTGA"	"CTL/NK-cell"
"CGTTCTGGTATCGTAC"	"T-cell"
"CGTTCTGGTATGCAAA"	"B-cell"
"CGTTGGGAGGCCTGCT"	"EC"
"CGTTGGGGTACGTTCA"	"Cyst.LOH,TAL-cell"
"CGTTGGGGTCTCGGGT"	"T-cell"
"CGTTGGGGTGCCCAGT"	"T-cell"
"CTAACCCCAATGTGGG"	"Cyst.LOH,TAL-cell"
"CTAACCCCATAATCCG"	"STC_1"
"CTAACCCCATGTGGCC"	"VSMC"
"CTAACCCGTGGTTCTA"	"EC"
"CTAACCCTCACTCACC"	"Cyst.LOH,TAL-cell"
"CTAACCCTCTCGGTCT"	"Mac"
"CTAACTTCACGGATCC"	"STC_1"
"CTAACTTGTTAGTTCG"	"T-cell"
"CTAACTTTCTCTCCGA"	"STC_1"
"CTAAGTGAGGATGTTA"	"Cyst.LOH,TAL-cell"
"CTAAGTGCAACCGCTG"	"T-cell"
"CTAAGTGGTAGTTAGA"	"Cyst.LOH,TAL-cell"
"CTAAGTGTCTCACCCA"	"T-cell"
"CTACAGAAGACGGTTG"	"Cyst.LOH,TAL-cell"
"CTACAGAAGTCGAAAT"	"Cyst.LOH,TAL-cell"
"CTACATTAGAGTGACC"	"STC_2"
"CTACATTAGGGTGAAA"	"Mono/Mac"
"CTACATTCACAGTGAG"	"STC_1"
"CTACATTCATAACCCA"	"Cyst.PT"
"CTACATTGTGTAAATG"	"Mono/Mac"
"CTACATTTCTGAATCG"	"VSMC"
"CTACCCAAGTACTGTC"	"Cyst.PT"
"CTACCCACAGAGGGTT"	"Mac"
"CTACCCAGTTCAGGTT"	"STC_1"
"CTACGGGAGACTAAGT"	"T-cell"
"CTACGGGGTTTCGCTC"	"VSMC"
"CTACGGGTCCTTCGAC"	"Mac"
"CTACTATCAGACCTGC"	"Mono/Mac"
"CTACTATCAGAGATTA"	"Cyst.IC-A"
"CTACTATCATGGAATA"	"CTL/NK-cell"
"CTACTATGTGCATGTT"	"VSMC"
"CTACTATGTTCAATCG"	"STC_1"
"CTAGACAAGCACACAG"	"T-cell"
"CTAGACACACATGAAA"	"T-cell"
"CTAGACAGTAACACCT"	"Cyst.LOH,TAL-cell"
"CTAGACAGTCGTCGGT"	"Cyst.LOH,TAL-cell"
"CTAGACAGTCTACGAT"	"STC_1"
"CTAGACAGTCTTACAG"	"T-cell"
"CTAGACAGTGTCTTCC"	"Mac"
"CTAGACATCTTACCAT"	"Cyst.PT"
"CTAGGTAAGGGCCAAT"	"T-cell"
"CTAGGTAGTAGCTGCC"	"T-cell"
"CTAGGTATCAAAGGTA"	"STC_1"
"CTATAGGGTAGTACGG"	"Mono/Mac"
"CTATAGGTCGGATTAC"	"VSMC"
"CTATAGGTCTCGTTTA"	"T-cell"
"CTATCCGAGTTAACAG"	"VSMC"
"CTATCCGGTGTAAACA"	"Cyst.PT"
"CTATCCGGTTACCTGA"	"T-cell"
"CTATCTAAGCTGAAGC"	"PEC"
"CTATCTACACGTACAT"	"STC_1"
"CTATCTAGTCTCGGGT"	"Cyst.LOH,TAL-cell"
"CTATCTAGTGCACAAG"	"CTL/NK-cell"
"CTATCTAGTGGCTGAA"	"Mac"
"CTATCTATCATCTCTA"	"T-cell"
"CTATCTATCCGACGGT"	"Fibroblast"
"CTATCTATCCGGCTTT"	"Cyst.IC-A"
"CTCAAGACATTGCTGA"	"Mono/Mac"
"CTCAAGAGTAGATTAG"	"T-cell"
"CTCAAGAGTCCAACGC"	"EC"
"CTCAAGATCAATCCAG"	"PEC"
"CTCAAGATCTCTCTAA"	"Mono/Mac"
"CTCAATTAGGAGAATG"	"PEC"
"CTCAATTAGTCATCCA"	"STC_1"
"CTCAATTCAAACGTGG"	"T-cell"
"CTCAATTCAATCTCTT"	"T-cell"
"CTCAATTCAGCAATTC"	"T-cell"
"CTCAATTCAGCATGCC"	"T-cell"
"CTCAATTTCCACTAGA"	"T-cell"
"CTCACTGCAACTCCCT"	"Cyst.PT"
"CTCACTGGTAGCACAG"	"Cyst.PT"
"CTCACTGGTTTAAGGA"	"EC"
"CTCACTGTCCTTCACG"	"Mac"
"CTCAGAAAGAGGATGA"	"Cyst.LOH,TAL-cell"
"CTCAGAAAGCATCCCG"	"Cyst.PT"
"CTCAGAAAGCCTTGAT"	"PEC"
"CTCAGAAAGGAATCGC"	"Mac"
"CTCAGAAAGGTTCCAT"	"VSMC"
"CTCAGAACAGGTCAAG"	"STC_1"
"CTCAGAAGTAATACCC"	"VSMC"
"CTCAGAAGTGCTTCAA"	"STC_2"
"CTCAGGGCATGGCACC"	"EC"
"CTCAGGGTCGCTGATA"	"STC_1"
"CTCAGTCAGCAACTTC"	"PEC"
"CTCAGTCCAATACAGA"	"Mono/Mac"
"CTCATCGAGAAGCGGG"	"STC_1"
"CTCATCGGTACGTACT"	"PEC"
"CTCATGCAGTAATTGG"	"Mono/Mac"
"CTCATGCCACTTGGGC"	"T-cell"
"CTCATGCCATCCCGTT"	"Mono/Mac"
"CTCATGCGTGCAATGG"	"VSMC"
"CTCATGCTCAAACGTC"	"STC_1"
"CTCATGCTCCGAGGCT"	"Mono/Mac"
"CTCATTAAGCTGGCCT"	"T-cell"
"CTCATTACAGCCTATA"	"PEC"
"CTCATTAGTGACAGCA"	"EC"
"CTCATTAGTTAGTCGT"	"T-cell"
"CTCATTATCATGGTAC"	"STC_1"
"CTCATTATCTCGACCT"	"STC_1"
"CTCCAACAGGTACATA"	"Mac"
"CTCCAACCACTAACCA"	"PEC"
"CTCCAACCATTAGGCT"	"B-cell"
"CTCCAACGTATTGACC"	"PEC"
"CTCCAACGTTACCTTT"	"Cyst.LOH,TAL-cell"
"CTCCACAAGACTCGAG"	"Mac"
"CTCCACACAATGCAGG"	"VSMC"
"CTCCACACATGATGCT"	"Cyst.LOH,TAL-cell"
"CTCCATGCAGTTTCAG"	"Cyst.LOH,TAL-cell"
"CTCCATGGTAGCGTAG"	"T-cell"
"CTCCATGGTTGTAGCT"	"T-cell"
"CTCCATGTCATTCACT"	"T-cell"
"CTCCCAAAGCGCTGAA"	"PEC"
"CTCCCAAAGGGTCTTT"	"T-cell"
"CTCCCAACAAGCGGAT"	"T-cell"
"CTCCCTCCACTAGGTT"	"Cyst.LOH,TAL-cell"
"CTCCCTCCATCCGTTC"	"T-cell"
"CTCCCTCTCTAGCATG"	"T-cell"
"CTCCCTCTCTTCTAAC"	"T-cell"
"CTCCGATCAGTCCGTG"	"STC_1"
"CTCCGATTCCAACTGA"	"Cyst.IC-A"
"CTCCTCCGTACTGCGC"	"PEC"
"CTCCTCCTCATCCCGT"	"T-cell"
"CTCCTCCTCCACTTTA"	"T-cell"
"CTCCTTTAGGGTAGCT"	"PEC"
"CTCCTTTCAGTGGGTA"	"T-cell"
"CTCCTTTGTAGCTGTT"	"T-cell"
"CTCCTTTGTATACAGA"	"PEC"
"CTCCTTTGTTTACACG"	"VSMC"
"CTCCTTTTCAAATAGG"	"STC_1"
"CTCGAGGGTCATCTAG"	"VSMC"
"CTCGAGGGTCGTATTG"	"PEC"
"CTCGAGGGTGAGGCAT"	"STC_1"
"CTCGAGGTCATTCACT"	"STC_1"
"CTCGAGGTCGTTCATT"	"Cyst.PT"
"CTCTCAGGTTGCCATA"	"Cyst.LOH,TAL-cell"
"CTCTCGACACGGTGTC"	"Mono/Mac"
"CTCTCGACAGCACACC"	"VSMC"
"CTCTCGATCTATGTGG"	"T-cell"
"CTCTGGTAGAGGTCGT"	"Mac"
"CTCTGGTAGTCCTGCG"	"Mono/Mac"
"CTCTGGTCAAGCAATA"	"T-cell"
"CTCTGGTCAAGTACCT"	"PEC"
"CTCTGGTCACGAGGTA"	"VSMC"
"CTGAATGAGATCCGAG"	"EC"
"CTGAATGAGGAAACGA"	"Mac"
"CTGAATGGTCGTTATG"	"Fibroblast"
"CTGAATGTCGCATAGT"	"Cyst.LOH,TAL-cell"
"CTGAGCGAGTTTGCTG"	"PEC"
"CTGAGCGCAGCACGAA"	"Cyst.LOH,TAL-cell"
"CTGAGCGCAGGCACTC"	"VSMC"
"CTGAGCGCATAGGTAA"	"B-cell"
"CTGAGGCAGGACGGAG"	"STC_1"
"CTGAGGCAGTTGGAAT"	"Cyst.PT"
"CTGAGGCCAACGTATC"	"T-cell"
"CTGAGGCCAGAAGCGT"	"STC_1"
"CTGATCCCAGGCTACC"	"Cyst.LOH,TAL-cell"
"CTGATCCGTGTGTCGC"	"PEC"
"CTGATCCTCGGCTGAC"	"PEC"
"CTGCAGGCACGTTGGC"	"T-cell"
"CTGCAGGCAGAATTCC"	"STC_1"
"CTGCAGGGTGGCGCTT"	"Cyst.PT"
"CTGCATCAGGGTACAC"	"Cyst.LOH,TAL-cell"
"CTGCATCAGTCCTACA"	"Cyst.PT"
"CTGCATCCAAGCACCC"	"T-cell"
"CTGCATCGTTGGCCTG"	"Cyst.LOH,TAL-cell"
"CTGCATCTCGATACAC"	"EC"
"CTGCCATAGTAGAGTT"	"VSMC"
"CTGCCATAGTTGCGAG"	"STC_1"
"CTGCCTAAGAATAGTC"	"T-cell"
"CTGCCTAAGACGACTG"	"Cyst.LOH,TAL-cell"
"CTGCCTAAGGGCATGT"	"VSMC"
"CTGCCTATCAAGCCGC"	"STC_1"
"CTGCCTATCCATTTCA"	"T-cell"
"CTGCCTATCTATCCAT"	"Mono/Mac"
"CTGCCTATCTCCGCAT"	"Cyst.PT"
"CTGCGAGGTATTTCTC"	"PEC"
"CTGCGAGTCATTGTGG"	"EC"
"CTGCTCAGTATCCTCC"	"Mac"
"CTGCTCATCAGGAAAT"	"T-cell"
"CTGGACGAGGACATCG"	"Mono/Mac"
"CTGGACGAGGTTAGTA"	"STC_1"
"CTGGACGCATGCCATA"	"VSMC"
"CTGGCAGAGAGAGGTA"	"Cyst.LOH,TAL-cell"
"CTGGCAGCAGTAACGG"	"STC_1"
"CTGGTCTCAACGGCTC"	"B-cell"
"CTGGTCTGTAATGCGG"	"T-cell"
"CTGGTCTGTTCGAAGG"	"T-cell"
"CTGTACCAGAGATCGC"	"T-cell"
"CTGTACCGTAGGCTGA"	"Mono/Mac"
"CTGTACCGTATGATCC"	"VSMC"
"CTGTACCTCCCGTTGT"	"Cyst.LOH,TAL-cell"
"CTGTACCTCGAATGCT"	"Mac"
"CTGTACCTCTCGACCT"	"Mono/Mac"
"CTGTAGAGTATGCGTT"	"Cyst.LOH,TAL-cell"
"CTGTAGAGTCCTATAG"	"T-cell"
"CTGTATTAGTGGTTGG"	"EC"
"CTGTATTCAGACAAAT"	"Cyst.LOH,TAL-cell"
"CTGTATTCATACAGAA"	"Mono/Mac"
"CTGTATTCATGACTAC"	"Cyst.LOH,TAL-cell"
"CTGTATTGTGTGACCC"	"Mono/Mac"
"CTGTATTTCAATCTTC"	"Mac"
"CTGTCGTAGACTGTTC"	"T-cell"
"CTGTCGTAGTACGAGC"	"Cyst.PT"
"CTGTCGTGTCCGGTGT"	"Cyst.LOH,TAL-cell"
"CTGTGAAAGGTACAGC"	"Cyst.PT"
"CTGTGAAGTCTTCCGT"	"Fibroblast"
"CTGTGAATCCATGCAA"	"STC_2"
"CTGTGAATCGCTACAA"	"Cyst.LOH,TAL-cell"
"CTGTGAATCGTTCTCG"	"STC_1"
"CTGTGGGGTTGAGGAC"	"Cyst.LOH,TAL-cell"
"CTGTGGGTCAGTCACA"	"Cyst.LOH,TAL-cell"
"CTTACCGGTGCAACAG"	"T-cell"
"CTTAGGAAGCGACCCT"	"Cyst.LOH,TAL-cell"
"CTTAGGACACAAGTGG"	"Mac"
"CTTAGGATCCGAGCTG"	"PEC"
"CTTCAATAGTGGAAAG"	"Mono/Mac"
"CTTCAATAGTTGAATG"	"T-cell"
"CTTCAATGTCACCCTT"	"T-cell"
"CTTCAATGTGTGACCC"	"CTL/NK-cell"
"CTTCAATGTTTGGCTA"	"T-cell"
"CTTCAATTCCGGTAGC"	"Cyst.PT"
"CTTCCGAGTCACTTCC"	"STC_1"
"CTTCCGAGTCCGACGT"	"Cyst.LOH,TAL-cell"
"CTTCCGATCGGACAAG"	"STC_2"
"CTTCCTTCAAATGCGG"	"Mac"
"CTTCCTTGTCGCATTA"	"T-cell"
"CTTCCTTTCAGGCGAA"	"Cyst.LOH,TAL-cell"
"CTTCCTTTCTGCACCT"	"T-cell"
"CTTCGGTGTCAGTCGC"	"Cyst.PT"
"CTTCGGTGTCGTACAT"	"CTL/NK-cell"
"CTTCTAACAACCCTAA"	"STC_1"
"CTTCTAAGTTGCATTG"	"VSMC"
"CTTGAGAAGCGTCGAA"	"PEC"
"CTTGAGAAGGGTCACA"	"Cyst.PT"
"CTTGAGAGTCAGCGTC"	"Mac"
"CTTGAGATCTCATTTG"	"CTL/NK-cell"
"CTTGATTAGAAGCGAA"	"CTL/NK-cell"
"CTTGATTCATTCCTCG"	"T-cell"
"CTTGATTGTAAGAACT"	"VSMC"
"CTTGATTTCGTCAGAT"	"PEC"
"CTTGATTTCTGTAACG"	"Mac"
"CTTTCAATCAAAGAAC"	"T-cell"
"CTTTCAATCACACCGG"	"Cyst.PT"
"CTTTCAATCCCTCTCC"	"Mast-cell"
"CTTTCAATCGCCTAGG"	"Cyst.PT"
"CTTTCGGAGAATAGTC"	"STC_1"
"CTTTCGGAGATTCGAA"	"Mac"
"CTTTCGGCACCCTTGT"	"Mono/Mac"
"CTTTCGGCAGATCCAT"	"Cyst.PT"
"CTTTCGGTCACCGCTT"	"Mac"
"GAAACCTAGAAGGGAT"	"Mono/Mac"
"GAAACCTCAGGTGGAT"	"T-cell"
"GAAACCTCATCCTTGC"	"B-cell"
"GAAACCTCATCGCCTT"	"Mac"
"GAAACCTTCGCAATGT"	"PEC"
"GAAATGACAAGTTTGC"	"T-cell"
"GAAATGAGTCCGATCG"	"T-cell"
"GAAATGATCAGACCGC"	"T-cell"
"GAACACTAGTCATGGG"	"Cyst.LOH,TAL-cell"
"GAACACTCAAAGCACG"	"Cyst.PT"
"GAACACTCACTCAAGT"	"T-cell"
"GAACACTGTCACATTG"	"Cyst.LOH,TAL-cell"
"GAACACTTCCGATAAC"	"Mono/Mac"
"GAACACTTCGACGAGA"	"STC_1"
"GAACGTTAGACTACCT"	"Mono/Mac"
"GAACGTTAGCTAGAGC"	"Mono/Mac"
"GAACGTTCACAAGCCC"	"Mast-cell"
"GAACGTTCACTGTCCT"	"Mono/Mac"
"GAACGTTGTGTCTTGA"	"VSMC"
"GAACGTTTCATTGAGC"	"T-cell"
"GAACTGTAGAGCAGAA"	"STC_1"
"GAACTGTGTGAGCAGT"	"Mono/Mac"
"GAACTGTGTTATTCTC"	"Mac"
"GAACTGTTCGATTCCC"	"T-cell"
"GAAGAATAGTAACAGT"	"Cyst.IC-A"
"GAAGAATGTTTAAGGA"	"STC_1"
"GAAGAATTCATCGCTC"	"CTL/NK-cell"
"GAAGAATTCGCTTTAT"	"T-cell"
"GAAGAATTCTATACTC"	"VSMC"
"GAAGCCCGTCCTGTTC"	"Cyst.PT"
"GAAGCGACATAGATCC"	"EC"
"GAAGGACAGTCATAGA"	"STC_1"
"GAAGGACTCAAGTGGG"	"Mono/Mac"
"GAAGGACTCATTCACT"	"T-cell"
"GAAGGACTCCATTTCA"	"Cyst.PT"
"GAAGGACTCTGGAAGG"	"Mono/Mac"
"GAAGGGTAGGCCCAAA"	"B-cell"
"GAAGGGTAGTTGAAAC"	"Mac"
"GAAGGGTCATGACAGG"	"Cyst.LOH,TAL-cell"
"GAAGGGTGTATCGTGT"	"Cyst.PT"
"GAAGGGTGTTGTTGAC"	"Cyst.IC-A"
"GAAGGGTTCAGCTGAT"	"T-cell"
"GAAGGGTTCGTTCCTG"	"Cyst.LOH,TAL-cell"
"GAAGTAAAGAGACAAG"	"T-cell"
"GAAGTAACAACAGATA"	"T-cell"
"GAAGTAAGTATGGAGC"	"Cyst.LOH,TAL-cell"
"GAAGTAAGTTCTCCTG"	"CTL/NK-cell"
"GAAGTAAGTTTATGCG"	"T-cell"
"GAAGTAATCGTTGCCT"	"Cyst.LOH,TAL-cell"
"GAAGTAATCTTCGACC"	"VSMC"
"GAATAGACAAAGAACT"	"B-cell"
"GAATAGAGTCACCGCA"	"PEC"
"GAATCACAGCTCCCTT"	"Mono/Mac"
"GAATCACCAACCAGAG"	"Cyst.PT"
"GAATCACCACCAATTG"	"PEC"
"GAATCACGTAGCTTTG"	"EC"
"GAATCGTAGAGTGTTA"	"Cyst.PT"
"GAATCGTAGCGCCGTT"	"B-cell"
"GAATCGTGTCCGCAGT"	"T-cell"
"GACACGCTCTGACCCT"	"T-cell"
"GACAGCCAGAGCAAGA"	"STC_1"
"GACAGCCAGCGCCTCA"	"T-cell"
"GACAGCCCAAGAGAGA"	"CTL/NK-cell"
"GACAGCCTCATTACTC"	"STC_1"
"GACATCACATTGACCA"	"Cyst.PT"
"GACATCAGTATTGAGA"	"T-cell"
"GACATCATCATTATCC"	"Mono/Mac"
"GACATCATCGGTGAAG"	"EC"
"GACCAATAGTAGTCCT"	"Mac"
"GACCAATCACATTACG"	"VSMC"
"GACCAATCACGGTGCT"	"T-cell"
"GACCAATGTAAGGCCA"	"STC_1"
"GACCCAGAGTCATGGG"	"T-cell"
"GACCCAGAGTTACTCG"	"Mast-cell"
"GACCCAGCAACCGCCA"	"Cyst.LOH,TAL-cell"
"GACCCAGCACGCGTGT"	"T-cell"
"GACCCAGGTACCTTCC"	"Mac"
"GACCCTTAGCTCGCAC"	"T-cell"
"GACCCTTAGTCACTCA"	"STC_1"
"GACCCTTCAAGCAATA"	"Cyst.PT"
"GACCCTTCATCTGGGC"	"B-cell"
"GACCCTTTCCAAGAGG"	"T-cell"
"GACCGTGCAACGATTC"	"Cyst.PT"
"GACCGTGGTTCTCGTC"	"Cyst.LOH,TAL-cell"
"GACCGTGTCAGGAGAC"	"VSMC"
"GACCGTGTCATGGAGG"	"Cyst.LOH,TAL-cell"
"GACCGTGTCCATTCAT"	"STC_2"
"GACCTTCAGGGTACAC"	"Cyst.LOH,TAL-cell"
"GACCTTCAGGTTGTTC"	"STC_1"
"GACCTTCAGTGCTCAT"	"T-cell"
"GACCTTCCAACGGTAG"	"T-cell"
"GACCTTCGTTGCTCGG"	"VSMC"
"GACCTTCTCGTAACCA"	"STC_1"
"GACGCTGAGGCACTAG"	"T-cell"
"GACGCTGCAATGCTCA"	"Mac"
"GACGCTGCATGATGCT"	"Mac"
"GACGCTGTCCTAGCTC"	"Fibroblast"
"GACGCTGTCGTCGCTT"	"STC_1"
"GACTATGTCAACTGGT"	"T-cell"
"GACTCAAAGCACTCAT"	"PEC"
"GACTCAACAAGGCGTA"	"Cyst.PT"
"GACTCAACAGATCCTA"	"Cyst.LOH,TAL-cell"
"GACTCAAGTACTAAGA"	"Cyst.LOH,TAL-cell"
"GACTCAAGTTAGAGTA"	"CTL/NK-cell"
"GACTCAATCCATCACC"	"T-cell"
"GACTCAATCGATACAC"	"Mono/Mac"
"GACTCTCAGTCAGCGA"	"CTL/NK-cell"
"GACTCTCCACTACTTT"	"Mac"
"GACTCTCGTACACGTT"	"Mono/Mac"
"GACTCTCTCGTGGCGT"	"Mac"
"GACTGATGTGAGATAT"	"VSMC"
"GACTGATGTTAGGACG"	"Mono/Mac"
"GACTGATTCCCTCGTA"	"Mac"
"GACTGATTCGAGAGCA"	"PEC"
"GACTTCCAGACCCGCT"	"PEC"
"GACTTCCAGATGGTAT"	"T-cell"
"GACTTCCAGTTTCGGT"	"STC_1"
"GACTTCCCAACAGCTT"	"CTL/NK-cell"
"GACTTCCCAGTTCTAG"	"Mono/Mac"
"GACTTCCTCACGATAC"	"PEC"
"GACTTCCTCGAAGCCC"	"VSMC"
"GAGAAATTCACCATAG"	"PEC"
"GAGAAATTCCCAACTC"	"Mac"
"GAGACCCAGCCTCTGG"	"CTL/NK-cell"
"GAGACCCAGCTAGATA"	"VSMC"
"GAGACCCCACCTATCC"	"STC_1"
"GAGACCCCAGAAACCG"	"Mono/Mac"
"GAGACCCGTATCTCTT"	"VSMC"
"GAGACCCGTTGCGTAT"	"STC_1"
"GAGACCCTCTCTCGCA"	"STC_1"
"GAGACTTAGTTCCATG"	"T-cell"
"GAGACTTCAACACTAC"	"VSMC"
"GAGACTTCAGAGAATT"	"STC_1"
"GAGACTTCAGTGACCC"	"STC_1"
"GAGACTTCATGTCGTA"	"STC_1"
"GAGACTTGTCGTACAT"	"STC_1"
"GAGACTTTCCGTATGA"	"Cyst.PT"
"GAGACTTTCGGCGATC"	"CTL/NK-cell"
"GAGAGGTGTATCGTTG"	"T-cell"
"GAGAGGTGTGGGTATG"	"PEC"
"GAGATGGCAGGTCCGT"	"PEC"
"GAGATGGGTGGCACTC"	"Cyst.LOH,TAL-cell"
"GAGATGGTCCTTCACG"	"Cyst.PT"
"GAGATGGTCTGCTAGA"	"Mono/Mac"
"GAGCCTGAGGAGATAG"	"Mac"
"GAGCCTGAGTAAGCAT"	"Cyst.LOH,TAL-cell"
"GAGCCTGGTCATTGCA"	"Fibroblast"
"GAGCCTGGTCCCGGTA"	"Mono/Mac"
"GAGCCTGGTGTGTACT"	"B-cell"
"GAGCTGCAGGAAAGTG"	"PEC"
"GAGCTGCCAGCTACCG"	"STC_1"
"GAGCTGCCATCGGTTA"	"CTL/NK-cell"
"GAGGCAACACCGTGAC"	"T-cell"
"GAGGCAATCGGCATCG"	"VSMC"
"GAGGCAATCTACCCAC"	"Cyst.LOH,TAL-cell"
"GAGGCCTAGCTTTGTG"	"Cyst.PT"
"GAGGCCTAGGGAGATA"	"Cyst.PT"
"GAGGCCTCAAACCGGA"	"EC"
"GAGGCCTGTCATACCA"	"EC"
"GAGGCCTTCCCGAGGT"	"VSMC"
"GAGGCCTTCGAGCCAC"	"Cyst.LOH,TAL-cell"
"GAGGCCTTCTGAGCAT"	"VSMC"
"GAGGCCTTCTGCTTAT"	"STC_1"
"GAGGGATAGGTAGACC"	"PEC"
"GAGGGATTCGCATTAG"	"EC"
"GAGGGATTCTGGTTGA"	"Cyst.PT"
"GAGGGTAAGAGCAGCT"	"Mono/Mac"
"GAGGGTAGTAGTCACT"	"CTL/NK-cell"
"GAGGGTAGTCCGGATC"	"STC_1"
"GAGGGTAGTCGCTTGG"	"EC"
"GAGGGTATCGTGTGAT"	"Cyst.LOH,TAL-cell"
"GAGTCATAGTAAGACT"	"Mono/Mac"
"GAGTCATAGTACCGGA"	"Mac"
"GAGTCATCAAGGGCAT"	"Cyst.LOH,TAL-cell"
"GAGTCATCAGTCAGTT"	"T-cell"
"GAGTCTAAGATGGCGT"	"VSMC"
"GAGTCTAGTTAAACCC"	"CTL/NK-cell"
"GAGTGAGCACCGTGAC"	"VSMC"
"GAGTGAGCATACTTTC"	"CTL/NK-cell"
"GAGTGAGGTCGCTTAA"	"Cyst.LOH,TAL-cell"
"GAGTGAGTCGACACTA"	"CTL/NK-cell"
"GAGTGTTAGACACACG"	"EC"
"GAGTGTTAGATAGGGA"	"T-cell"
"GAGTGTTAGGCATCTT"	"PEC"
"GAGTGTTCAAATACAG"	"T-cell"
"GAGTGTTGTTCAACGT"	"STC_2"
"GAGTGTTTCCCATAAG"	"T-cell"
"GAGTTACCAACTACGT"	"Mac"
"GAGTTACTCGTAATGC"	"Cyst.LOH,TAL-cell"
"GAGTTGTCAATGTCTG"	"Cyst.PT"
"GAGTTGTTCCGACAGC"	"Cyst.PT"
"GAGTTGTTCTCGTCGT"	"T-cell"
"GAGTTTGAGCGACTTT"	"PEC"
"GAGTTTGAGGTAATCA"	"STC_1"
"GAGTTTGCAGAACTTC"	"T-cell"
"GAGTTTGGTCCACTCT"	"PEC"
"GAGTTTGTCTTTCGAT"	"STC_2"
"GATAGAACACATACTG"	"Cyst.PT"
"GATAGAATCACGGTCG"	"Cyst.PT"
"GATAGCTAGCACCCAC"	"Cyst.LOH,TAL-cell"
"GATAGCTAGTATAACG"	"Mac"
"GATAGCTCAATCTCTT"	"Mac"
"GATAGCTGTATGAAGT"	"EC"
"GATAGCTGTTGCATCA"	"T-cell"
"GATCACAAGAGTGTTA"	"STC_1"
"GATCACATCAGAGTTC"	"Cyst.LOH,TAL-cell"
"GATCACATCATGCGGC"	"Mono/Mac"
"GATCAGTCAAATCGGG"	"Cyst.PT"
"GATCAGTGTTGTGGCC"	"Cyst.PT"
"GATCAGTTCACCTCAC"	"Fibroblast"
"GATCAGTTCCTAGCTC"	"Cyst.LOH,TAL-cell"
"GATCAGTTCGCCTTGT"	"EC"
"GATCATGCAAGCAATA"	"Cyst.LOH,TAL-cell"
"GATCATGCACCCTTGT"	"Cyst.PT"
"GATCCCTAGGAGACCT"	"T-cell"
"GATCCCTAGTCTCTGA"	"Cyst.LOH,TAL-cell"
"GATCCCTTCAAACGTC"	"STC_1"
"GATCCCTTCCATAAGC"	"Cyst.PT"
"GATCGTAAGCATCCCG"	"Cyst.LOH,TAL-cell"
"GATCGTAAGGAGATAG"	"T-cell"
"GATCGTACAGAAATTG"	"EC"
"GATCGTAGTATGTCTG"	"T-cell"
"GATCGTAGTTTGTTCT"	"Mac"
"GATCGTATCCAAGCCG"	"T-cell"
"GATCGTATCTAATTCC"	"STC_1"
"GATCGTATCTGTGCTC"	"Cyst.LOH,TAL-cell"
"GATGACTAGGAAGTAG"	"CTL/NK-cell"
"GATGACTCAATACCCA"	"T-cell"
"GATGACTCACACGTGC"	"VSMC"
"GATGAGGGTCACTGAT"	"Cyst.PT"
"GATGAGGTCTACACAG"	"Mono/Mac"
"GATGATCAGCTAAATG"	"Fibroblast"
"GATGATCAGGATTTAG"	"STC_1"
"GATGATCGTGGATACG"	"VSMC"
"GATGATCGTGGCATCC"	"Cyst.PT"
"GATGATCTCAAGGACG"	"VSMC"
"GATGCTAAGTTGCCCG"	"STC_1"
"GATGCTACAGCACAAG"	"T-cell"
"GATGCTAGTACCGTCG"	"Cyst.PT"
"GATGCTAGTTCCGCGA"	"Mono/Mac"
"GATGCTATCGCTCTAC"	"Cyst.IC-A"
"GATGGAGAGACGCTCC"	"Cyst.LOH,TAL-cell"
"GATGGAGAGCTACAAA"	"STC_1"
"GATGGAGAGTATTGCC"	"Cyst.PT"
"GATGGAGCACTGTGAT"	"Cyst.PT"
"GATGGAGGTTAGAGTA"	"Mono/Mac"
"GATGTTGCAATAACCC"	"Cyst.LOH,TAL-cell"
"GATGTTGCACTATCCC"	"T-cell"
"GATGTTGCAGCTTCGG"	"Cyst.LOH,TAL-cell"
"GATGTTGGTAGTATAG"	"PEC"
"GATTCGAAGGCTCTAT"	"T-cell"
"GATTCGAAGTCACACT"	"T-cell"
"GATTCGACATGGGAAC"	"CTL/NK-cell"
"GATTCGAGTTGAGAGC"	"Mono/Mac"
"GATTCGATCAACCTCC"	"Mono/Mac"
"GATTCTTCAAATTAGG"	"EC"
"GATTCTTGTAGGTACG"	"T-cell"
"GATTCTTTCCCAACTC"	"Mac"
"GATTCTTTCGATACAC"	"Cyst.LOH,TAL-cell"
"GATTCTTTCTTCGCTG"	"T-cell"
"GATTGGTAGTAGTCAA"	"Cyst.LOH,TAL-cell"
"GATTGGTCACTCCGGA"	"STC_1"
"GATTGGTTCAGCAATC"	"STC_2"
"GATTGGTTCCCTTCCC"	"Mac"
"GATTGGTTCTCAGTCC"	"Cyst.LOH,TAL-cell"
"GATTTCTGTCGGATTT"	"PEC"
"GCAACATAGCGTTGTT"	"T-cell"
"GCAACATGTTAAGACA"	"PEC"
"GCAACCGAGACAGTCG"	"VSMC"
"GCAACCGAGGGATCAC"	"Cyst.LOH,TAL-cell"
"GCAACCGGTCGACTGC"	"T-cell"
"GCACATAAGTCTAGAA"	"PEC"
"GCACATACAACCCTCT"	"T-cell"
"GCACATACAACGTATC"	"Mono/Mac"
"GCACATACAATGCTCA"	"Cyst.PT"
"GCACATACATCATCCC"	"Mono/Mac"
"GCACATAGTAGAATGT"	"VSMC"
"GCACATAGTGGGTATG"	"Fibroblast"
"GCACATATCGTCTACC"	"T-cell"
"GCACGGTCAATGCAGG"	"STC_1"
"GCACGGTGTCCGCAGT"	"STC_1"
"GCACGTGAGAACAAGG"	"T-cell"
"GCACGTGCAGGCCTGT"	"Mono/Mac"
"GCACGTGTCACCCTGT"	"VSMC"
"GCACGTGTCGGTCGGT"	"Cyst.PT"
"GCACTAAAGCTGTCCG"	"PEC"
"GCACTAAAGGCACAAC"	"Mono/Mac"
"GCACTAACACATTGTG"	"PEC"
"GCACTAACACGGTGCT"	"PEC"
"GCACTAATCGCAAGAG"	"CTL/NK-cell"
"GCACTAATCTGCGATA"	"CTL/NK-cell"
"GCAGCCAAGGCTCACC"	"T-cell"
"GCAGCCACAAAGGCGT"	"T-cell"
"GCAGCCACAACAACAA"	"Mono/Mac"
"GCAGCCAGTGTGTACT"	"T-cell"
"GCAGCCAGTTAAGGGC"	"STC_2"
"GCAGCCATCATGCATG"	"PEC"
"GCAGCTGTCATGCCGG"	"PEC"
"GCAGCTGTCATTCGGA"	"Cyst.PT"
"GCAGCTGTCATTTGGG"	"VSMC"
"GCAGCTGTCCGATAAC"	"STC_1"
"GCAGGCTAGTGGCGAT"	"B-cell"
"GCAGGCTTCGACTCCT"	"Cyst.LOH,TAL-cell"
"GCAGTTACAGCGACCT"	"T-cell"
"GCAGTTAGTACGACAG"	"T-cell"
"GCAGTTATCAGTCATG"	"Cyst.LOH,TAL-cell"
"GCATCGGCAAGCCCAC"	"Cyst.LOH,TAL-cell"
"GCATCGGGTAGATCCT"	"PEC"
"GCATCGGTCGCTTTAT"	"Mono/Mac"
"GCATCTCAGAGTTGAT"	"Fibroblast"
"GCATCTCGTACTCCGG"	"VSMC"
"GCATCTCGTCACGACC"	"Cyst.PT"
"GCATCTCGTTGGCTAT"	"STC_1"
"GCATCTCTCAAGCTTG"	"Cyst.LOH,TAL-cell"
"GCATCTCTCGAACCTA"	"Mac"
"GCATTAGCAAGGTTGG"	"Cyst.PT"
"GCATTAGCATTCCTAT"	"STC_1"
"GCATTAGGTGCGCTCA"	"VSMC"
"GCATTAGGTTGGGAAC"	"T-cell"
"GCCAACGAGCGCTGAA"	"CTL/NK-cell"
"GCCAACGAGGCGACAT"	"Mono/Mac"
"GCCAACGGTAACGGTG"	"CTL/NK-cell"
"GCCAACGGTACGAGTG"	"T-cell"
"GCCAACGGTGGCCTCA"	"T-cell"
"GCCAACGTCGTAGCCG"	"STC_1"
"GCCAACGTCTCAAAGC"	"STC_1"
"GCCAGCAGTCGGTGAA"	"Mac"
"GCCAGCATCCGTCACT"	"Fibroblast"
"GCCAGGTAGCGCGTTC"	"Cyst.LOH,TAL-cell"
"GCCAGGTAGGTTCCAT"	"T-cell"
"GCCAGTGAGAGAGCGG"	"Cyst.LOH,TAL-cell"
"GCCAGTGGTACGCGTC"	"Mast-cell"
"GCCAGTGGTTACCTGA"	"Cyst.PT"
"GCCAGTGGTTCTGACA"	"T-cell"
"GCCAGTGTCACGGACC"	"Mac"
"GCCAGTGTCCTATTGT"	"Cyst.LOH,TAL-cell"
"GCCATGGAGTCCCAAT"	"Cyst.PT"
"GCCATGGCAGCCATTA"	"T-cell"
"GCCATGGGTAGCACGA"	"VSMC"
"GCCATGGGTAGCGTAG"	"T-cell"
"GCCATGGGTCGGAACA"	"VSMC"
"GCCATGGTCGCCATAA"	"PEC"
"GCCATTCAGCGCCCAT"	"T-cell"
"GCCATTCCAGACTCTA"	"Fibroblast"
"GCCATTCTCATTGCTT"	"Cyst.PT"
"GCCCAGAAGTCACTAC"	"T-cell"
"GCCCAGACATCTGCGG"	"Cyst.LOH,TAL-cell"
"GCCCAGAGTACGGCAA"	"EC"
"GCCCGAAAGGCGCTTC"	"Cyst.LOH,TAL-cell"
"GCCCGAAGTATCGATC"	"STC_1"
"GCCGATGCACTACCCT"	"Cyst.IC-A"
"GCCGATGCAGTGTACT"	"Mac"
"GCCGTGAAGAGGATGA"	"STC_2"
"GCCGTGACACAGAGAC"	"Cyst.PT"
"GCCGTGAGTATTTCCT"	"Mac"
"GCCGTGAGTCTACAGT"	"Mono/Mac"
"GCCTGTTCAAGTTCCA"	"Fibroblast"
"GCCTGTTGTCAGACTT"	"PEC"
"GCCTGTTTCTATCACT"	"T-cell"
"GCGAGAAAGGAACTCG"	"T-cell"
"GCGAGAACATCTGTTT"	"Mac"
"GCGAGAAGTATTTCGG"	"Mast-cell"
"GCGATCGAGAGTGACC"	"Cyst.LOH,TAL-cell"
"GCGATCGAGTGAGTGC"	"Mac"
"GCGATCGCAACAACAA"	"PEC"
"GCGATCGTCAAGGCTT"	"VSMC"
"GCGGAAAAGGAAGTCC"	"STC_1"
"GCGGAAACACACGCCA"	"Cyst.LOH,TAL-cell"
"GCGGAAATCATGAGTC"	"Cyst.PT"
"GCGGAAATCGTTGTGA"	"STC_1"
"GCGGATCAGCCAGTAG"	"Mono/Mac"
"GCGGATCCACCGCTAG"	"Cyst.LOH,TAL-cell"
"GCGTGCATCCTATTGT"	"EC"
"GCGTTTCCAAGCACCC"	"T-cell"
"GCGTTTCCACAGAGCA"	"STC_1"
"GCGTTTCGTCAACATC"	"Fibroblast"
"GCGTTTCGTGAGTAGC"	"Cyst.LOH,TAL-cell"
"GCTACAATCGTTAGAC"	"Cyst.PT"
"GCTACCTCACGACCTG"	"PEC"
"GCTACCTGTCATAACC"	"STC_1"
"GCTACCTGTGTAGCAG"	"T-cell"
"GCTACCTGTTCCACGG"	"STC_1"
"GCTACCTTCGGAAACG"	"STC_1"
"GCTCAAACACTCCGAG"	"Cyst.LOH,TAL-cell"
"GCTCAAACAGAGAATT"	"Cyst.PT"
"GCTCAAAGTCCTTTGC"	"Cyst.PT"
"GCTCAAAGTCTTAGTG"	"VSMC"
"GCTCAAAGTTTACTGG"	"Cyst.PT"
"GCTCAAATCGACCCAG"	"PEC"
"GCTGAATAGACCATGG"	"B-cell"
"GCTGCAGAGAGTATAC"	"T-cell"
"GCTGCAGAGGTCATCT"	"Cyst.PT"
"GCTGCAGTCCAAGGGA"	"STC_1"
"GCTGGGTGTATGCAAA"	"T-cell"
"GCTGGGTTCCAGCAAT"	"EC"
"GCTGGGTTCCCTTGGT"	"PEC"
"GCTGGGTTCTTCGTGC"	"Cyst.PT"
"GCTTCACAGATGCAGC"	"VSMC"
"GCTTCACAGATGTTCC"	"Mast-cell"
"GCTTCACAGGCCTTGC"	"T-cell"
"GCTTCACCACACGTGC"	"Mono/Mac"
"GCTTCACCAGACGGAT"	"STC_1"
"GCTTCACGTTAGCGGA"	"Cyst.LOH,TAL-cell"
"GCTTCACGTTTACTGG"	"Cyst.LOH,TAL-cell"
"GCTTCACTCTGCGGAC"	"PEC"
"GCTTCACTCTTACCGC"	"EC"
"GCTTGGGAGACCATAA"	"STC_1"
"GCTTGGGCAATAGTAG"	"Mono/Mac"
"GCTTGGGGTGCGTTTA"	"Cyst.PT"
"GCTTGGGTCTTAGTTC"	"VSMC"
"GCTTTCGAGAGTTCGG"	"T-cell"
"GCTTTCGCAGGTTACT"	"PEC"
"GCTTTCGGTCAAATCC"	"Mono/Mac"
"GGAACCCGTCAAAGAT"	"T-cell"
"GGAACCCGTGAATGAT"	"Mac"
"GGAACCCTCTCGGGAC"	"CTL/NK-cell"
"GGAAGTGCACCAATTG"	"EC"
"GGAAGTGGTCACAGTT"	"EC"
"GGAAGTGTCTGCACCT"	"T-cell"
"GGAATCTAGCCGAACA"	"Cyst.PT"
"GGAATCTCATTGAGCT"	"STC_1"
"GGAATCTTCTCCGAAA"	"T-cell"
"GGAATGGAGCTAGTTC"	"Mast-cell"
"GGAATGGCAGACGCTC"	"VSMC"
"GGAATGGGTGCCAAGA"	"PEC"
"GGAATGGTCCACTGAA"	"Cyst.LOH,TAL-cell"
"GGACGTCAGAGGTATT"	"Cyst.LOH,TAL-cell"
"GGACGTCCACTCTAGA"	"VSMC"
"GGACGTCCAGGCTCTG"	"PEC"
"GGACGTCCATGAGGGT"	"CTL/NK-cell"
"GGACGTCTCTCGGCTT"	"Mac"
"GGAGAACAGCTCTTCC"	"STC_1"
"GGAGAACCAGCTTTCC"	"VSMC"
"GGAGAACGTACCGGAA"	"Mac"
"GGAGAACGTCGCATTA"	"STC_1"
"GGAGAACGTGACTAAA"	"EC"
"GGAGATGCAATAGTAG"	"CTL/NK-cell"
"GGAGATGGTTCATCTT"	"Cyst.LOH,TAL-cell"
"GGAGATGTCCACCCTA"	"T-cell"
"GGAGATGTCCCAGGCA"	"Mono/Mac"
"GGAGCAAAGGTCACAG"	"T-cell"
"GGAGCAACACTCTAGA"	"Cyst.LOH,TAL-cell"
"GGAGCAACATGGAGAC"	"Cyst.LOH,TAL-cell"
"GGAGCAATCCTCGCAT"	"Cyst.LOH,TAL-cell"
"GGAGCAATCCTGTACC"	"STC_1"
"GGAGGATAGCCGATTT"	"T-cell"
"GGAGGATCACGAAGAC"	"Mono/Mac"
"GGAGGATCACGCAGTC"	"VSMC"
"GGAGGATCATAGAAAC"	"Cyst.LOH,TAL-cell"
"GGAGGATCATCCTAAG"	"T-cell"
"GGAGGATCATGACTCA"	"Cyst.LOH,TAL-cell"
"GGAGGATGTCTGTGGC"	"VSMC"
"GGAGGATGTCTTCGAA"	"Cyst.PT"
"GGAGGATTCAAATGCC"	"Mono/Mac"
"GGAGGTAAGAAGCCTG"	"Mac"
"GGAGGTATCGATTGGT"	"STC_1"
"GGAGGTATCTCATTGT"	"CTL/NK-cell"
"GGATCTAAGAATACAC"	"Cyst.PT"
"GGATCTACAGAACTAA"	"VSMC"
"GGATCTAGTACCCGCA"	"T-cell"
"GGATCTAGTCGGTGTC"	"EC"
"GGATGTTCAGGAGGTT"	"B-cell"
"GGATGTTCATTGGCAT"	"Cyst.LOH,TAL-cell"
"GGATGTTGTTTCCAAG"	"STC_1"
"GGCACGTAGGCTTCCG"	"VSMC"
"GGCACGTAGTCTCTGA"	"Cyst.LOH,TAL-cell"
"GGCACGTAGTGTGTTC"	"Cyst.LOH,TAL-cell"
"GGCACGTCACCTCTGT"	"Cyst.PT"
"GGCACGTTCGGTAGAG"	"Fibroblast"
"GGCAGTCCACAGTCCG"	"PEC"
"GGCAGTCGTAGTGATA"	"STC_1"
"GGCAGTCGTATCCTCC"	"VSMC"
"GGCAGTCGTTCCTAGA"	"Mono/Mac"
"GGCGTCACAACCGATT"	"Cyst.PT"
"GGCGTCACAATTTCGG"	"Mono/Mac"
"GGCGTCACAGTCCGTG"	"Cyst.LOH,TAL-cell"
"GGCGTCAGTGGCACTC"	"Cyst.LOH,TAL-cell"
"GGCTGTGCACCTTCCA"	"Cyst.LOH,TAL-cell"
"GGCTGTGGTAGAATAC"	"STC_1"
"GGCTTGGAGCTGTTCA"	"VSMC"
"GGCTTGGTCCATCAGA"	"Mac"
"GGCTTTCAGAGGGTAA"	"Mono/Mac"
"GGCTTTCAGAGTCACG"	"CTL/NK-cell"
"GGCTTTCGTACCATAC"	"Mac"
"GGCTTTCTCTAGTTCT"	"T-cell"
"GGCTTTCTCTATCGGA"	"Mac"
"GGGAAGTTCATCGCAA"	"Mono/Mac"
"GGGAAGTTCTCTGAGA"	"Cyst.PT"
"GGGAAGTTCTTGAGCA"	"Cyst.LOH,TAL-cell"
"GGGACAAAGCACTGGA"	"VSMC"
"GGGACAACACCACTGG"	"Cyst.PT"
"GGGACCTAGTTACGGG"	"VSMC"
"GGGACCTCATAGCTGT"	"STC_1"
"GGGACCTTCTAGTGTG"	"T-cell"
"GGGACTCCACCTCTAC"	"Mac"
"GGGACTCCACGACGTC"	"Cyst.PT"
"GGGACTCCAGCTGCCA"	"VSMC"
"GGGACTCTCCTAGAGT"	"STC_1"
"GGGACTCTCGGCTGGT"	"PEC"
"GGGAGATCATGTGTCA"	"STC_1"
"GGGAGATGTATACAGA"	"Cyst.LOH,TAL-cell"
"GGGAGATGTTCAGCGC"	"Mac"
"GGGAGATTCCTTTAGT"	"Mac"
"GGGAGATTCGGATACT"	"VSMC"
"GGGAGTAAGATGGTCG"	"Cyst.LOH,TAL-cell"
"GGGAGTACAAGTGACG"	"STC_1"
"GGGAGTAGTAGCTGTT"	"Cyst.PT"
"GGGATCCCACTCAAGT"	"VSMC"
"GGGATGAAGCTGTTCA"	"Cyst.LOH,TAL-cell"
"GGGATGACATCCTATT"	"T-cell"
"GGGATGATCAAAGCCT"	"Mono/Mac"
"GGGCCATCAATGTTGC"	"Cyst.PT"
"GGGCGTTAGGTCCTGC"	"EC"
"GGGCGTTCAGGCTATT"	"Mac"
"GGGCTACAGCTGACTT"	"STC_1"
"GGGCTACCAACCGGAA"	"T-cell"
"GGGCTACCAGGCTCTG"	"Mono/Mac"
"GGGCTACGTAACTAAG"	"T-cell"
"GGGCTACGTTTCGACA"	"Cyst.PT"
"GGGCTACTCCTCTCGA"	"T-cell"
"GGGCTCAAGCATCCTA"	"STC_1"
"GGGCTCAAGTATGAGT"	"T-cell"
"GGGCTCACAATAGGAT"	"Cyst.LOH,TAL-cell"
"GGGCTCACAGCTATAC"	"VSMC"
"GGGCTCACAGTTGGTT"	"Cyst.LOH,TAL-cell"
"GGGCTCAGTAACGCGA"	"EC"
"GGGCTCATCGAGATGG"	"T-cell"
"GGGTAGAAGTTTGGCT"	"EC"
"GGGTAGATCATTTGGG"	"Mono/Mac"
"GGGTAGATCGTGAGAG"	"VSMC"
"GGGTATTCAAGTTCCA"	"PEC"
"GGGTATTGTACAGCGA"	"VSMC"
"GGGTATTGTGGATTTC"	"STC_1"
"GGGTATTTCTATCGCC"	"PEC"
"GGGTATTTCTCCGAGG"	"Mono/Mac"
"GGGTCACAGATCCCGC"	"VSMC"
"GGGTCACCATTCGATG"	"B-cell"
"GGGTCACTCATCACAG"	"Mono/Mac"
"GGGTCACTCTAGGAAA"	"VSMC"
"GGGTCACTCTTTGCTA"	"Cyst.PT"
"GGGTCTGAGGCAGGTT"	"PEC"
"GGGTCTGCACGACGTC"	"STC_1"
"GGGTCTGGTTCGGTAT"	"CTL/NK-cell"
"GGGTGAAAGCCGAATG"	"CTL/NK-cell"
"GGGTGTCGTAATCAAG"	"B-cell"
"GGGTTATTCGGAGTGA"	"STC_1"
"GGGTTTACAGCGGTTC"	"Cyst.LOH,TAL-cell"
"GGGTTTAGTAATTGGA"	"Cyst.PT"
"GGGTTTAGTTTCCATT"	"CTL/NK-cell"
"GGGTTTATCGCTAGCG"	"Cyst.PT"
"GGGTTTATCTTAGGAC"	"Cyst.PT"
"GGTAACTAGAGAGAAC"	"Cyst.LOH,TAL-cell"
"GGTAACTCACCCTGAG"	"Mono/Mac"
"GGTAACTGTGCCCGTA"	"T-cell"
"GGTAATCAGGGTATAT"	"B-cell"
"GGTAATCCACAACCGC"	"T-cell"
"GGTAATCCACACCTTC"	"CTL/NK-cell"
"GGTAATCTCCCTTCCC"	"CTL/NK-cell"
"GGTAGAGAGCCTCGTG"	"Mono/Mac"
"GGTAGAGAGGTTATAG"	"Mono/Mac"
"GGTAGAGGTCATCTAG"	"B-cell"
"GGTAGAGTCACCATCC"	"VSMC"
"GGTCACGAGCTGCCTG"	"T-cell"
"GGTCACGAGTCGCTAT"	"Fibroblast"
"GGTCACGCACTAAACC"	"Cyst.PT"
"GGTCACGGTAGGGTAC"	"PEC"
"GGTCACGGTCCAACGC"	"Mac"
"GGTCACGTCCCGAGGT"	"Fibroblast"
"GGTCTGGGTCCGGATC"	"EC"
"GGTCTGGTCAGTGATC"	"Fibroblast"
"GGTGAAGCACGTAGTT"	"CTL/NK-cell"
"GGTGAAGCAGAGGGTT"	"Mast-cell"
"GGTGAAGCAGGAATCG"	"VSMC"
"GGTGAAGGTATTAAGG"	"CTL/NK-cell"
"GGTGATTAGCATAGGC"	"T-cell"
"GGTGATTCAGTACTAC"	"Cyst.LOH,TAL-cell"
"GGTGATTGTAGGGTAC"	"VSMC"
"GGTGATTTCAGGACGA"	"VSMC"
"GGTGGCTCAACTGCTA"	"T-cell"
"GGTGTCGAGGGATGTC"	"VSMC"
"GGTGTCGCAAACGTGG"	"STC_1"
"GGTGTCGTCAGAATAG"	"T-cell"
"GGTGTCGTCGCCATAA"	"Cyst.PT"
"GGTGTTAAGTCGTTAC"	"Mac"
"GGTGTTACAACCAACT"	"Cyst.LOH,TAL-cell"
"GGTGTTACACTAACGT"	"Fibroblast"
"GGTGTTACAGGTTCCG"	"B-cell"
"GGTGTTACAGTGTACT"	"EC"
"GGTGTTAGTAGTATAG"	"Cyst.PT"
"GGTTAACGTTGTGTAC"	"STC_1"
"GGTTAACGTTTATGCG"	"T-cell"
"GGTTCTCAGCTCGTGC"	"PEC"
"GGTTCTCAGTGGATAT"	"T-cell"
"GGTTCTCCATCCTATT"	"VSMC"
"GGTTCTCGTTCTCTCG"	"Cyst.PT"
"GGTTCTCTCACGTCCT"	"Cyst.LOH,TAL-cell"
"GGTTCTCTCGTCGACG"	"STC_1"
"GGTTGTACAGGAGGTT"	"EC"
"GGTTGTACATGGTACT"	"Cyst.LOH,TAL-cell"
"GGTTGTAGTGATACCT"	"Mac"
"GGTTGTATCTCGACGG"	"Mac"
"GTAACACTCGCACGGT"	"Cyst.PT"
"GTAACCAAGCCTCAGC"	"Mono/Mac"
"GTAACCACAGCTATTG"	"T-cell"
"GTAATCGCACTCCCTA"	"CTL/NK-cell"
"GTAATCGCAGAGATTA"	"Mono/Mac"
"GTAATCGGTAGATTGA"	"Cyst.LOH,TAL-cell"
"GTAATCGGTCGTGCCA"	"STC_1"
"GTAATCGTCCATGATG"	"PEC"
"GTAATCGTCTAGGCAT"	"T-cell"
"GTAATGCAGGCCTGCT"	"T-cell"
"GTAATGCCAGCTTTGA"	"Cyst.PT"
"GTAATGCCAGTCGGAA"	"Cyst.PT"
"GTAATGCCAGTGCGCT"	"T-cell"
"GTAATGCGTAGCTTAC"	"STC_2"
"GTAATGCTCATGGATC"	"PEC"
"GTAATGCTCCACAGGC"	"Cyst.PT"
"GTAATGCTCTCCAAGA"	"Cyst.PT"
"GTAATGCTCTTGGTGA"	"STC_1"
"GTACAACGTGGGTTGA"	"VSMC"
"GTACAACGTTTCGATG"	"PEC"
"GTACAACTCCTTATAC"	"Cyst.PT"
"GTACAGTAGAGTAACT"	"T-cell"
"GTACAGTAGGGATCGT"	"PEC"
"GTACAGTGTACTGAGG"	"Cyst.PT"
"GTACAGTTCATCGCCT"	"T-cell"
"GTACAGTTCCTCTAGC"	"VSMC"
"GTACAGTTCCTGTTGC"	"T-cell"
"GTAGAAACAAGAATGT"	"STC_1"
"GTAGAAAGTGGGTCAA"	"VSMC"
"GTAGAGGCATCATCCC"	"VSMC"
"GTAGAGGGTACCAGAG"	"VSMC"
"GTAGAGGTCTACTGAG"	"PEC"
"GTAGAGGTCTCCCAAC"	"Mast-cell"
"GTAGATCAGAGGCTGT"	"Cyst.LOH,TAL-cell"
"GTAGATCAGGTTCCAT"	"VSMC"
"GTAGATCCACGCCAGT"	"Mac"
"GTAGATCCAGCAGAAC"	"Cyst.LOH,TAL-cell"
"GTAGATCCAGTTTCGA"	"T-cell"
"GTAGCTAGTGAATAAC"	"Mac"
"GTAGCTATCCCATAAG"	"Cyst.LOH,TAL-cell"
"GTAGCTATCCGTATGA"	"T-cell"
"GTAGCTATCCGTGTCT"	"Cyst.LOH,TAL-cell"
"GTAGCTATCGATCCAA"	"Cyst.LOH,TAL-cell"
"GTAGGAGCAATAGGGC"	"Mono/Mac"
"GTAGGAGCATGTCTAG"	"Mac"
"GTAGGAGGTAGAGACC"	"EC"
"GTAGGAGGTGTACATC"	"Mac"
"GTAGGAGTCATCGCTC"	"T-cell"
"GTAGGTTCACTTGTCC"	"Cyst.LOH,TAL-cell"
"GTAGTACAGCTCGACC"	"STC_1"
"GTAGTACAGGGTGGGA"	"Mono/Mac"
"GTAGTACCAATCCTTT"	"Cyst.LOH,TAL-cell"
"GTAGTACCACCGTGAC"	"PEC"
"GTAGTACGTCGTCAGC"	"Cyst.LOH,TAL-cell"
"GTATTGGAGCAACCAG"	"PEC"
"GTATTGGAGCGACAGT"	"STC_2"
"GTATTGGAGGTATCTC"	"VSMC"
"GTATTGGGTCGACTTA"	"STC_2"
"GTATTGGTCCTCATAT"	"VSMC"
"GTATTGGTCTAGCAAC"	"Mac"
"GTATTTCAGTAGAGTT"	"VSMC"
"GTATTTCCATCCCGTT"	"Cyst.PT"
"GTATTTCGTAAGCTCT"	"Cyst.PT"
"GTATTTCGTACCCAGC"	"PEC"
"GTATTTCGTACGATTC"	"T-cell"
"GTATTTCGTGCAACAG"	"STC_2"
"GTATTTCTCGCCAGTG"	"CTL/NK-cell"
"GTATTTCTCGGTCTAA"	"T-cell"
"GTCAAACAGAACGCGT"	"Mac"
"GTCAAACAGTCCGCCA"	"T-cell"
"GTCAAACCAGCAATTC"	"Cyst.LOH,TAL-cell"
"GTCAAGTAGGCACCAA"	"Cyst.LOH,TAL-cell"
"GTCAAGTCAGAGTGAC"	"Mac"
"GTCAAGTTCACCTACC"	"VSMC"
"GTCAAGTTCGGCTTGG"	"Cyst.PT"
"GTCACGGCACTCACTC"	"Cyst.LOH,TAL-cell"
"GTCACGGGTACCACGC"	"PEC"
"GTCACGGGTCAGCGTC"	"STC_1"
"GTCACGGTCCACTGAA"	"Cyst.PT"
"GTCACGGTCGGTAGGA"	"Cyst.LOH,TAL-cell"
"GTCACTCAGCCAGTAG"	"T-cell"
"GTCACTCGTGGAAGTC"	"Cyst.LOH,TAL-cell"
"GTCACTCGTGTCCACG"	"Cyst.PT"
"GTCACTCTCATGCCGG"	"PEC"
"GTCAGCGAGCTGTTAC"	"Cyst.PT"
"GTCAGCGAGGGTCAAC"	"VSMC"
"GTCAGCGCACAAGCCC"	"T-cell"
"GTCAGCGCAGGCAATG"	"VSMC"
"GTCAGCGCAGTAGGAC"	"B-cell"
"GTCAGCGGTATGAGGC"	"T-cell"
"GTCAGCGTCCACCTCA"	"Cyst.LOH,TAL-cell"
"GTCATCCAGAACGTGC"	"Mono/Mac"
"GTCATCCAGTGAGCCA"	"VSMC"
"GTCATCCTCCATTTCA"	"Mast-cell"
"GTCATCCTCCGCTAGG"	"T-cell"
"GTCATGAAGCCTGACC"	"CTL/NK-cell"
"GTCATGAAGTTGTACC"	"T-cell"
"GTCATGATCCATTGTT"	"Cyst.PT"
"GTCATTTAGACATCCT"	"Cyst.PT"
"GTCATTTAGGGTAGCT"	"T-cell"
"GTCATTTCAAGTATCC"	"VSMC"
"GTCATTTCAATCTAGC"	"Cyst.PT"
"GTCATTTCAGCAGTAG"	"T-cell"
"GTCATTTCAGTAGAAT"	"Mac"
"GTCATTTGTTGGCCGT"	"EC"
"GTCCACTAGCACTAGG"	"STC_1"
"GTCCACTCATGACTTG"	"Mac"
"GTCCACTCATTAAGCC"	"Cyst.LOH,TAL-cell"
"GTCCACTTCATCGCTC"	"Cyst.PT"
"GTCCACTTCCCGAGGT"	"T-cell"
"GTCCACTTCGAGGCAA"	"Mac"
"GTCCACTTCGTGCATA"	"Mono/Mac"
"GTCCCATGTACCCACG"	"Cyst.PT"
"GTCCCATGTGACTATC"	"Cyst.PT"
"GTCCTCAAGATTAGCA"	"T-cell"
"GTCCTCAGTACGGTTT"	"CTL/NK-cell"
"GTCCTCATCCATCCGT"	"T-cell"
"GTCGAATCAACAAGAT"	"STC_1"
"GTCGAATCACGCCACA"	"Cyst.PT"
"GTCGAATTCACTGGGC"	"STC_2"
"GTCGAATTCCGGCAAC"	"Cyst.LOH,TAL-cell"
"GTCGCGAAGCAGCCTC"	"Mono/Mac"
"GTCGCGAAGCCGCTTG"	"T-cell"
"GTCGCGATCAATCTCT"	"STC_1"
"GTCGTAAAGATCGCCC"	"Mono/Mac"
"GTCGTAAAGTAACAGT"	"Cyst.LOH,TAL-cell"
"GTCGTAAGTTGTCAGT"	"VSMC"
"GTCGTAATCATCGCAA"	"T-cell"
"GTCGTTCAGGTTACCT"	"T-cell"
"GTCGTTCGTAACGTTC"	"Mono/Mac"
"GTCGTTCGTGCTGCAC"	"CTL/NK-cell"
"GTCGTTCTCACATCAG"	"STC_1"
"GTCGTTCTCGTTCTCG"	"CTL/NK-cell"
"GTCTACCAGACTACGG"	"T-cell"
"GTCTACCAGCGAAACC"	"Cyst.PT"
"GTCTACCCAAGGACAC"	"STC_1"
"GTCTACCCACTGTCGG"	"T-cell"
"GTCTACCGTGACCGAA"	"T-cell"
"GTCTACCGTGCGACAA"	"VSMC"
"GTCTACCGTTAAACAG"	"Mono/Mac"
"GTCTACCTCATCCCGT"	"CTL/NK-cell"
"GTCTAGAAGGCCTGAA"	"Mono/Mac"
"GTCTAGAGTAAGTCAA"	"Mac"
"GTCTAGAGTGTTCCAA"	"PEC"
"GTCTCACAGCCTTCTC"	"CTL/NK-cell"
"GTCTCACCATTGCTGA"	"Cyst.PT"
"GTCTCACGTAAGGCCA"	"VSMC"
"GTCTCACGTCAGCTTA"	"EC"
"GTCTCACGTTGCTTGA"	"STC_2"
"GTCTCACTCTGACCCT"	"T-cell"
"GTCTGTCAGACGAAGA"	"T-cell"
"GTCTGTCAGTGGCGAT"	"T-cell"
"GTCTGTCCAAAGCAAT"	"Mono/Mac"
"GTCTGTCGTCAACATC"	"T-cell"
"GTCTGTCTCGACCCAG"	"Cyst.PT"
"GTCTGTCTCGTCTAAG"	"Cyst.LOH,TAL-cell"
"GTCTGTCTCTAGGCCG"	"Mono/Mac"
"GTCTTTAAGTGTCATC"	"Cyst.LOH,TAL-cell"
"GTCTTTACATGTACGT"	"T-cell"
"GTCTTTATCACCCTGT"	"T-cell"
"GTCTTTATCCGAGGCT"	"EC"
"GTGACGCAGGACAGTC"	"VSMC"
"GTGACGCAGTAATTGG"	"STC_2"
"GTGACGCGTATCTCTT"	"T-cell"
"GTGACGCTCACACCGG"	"CTL/NK-cell"
"GTGAGCCAGATCCCAT"	"T-cell"
"GTGAGCCAGATGTTCC"	"Cyst.PT"
"GTGAGCCCAAGACCGA"	"STC_1"
"GTGAGCCGTCACGTGC"	"CTL/NK-cell"
"GTGAGGAAGTGCACCC"	"VSMC"
"GTGAGGATCCTTACCG"	"T-cell"
"GTGAGTTCATCTCAAG"	"T-cell"
"GTGAGTTGTCTCGGGT"	"T-cell"
"GTGAGTTGTTACCGTA"	"T-cell"
"GTGAGTTGTTGTCTAG"	"B-cell"
"GTGAGTTTCCACCTGT"	"Cyst.LOH,TAL-cell"
"GTGATGTCAATAACGA"	"PEC"
"GTGATGTCATGTACGT"	"Mono/Mac"
"GTGATGTGTACCTAAC"	"T-cell"
"GTGATGTTCCTTCTTC"	"Cyst.LOH,TAL-cell"
"GTGCACGAGTCATCGT"	"Cyst.LOH,TAL-cell"
"GTGCACGCATGTTCGA"	"Mono/Mac"
"GTGCACGGTCCGTTTC"	"PEC"
"GTGCACGTCATTATCC"	"Mast-cell"
"GTGCACGTCGTCCTCA"	"Fibroblast"
"GTGCAGCAGCCGTAAG"	"PEC"
"GTGCAGCGTTATAGAG"	"STC_1"
"GTGCAGCTCATGGTAC"	"CTL/NK-cell"
"GTGCAGCTCCCTCGAT"	"T-cell"
"GTGCGTGAGAGCCTGA"	"T-cell"
"GTGCGTGCAGCTATAC"	"Cyst.LOH,TAL-cell"
"GTGCGTGCATTAGGCT"	"CTL/NK-cell"
"GTGCGTGTCGCTGATA"	"Mono/Mac"
"GTGCTGGAGCTCGAAG"	"PEC"
"GTGCTGGAGGGAGGCA"	"Cyst.LOH,TAL-cell"
"GTGCTGGCACTAACGT"	"STC_1"
"GTGCTGGGTTAGAAAC"	"Cyst.LOH,TAL-cell"
"GTGCTGGTCTTGGATG"	"STC_1"
"GTGCTTCCAGAAGCTG"	"Cyst.LOH,TAL-cell"
"GTGCTTCTCTCGCGTT"	"Mono/Mac"
"GTGGAAGCAGCATTGT"	"Mac"
"GTGGAGAGTATCTCGA"	"Mac"
"GTGGAGATCATCCTAT"	"Mast-cell"
"GTGGCGTAGCCACCGT"	"Mono/Mac"
"GTGGCGTAGCGTGAGT"	"STC_1"
"GTGGCGTAGCTCTGTA"	"Mono/Mac"
"GTGGCGTCATGACTCA"	"STC_1"
"GTGGGAAAGGATTTCC"	"Mac"
"GTGGGAACAGCTGTAT"	"Cyst.PT"
"GTGGGAAGTTCGTTCC"	"T-cell"
"GTGGGAATCTCGCAGG"	"Cyst.LOH,TAL-cell"
"GTGGTTACAGAAATTG"	"Cyst.LOH,TAL-cell"
"GTGGTTACAGTCAGTT"	"PEC"
"GTGTAACAGCCTCTGG"	"EC"
"GTGTAACCAGAATCGG"	"PEC"
"GTGTAACGTACGAAAT"	"Mac"
"GTGTAACGTGTAACGG"	"Cyst.PT"
"GTGTAACGTTCCGGTG"	"Mono/Mac"
"GTGTCCTAGAGGATGA"	"VSMC"
"GTGTCCTAGTGCTAGG"	"Mono/Mac"
"GTGTCCTCAACGTAAA"	"Cyst.LOH,TAL-cell"
"GTGTCCTCACGAAGAC"	"Mono/Mac"
"GTGTCCTTCACCCATC"	"Cyst.LOH,TAL-cell"
"GTGTGATCATATCGGT"	"T-cell"
"GTGTGGCAGGGTAGCT"	"T-cell"
"GTGTGGCCAGAGTAAT"	"STC_1"
"GTGTGGCTCAATCTCT"	"CTL/NK-cell"
"GTGTTAGAGGGTTGCA"	"Mono/Mac"
"GTGTTAGCAGCCTACG"	"T-cell"
"GTGTTAGGTGTTAAAG"	"VSMC"
"GTGTTCCAGTCTGGAG"	"T-cell"
"GTGTTCCCAGGGTCTC"	"Mac"
"GTGTTCCCATGTGGTT"	"VSMC"
"GTGTTCCGTAACACGG"	"CTL/NK-cell"
"GTGTTCCGTGTCTAAC"	"STC_1"
"GTTACAGAGCACTGGA"	"Mac"
"GTTACAGAGGAGAATG"	"PEC"
"GTTACAGCACGACGAA"	"Mono/Mac"
"GTTACAGCATTCTTCA"	"T-cell"
"GTTACAGGTTGACTAC"	"PEC"
"GTTACCCAGACTAAGT"	"T-cell"
"GTTACCCAGTAAGACT"	"STC_2"
"GTTACCCCAACGGCCT"	"PEC"
"GTTACCCGTCTGTTAG"	"EC"
"GTTACCCGTGCCCACA"	"Mast-cell"
"GTTACCCGTTGCGGAA"	"T-cell"
"GTTACCCTCCTGTTAT"	"Cyst.LOH,TAL-cell"
"GTTACGAAGATACATG"	"VSMC"
"GTTACGACATCCGAAT"	"STC_1"
"GTTACGATCCCATAAG"	"STC_2"
"GTTACGATCGGTGTTA"	"Mast-cell"
"GTTAGACGTCGCACAC"	"Mono/Mac"
"GTTAGACTCTAGGCAT"	"STC_1"
"GTTAGTGAGCAAGTCG"	"Mono/Mac"
"GTTAGTGCAATCGAAA"	"CTL/NK-cell"
"GTTAGTGCAATGACCT"	"VSMC"
"GTTAGTGGTGCCTATA"	"Fibroblast"
"GTTAGTGTCTGACGCG"	"B-cell"
"GTTATGGAGCTACAAA"	"PEC"
"GTTATGGGTATCGAGG"	"VSMC"
"GTTATGGGTGAATAAC"	"T-cell"
"GTTATGGGTTACGATC"	"Cyst.PT"
"GTTCATTAGTCCTACA"	"T-cell"
"GTTCATTAGTGCGACA"	"T-cell"
"GTTCATTCATTGCTTT"	"CTL/NK-cell"
"GTTCATTTCGGATAAA"	"T-cell"
"GTTCATTTCGTCCTCA"	"STC_1"
"GTTCCGTCAGGAGACT"	"T-cell"
"GTTCCGTTCGCAACAT"	"EC"
"GTTCGCTAGAGTTGTA"	"EC"
"GTTCGCTCACTGCATA"	"Cyst.PT"
"GTTCGCTGTGTTCAGT"	"PEC"
"GTTCTATCACGCTGTG"	"PEC"
"GTTCTATGTACAGGTG"	"Mono/Mac"
"GTTCTATGTAGATTAG"	"Mac"
"GTTCTATGTCCTACGG"	"T-cell"
"GTTCTATGTTTGATCG"	"VSMC"
"GTTCTATTCCCTATTA"	"Cyst.PT"
"GTTCTATTCCTACTGC"	"PEC"
"GTTGAACAGCTGAGCA"	"VSMC"
"GTTGAACAGGATACCG"	"Cyst.LOH,TAL-cell"
"GTTGAACCAACACGTT"	"Fibroblast"
"GTTGCGGAGGCCTAAG"	"Cyst.PT"
"GTTGCGGAGGTGGTTG"	"Cyst.PT"
"GTTGCGGCATACACCA"	"T-cell"
"GTTGCGGGTATAGCTC"	"VSMC"
"GTTGCGGGTTCCTAAG"	"T-cell"
"GTTGCGGTCAGCTGTA"	"PEC"
"GTTGCTCAGCCATTTG"	"VSMC"
"GTTGCTCAGTCACTCA"	"EC"
"GTTGCTCAGTGTAGAT"	"PEC"
"GTTGCTCGTGTGTGTT"	"Cyst.LOH,TAL-cell"
"GTTGCTCTCCACGAAT"	"T-cell"
"GTTGCTCTCCGATGCG"	"Cyst.LOH,TAL-cell"
"GTTGCTCTCGACACTA"	"Mac"
"GTTGTAGCAACGATTC"	"T-cell"
"GTTGTAGGTGACAACG"	"Cyst.LOH,TAL-cell"
"GTTGTAGGTGTAGTGG"	"EC"
"GTTGTAGTCATACAGC"	"Cyst.PT"
"GTTGTCCAGAAATTGC"	"T-cell"
"GTTGTCCAGACTAGAT"	"Cyst.IC-A"
"GTTGTCCGTCGCACGT"	"Mono/Mac"
"GTTGTGAAGGTCCCGT"	"EC"
"GTTGTGAAGTCTGGTT"	"PEC"
"GTTGTGACAGCACAGA"	"Cyst.LOH,TAL-cell"
"GTTGTGAGTGTACAGG"	"PEC"
"GTTTACTAGCACCGTC"	"T-cell"
"GTTTACTTCCACATAG"	"CTL/NK-cell"
"GTTTACTTCCCAGGCA"	"Cyst.PT"
"GTTTGGAGTTGAATCC"	"T-cell"
"GTTTGGATCAAGAGTA"	"Cyst.LOH,TAL-cell"
"TAACACGAGCCGGATA"	"Cyst.LOH,TAL-cell"
"TAACACGCAGCGACAA"	"VSMC"
"TAACCAGAGCGTCAAG"	"PEC"
"TAACCAGCAGCTCCTT"	"PEC"
"TAACCAGCAGGTATGG"	"STC_1"
"TAACCAGGTGCACGCT"	"B-cell"
"TAACGACAGTGGAAAG"	"T-cell"
"TAACGACGTCTCTCTG"	"Fibroblast"
"TAACTTCAGGGCAGGA"	"T-cell"
"TAACTTCCATCACAGT"	"Cyst.PT"
"TAACTTCGTGCTTCAA"	"Cyst.PT"
"TAACTTCTCTTCGATT"	"VSMC"
"TAAGCACAGAGCCCAA"	"Mono/Mac"
"TAAGCACAGTGTTCAC"	"Cyst.LOH,TAL-cell"
"TAAGCACGTAGTGCGA"	"CTL/NK-cell"
"TAAGCACTCATTATCC"	"VSMC"
"TAAGCCACATATGCGT"	"Mac"
"TAAGCGTCAAAGGCAC"	"VSMC"
"TAAGCGTCATGTAACC"	"B-cell"
"TAAGTCGAGCGTGCTC"	"Cyst.LOH,TAL-cell"
"TAAGTCGCACTGAGTT"	"T-cell"
"TAAGTCGCAGGCTACC"	"VSMC"
"TAAGTCGGTGTCTTGA"	"CTL/NK-cell"
"TAAGTCGGTTGCGAAG"	"PEC"
"TAAGTCGTCGATTGAC"	"EC"
"TAATCTCAGCAGGCTA"	"VSMC"
"TAATCTCCATTGAAAG"	"Cyst.LOH,TAL-cell"
"TAATCTCGTACGGTTT"	"Cyst.LOH,TAL-cell"
"TAATCTCTCGAGTACT"	"VSMC"
"TAATCTCTCGTCTACC"	"EC"
"TAATCTCTCTGCGTCT"	"Mono/Mac"
"TAATTCCAGCGACAGT"	"STC_1"
"TAATTCCAGTATGCAA"	"T-cell"
"TAATTCCCAATCGCAT"	"Mac"
"TAATTCCGTAGGCTCC"	"Cyst.LOH,TAL-cell"
"TAATTCCGTGACACAG"	"Mac"
"TAATTCCGTGGCACTC"	"Cyst.PT"
"TAATTCCTCCCGTTCA"	"Cyst.PT"
"TACAACGAGTGGCAGT"	"PEC"
"TACAACGCACAAAGTA"	"Cyst.PT"
"TACAACGCATCGATGT"	"VSMC"
"TACAACGGTAACTAAG"	"Cyst.LOH,TAL-cell"
"TACAACGGTGGTATGG"	"Mac"
"TACAACGTCATCGACA"	"T-cell"
"TACAACGTCCCAAGTA"	"Cyst.PT"
"TACAACGTCCTCACTG"	"T-cell"
"TACACCCAGACTCTTG"	"Mac"
"TACACCCCACAGCATT"	"T-cell"
"TACACCCGTGAATATG"	"STC_2"
"TACACCCTCAGGAAAT"	"T-cell"
"TACACCCTCGGTCATA"	"Cyst.LOH,TAL-cell"
"TACAGGTAGTCACACT"	"Cyst.LOH,TAL-cell"
"TACAGGTCAGCGGATA"	"Cyst.PT"
"TACAGGTGTGGACCTC"	"VSMC"
"TACATTCAGGAGATAG"	"T-cell"
"TACATTCCACTACTTT"	"VSMC"
"TACATTCCAGCTATTG"	"Mac"
"TACATTCGTAGTCGTT"	"T-cell"
"TACATTCGTTCTTGCC"	"Mac"
"TACATTCTCACGGACC"	"T-cell"
"TACCCACCACTTGTGA"	"Mono/Mac"
"TACCCACTCGTAGCTA"	"B-cell"
"TACCCGTAGCTCGGCT"	"STC_1"
"TACCCGTAGTGTTCAC"	"PEC"
"TACCCGTCACGGTAGA"	"T-cell"
"TACCCGTCACTGTCGG"	"T-cell"
"TACCCGTGTCCTACAA"	"B-cell"
"TACCCGTGTGTCCTAA"	"VSMC"
"TACCCGTGTTAGAAAC"	"Fibroblast"
"TACCCGTTCAAGCCAT"	"T-cell"
"TACCGAAAGGAGGTTC"	"PEC"
"TACCGAATCTCCATAT"	"VSMC"
"TACCGAATCTTGAACG"	"Cyst.PT"
"TACCGGGAGCTTCTAG"	"Cyst.LOH,TAL-cell"
"TACCGGGCATGTTACG"	"T-cell"
"TACCGGGTCCTTGACC"	"PEC"
"TACCGGGTCTGCCTCA"	"VSMC"
"TACCGGGTCTGTCAGA"	"T-cell"
"TACCTCGAGAATACAC"	"Cyst.LOH,TAL-cell"
"TACCTCGCAACTGAAA"	"Cyst.LOH,TAL-cell"
"TACCTCGCAGCTCGGT"	"STC_2"
"TACCTCGGTGGCGTAA"	"VSMC"
"TACCTCGTCACCGGTG"	"Cyst.PT"
"TACCTCGTCAGAGCAG"	"T-cell"
"TACCTGCCACAAATGA"	"T-cell"
"TACCTGCCATAACGGG"	"Cyst.LOH,TAL-cell"
"TACGCTCGTTGCCGAC"	"Cyst.PT"
"TACGCTCTCCAACCAA"	"Mac"
"TACGGGCAGGTAGACC"	"T-cell"
"TACGGGCAGTAACAGT"	"Cyst.PT"
"TACGGGCGTCTTTATC"	"Cyst.PT"
"TACGGGCGTTGCAACT"	"T-cell"
"TACGGGCTCCATAGAC"	"PEC"
"TACGGTAGTTCCAGGC"	"CTL/NK-cell"
"TACGGTATCGTTCATT"	"Cyst.PT"
"TACGTCCCAGATTCGT"	"T-cell"
"TACGTCCGTACGCTAT"	"T-cell"
"TACGTCCTCGGTCGGT"	"T-cell"
"TACTGCCAGCCTCAGC"	"T-cell"
"TACTGCCGTAGCACGA"	"Mac"
"TACTGCCGTTGCAAGG"	"T-cell"
"TACTTACAGTTGCCCG"	"T-cell"
"TACTTACCACTGAGGA"	"Cyst.LOH,TAL-cell"
"TACTTACCAGCGACCT"	"Fibroblast"
"TACTTACGTGTTCGTA"	"Cyst.PT"
"TACTTACTCGCAACAT"	"B-cell"
"TACTTACTCGGCATTA"	"Cyst.LOH,TAL-cell"
"TACTTCACATTGAGGG"	"STC_1"
"TACTTCAGTGGTAATA"	"VSMC"
"TACTTCAGTTATCTTC"	"STC_1"
"TACTTCATCACTACTT"	"Mast-cell"
"TACTTCATCGTTCTGC"	"EC"
"TACTTGTAGACGCCAA"	"T-cell"
"TACTTGTAGGCTCTAT"	"T-cell"
"TACTTGTAGTCCCGGT"	"T-cell"
"TACTTGTTCATAGAGA"	"Mac"
"TAGACCACAAGAGAGA"	"Mast-cell"
"TAGACCACACTTCAAG"	"T-cell"
"TAGACCAGTCCGGCAT"	"Cyst.LOH,TAL-cell"
"TAGACCAGTGTAGGAC"	"STC_1"
"TAGACTGCACCGTACG"	"Mac"
"TAGACTGCAGTCAACT"	"CTL/NK-cell"
"TAGACTGGTTACCTTT"	"PEC"
"TAGAGTCCACGCGCTA"	"Mac"
"TAGAGTCCATCGATAC"	"Cyst.PT"
"TAGAGTCGTGGATCGA"	"VSMC"
"TAGAGTCGTGGCGCTT"	"Fibroblast"
"TAGAGTCTCGGCGATC"	"PEC"
"TAGATCGAGATTTGCC"	"T-cell"
"TAGATCGAGCACTCAT"	"Cyst.LOH,TAL-cell"
"TAGATCGCAAGCAATA"	"Mono/Mac"
"TAGATCGTCCATCTAT"	"PEC"
"TAGCACAAGCCAGAGT"	"T-cell"
"TAGGAGGCAACCACAT"	"Cyst.PT"
"TAGGAGGGTGGCTTGC"	"T-cell"
"TAGGAGGGTTAAGGGC"	"STC_2"
"TAGGAGGTCCAGCACG"	"Mast-cell"
"TAGGGTTAGCTCCCTT"	"T-cell"
"TAGGGTTAGTCGAAGC"	"Cyst.PT"
"TAGGGTTGTACTAAGA"	"CTL/NK-cell"
"TAGGGTTTCACCTGTC"	"T-cell"
"TAGGTACCATCACGGC"	"Cyst.PT"
"TAGGTACCATTGTGCA"	"STC_1"
"TAGGTACGTGCCTAAT"	"Mono/Mac"
"TAGGTTGAGATTGCGG"	"Cyst.LOH,TAL-cell"
"TAGGTTGAGTTGGGAC"	"STC_1"
"TAGGTTGCAAGTGGTG"	"Mono/Mac"
"TAGGTTGCATAGGTAA"	"STC_1"
"TAGGTTGGTAACAGGC"	"Mono/Mac"
"TAGGTTGGTTTGGGTT"	"Cyst.PT"
"TAGGTTGTCCGAAGGA"	"Cyst.PT"
"TAGTGCAAGGGCAAGG"	"STC_2"
"TATACCTAGATACAGT"	"Mac"
"TATACCTAGGCTCCCA"	"T-cell"
"TATACCTGTGAGCCAA"	"T-cell"
"TATACCTTCATCCCGT"	"Mono/Mac"
"TATACCTTCCAAATGC"	"Cyst.LOH,TAL-cell"
"TATATCCAGGACAGTC"	"VSMC"
"TATATCCTCCAGTGCG"	"PEC"
"TATCAGGAGTCATCGT"	"T-cell"
"TATCAGGCATTGTACG"	"STC_1"
"TATCAGGTCCTAGCTC"	"VSMC"
"TATCCTACAAGGCGTA"	"Cyst.PT"
"TATCCTACAATGCTCA"	"T-cell"
"TATCCTATCAGAGCAG"	"T-cell"
"TATCGCCAGATTCGAA"	"Mac"
"TATCGCCCAGGCAATG"	"Mast-cell"
"TATCGCCGTTCCTAAG"	"T-cell"
"TATCTGTTCTTGATTC"	"VSMC"
"TATCTTGGTAGGTCAG"	"T-cell"
"TATCTTGTCGCAGATT"	"EC"
"TATGTTCAGCTGACTT"	"Mac"
"TATGTTCCAAAGGCGT"	"PEC"
"TATGTTCCAACCCTCT"	"VSMC"
"TATGTTCCAGAACGCA"	"Mac"
"TATGTTCCAGTTCACA"	"T-cell"
"TATGTTCGTGGGAGAG"	"EC"
"TATGTTCTCTGGGATT"	"Mono/Mac"
"TATTCCACACAAGCTT"	"Cyst.LOH,TAL-cell"
"TATTCCACACTCTCGT"	"Cyst.LOH,TAL-cell"
"TATTCCACAGTAGGAC"	"STC_1"
"TATTCCACATACCAGT"	"T-cell"
"TATTCCAGTCCCTGAG"	"CTL/NK-cell"
"TATTCCAGTCGAACGA"	"T-cell"
"TATTCCAGTGGTCCGT"	"STC_1"
"TATTCCAGTGTAGCAG"	"PEC"
"TATTCCAGTGTGGTCC"	"CTL/NK-cell"
"TATTCCATCATCTGTT"	"EC"
"TATTGCTAGAGTCTTC"	"T-cell"
"TATTGCTAGCATTTGC"	"VSMC"
"TATTGCTTCACGTCCT"	"VSMC"
"TATTGCTTCCGATCGG"	"STC_1"
"TATTGCTTCGTCTAAG"	"Cyst.LOH,TAL-cell"
"TATTGGGAGATCGGTG"	"VSMC"
"TATTGGGAGGTTAGTA"	"Cyst.PT"
"TATTGGGCAAGCCATT"	"CTL/NK-cell"
"TATTGGGGTCGACTGC"	"PEC"
"TATTGGGGTTTCTATC"	"STC_1"
"TATTGGGTCCGAGATT"	"Mono/Mac"
"TATTGGGTCGTGGTAT"	"Fibroblast"
"TATTTCGCATGAAGCG"	"Cyst.PT"
"TATTTCGGTAGAGATT"	"T-cell"
"TATTTCGGTTACCGTA"	"Mac"
"TATTTCGGTTGTGGAG"	"EC"
"TATTTCGTCCTTGACC"	"T-cell"
"TATTTCGTCTTTACAC"	"T-cell"
"TCAAGACAGATGTTCC"	"Cyst.PT"
"TCAAGACGTGGCGCTT"	"T-cell"
"TCAAGACGTGGTCTCG"	"T-cell"
"TCAAGACGTTAACCTG"	"T-cell"
"TCAAGACGTTCAGCTA"	"T-cell"
"TCAAGACGTTCTGAGT"	"EC"
"TCAAGCAAGCCATTTG"	"EC"
"TCAAGCAAGGTCTGGA"	"STC_1"
"TCAAGCACAATCCAGT"	"T-cell"
"TCAAGCATCAGGACAG"	"Mono/Mac"
"TCAAGTGAGAAGGCTC"	"T-cell"
"TCAAGTGAGCACACCC"	"Mast-cell"
"TCAAGTGCAAACACGG"	"T-cell"
"TCAAGTGCAACCAGAG"	"STC_1"
"TCAAGTGCACGCGCAT"	"Mono/Mac"
"TCAAGTGCATAAGCAA"	"Cyst.LOH,TAL-cell"
"TCAAGTGCATCGTGCG"	"Mac"
"TCAAGTGTCACTTTGT"	"EC"
"TCAATCTAGGTTCATC"	"STC_1"
"TCAATCTCATTGAGCT"	"T-cell"
"TCAATCTGTAATGCGG"	"Mono/Mac"
"TCAATCTGTTCCTAAG"	"T-cell"
"TCAATCTGTTTGGAGG"	"T-cell"
"TCAATCTTCAAGAAAC"	"Cyst.LOH,TAL-cell"
"TCAATTCAGGCATCTT"	"Cyst.LOH,TAL-cell"
"TCAATTCGTTACAGCT"	"PEC"
"TCAATTCGTTGCTGAT"	"PEC"
"TCACAAGTCCAATGCA"	"VSMC"
"TCACAAGTCCTACCGT"	"Mono/Mac"
"TCACAAGTCGGTTGTA"	"Mono/Mac"
"TCACAAGTCTTCGTGC"	"VSMC"
"TCACACCAGGTCTTTG"	"T-cell"
"TCACACCAGGTTGAGC"	"Cyst.LOH,TAL-cell"
"TCACACCCACGCAGTC"	"EC"
"TCACACCGTAACTGCT"	"Cyst.LOH,TAL-cell"
"TCACACCGTCAAGCGA"	"Cyst.LOH,TAL-cell"
"TCACACCTCCGTGGCA"	"VSMC"
"TCACATTGTAACGATA"	"VSMC"
"TCACATTGTCATCAGT"	"Mast-cell"
"TCACATTTCAACTCTT"	"T-cell"
"TCACATTTCTCTCGCA"	"Cyst.PT"
"TCACGCTAGTTTGAGA"	"PEC"
"TCACGCTCAAACACCT"	"Mono/Mac"
"TCACGCTCAGCGACCT"	"Cyst.PT"
"TCACGCTCATAAGATG"	"Mac"
"TCACGCTGTCCATCTC"	"Cyst.PT"
"TCACGGGGTGCATTAC"	"PEC"
"TCACTATAGCTCTATG"	"T-cell"
"TCACTATTCCAATCCC"	"Cyst.LOH,TAL-cell"
"TCACTATTCTGAATGC"	"STC_1"
"TCACTCGAGTAACAGT"	"T-cell"
"TCACTCGCAAAGCTAA"	"Mono/Mac"
"TCACTCGCATAGCACT"	"Cyst.PT"
"TCACTCGTCCGAAATC"	"CTL/NK-cell"
"TCAGCAACATGGGATG"	"PEC"
"TCAGCAAGTGCAGTGA"	"STC_1"
"TCAGCAAGTGTCCGTG"	"STC_1"
"TCAGCAATCGAGAAGC"	"PEC"
"TCAGCAATCGCTCATC"	"STC_1"
"TCAGCCTCAGACTGCC"	"Cyst.LOH,TAL-cell"
"TCAGCCTGTATCGCGC"	"Cyst.PT"
"TCAGCCTGTGTTCAGT"	"STC_1"
"TCAGCCTTCACCTACC"	"Cyst.LOH,TAL-cell"
"TCAGCCTTCGATCCCT"	"T-cell"
"TCAGCCTTCGGAAACG"	"STC_1"
"TCAGCCTTCTCCTGTG"	"EC"
"TCAGGGCAGCGCTGCT"	"Fibroblast"
"TCAGGGCCACTACCCT"	"STC_1"
"TCAGGGCCACTCCACT"	"T-cell"
"TCAGGGCGTTACACAC"	"Fibroblast"
"TCAGGGCTCCGGCTTT"	"STC_1"
"TCAGGTAAGTCTTGGT"	"PEC"
"TCAGGTACAAGCTACT"	"PEC"
"TCAGGTACAATGTTGC"	"VSMC"
"TCAGGTATCGTAGAGG"	"Mono/Mac"
"TCAGGTATCTAAGAAG"	"Mono/Mac"
"TCAGTCCCAACTCCCT"	"STC_1"
"TCAGTCCCACCGCTAG"	"Cyst.PT"
"TCAGTCCCAGAATGTA"	"Cyst.LOH,TAL-cell"
"TCAGTCCGTACTTCCC"	"Cyst.LOH,TAL-cell"
"TCAGTCCTCGTCGGGT"	"PEC"
"TCAGTGAAGACTACCT"	"PEC"
"TCAGTGAAGGTAAGAG"	"VSMC"
"TCAGTGAAGTCTGGTT"	"Cyst.LOH,TAL-cell"
"TCAGTGACAGAAGCGT"	"T-cell"
"TCAGTGATCGCAATTG"	"Cyst.LOH,TAL-cell"
"TCAGTGATCGGTCAGC"	"T-cell"
"TCAGTGATCGTAACCA"	"Fibroblast"
"TCAGTTTTCTACTCAT"	"Cyst.PT"
"TCATACTAGCTGAGCA"	"T-cell"
"TCATACTAGTAGAGTT"	"Cyst.LOH,TAL-cell"
"TCATACTCAACATCGT"	"PEC"
"TCATACTGTTTCAGAC"	"EC"
"TCATACTTCATTTCGT"	"VSMC"
"TCATACTTCGCCCAGA"	"T-cell"
"TCATACTTCTCTTCAA"	"Mono/Mac"
"TCATATCAGGTCGTAG"	"T-cell"
"TCATATCCACCGAATT"	"STC_1"
"TCATCATAGAACTCCT"	"T-cell"
"TCATCATAGTATAACG"	"Mac"
"TCATCATCAATGCAAA"	"Mono/Mac"
"TCATCATCACCACTGG"	"Mono/Mac"
"TCATCATTCAGCACCG"	"Cyst.PT"
"TCATCATTCATTCTTG"	"Cyst.LOH,TAL-cell"
"TCATCATTCTCCGTGT"	"Cyst.LOH,TAL-cell"
"TCATCATTCTGAATGC"	"PEC"
"TCATCCGAGGCGAACT"	"VSMC"
"TCATCCGAGTCATCGT"	"PEC"
"TCATCCGAGTGCCCGT"	"Cyst.PT"
"TCATGAGAGCCTCTTC"	"STC_1"
"TCATGAGGTGTTCCAA"	"Cyst.PT"
"TCATGAGTCTCGACCT"	"T-cell"
"TCATGCCAGGGTAATT"	"PEC"
"TCATGCCCAAACGTGG"	"VSMC"
"TCATGCCTCCAGTACA"	"Cyst.LOH,TAL-cell"
"TCATGCCTCTACTTCA"	"Cyst.LOH,TAL-cell"
"TCATGGAAGCGCTGAA"	"VSMC"
"TCATGGACAAGAGAGA"	"VSMC"
"TCATGGACAAGTCGTT"	"PEC"
"TCATGTTAGGTGAGCT"	"T-cell"
"TCATGTTCAACTACGT"	"STC_1"
"TCATGTTCAGTGTACT"	"T-cell"
"TCATTACAGGACTATA"	"STC_1"
"TCATTACTCACCTGGG"	"Mono/Mac"
"TCATTCAAGCTCCATA"	"Cyst.IC-A"
"TCATTCACACTTGTCC"	"CTL/NK-cell"
"TCATTGTCATTGCCTC"	"T-cell"
"TCATTGTGTGGGCTCT"	"CTL/NK-cell"
"TCATTGTGTTCGTGCG"	"Cyst.LOH,TAL-cell"
"TCATTTGCAACTGATC"	"STC_1"
"TCATTTGTCTGCGAGC"	"Mac"
"TCCACCAAGCGTTACT"	"Cyst.LOH,TAL-cell"
"TCCACCAAGGCACCAA"	"T-cell"
"TCCACCACATTCTGTT"	"STC_2"
"TCCACCAGTATGTCTG"	"Cyst.LOH,TAL-cell"
"TCCACCAGTTCGTAAC"	"Cyst.LOH,TAL-cell"
"TCCACCATCCAACTAG"	"Cyst.LOH,TAL-cell"
"TCCACCATCGTGGGAA"	"STC_1"
"TCCACCATCTGGGAGA"	"CTL/NK-cell"
"TCCACGTCACTTCATT"	"STC_1"
"TCCACGTTCATTTCGT"	"Cyst.LOH,TAL-cell"
"TCCAGAAAGACCCGCT"	"Cyst.PT"
"TCCATCGCAATGGCCC"	"VSMC"
"TCCATCGCATTCTCCG"	"STC_1"
"TCCATCGGTAATGTGA"	"T-cell"
"TCCATCGGTAGCTTTG"	"CTL/NK-cell"
"TCCATCGGTTAAGCAA"	"VSMC"
"TCCATCGGTTCCACGG"	"Cyst.PT"
"TCCATGCCAAGTCCAT"	"T-cell"
"TCCATGCCAGTTGTCA"	"Cyst.LOH,TAL-cell"
"TCCATGCCATCTCCCA"	"Cyst.PT"
"TCCATGCGTGAGAACC"	"Mono/Mac"
"TCCATGCTCGTAACTG"	"T-cell"
"TCCATGCTCTCGGTCT"	"CTL/NK-cell"
"TCCCACACACAACGTT"	"VSMC"
"TCCCACAGTACCGTCG"	"EC"
"TCCCACAGTCCGGATC"	"Cyst.LOH,TAL-cell"
"TCCCACAGTTAGAAAC"	"Fibroblast"
"TCCCAGTGTCAACCAT"	"Mono/Mac"
"TCCCAGTTCAAGCCAT"	"Mac"
"TCCCATGAGACAGTCG"	"Cyst.PT"
"TCCCATGGTTAGCTAC"	"T-cell"
"TCCCATGTCGCATTGA"	"PEC"
"TCCGAAACAACTTGGT"	"Cyst.LOH,TAL-cell"
"TCCGAAACAGAAACCG"	"VSMC"
"TCCGAAACATCGGAGA"	"Cyst.LOH,TAL-cell"
"TCCGAAAGTAAGCGGT"	"PEC"
"TCCGATCCACCAGACC"	"T-cell"
"TCCGATCCACTAGTAC"	"STC_1"
"TCCGATCCAGGACTTT"	"VSMC"
"TCCGATCGTGCACAAG"	"Mono/Mac"
"TCCGGGATCCATGAGT"	"Cyst.PT"
"TCCGGGATCTTCCAGC"	"Cyst.LOH,TAL-cell"
"TCCGTGTCAAACTCGT"	"PEC"
"TCCGTGTTCTGTCGCT"	"Cyst.LOH,TAL-cell"
"TCCTCCCAGGTCGCCT"	"STC_1"
"TCCTCCCCAAATCGTC"	"T-cell"
"TCCTCCCGTCGTTATG"	"T-cell"
"TCCTCCCGTGACTCTA"	"T-cell"
"TCCTCGACAAAGACTA"	"Cyst.LOH,TAL-cell"
"TCCTCGACATTGAAAG"	"Mac"
"TCCTCTTCACTGCTTC"	"T-cell"
"TCCTCTTGTTCGTACA"	"PEC"
"TCCTCTTGTTCTCGCT"	"Mono/Mac"
"TCCTCTTTCCCTTCCC"	"PEC"
"TCCTGCAAGCATTGTC"	"Cyst.PT"
"TCCTGCACAGTCACGC"	"B-cell"
"TCCTGCACATCGATAC"	"Mono/Mac"
"TCCTGCATCGGACTTA"	"Mac"
"TCCTTCTAGCCTTTCC"	"Cyst.PT"
"TCCTTCTCAGAGTAAT"	"STC_2"
"TCCTTCTTCCCAGGAC"	"Mac"
"TCCTTTCAGTTCTCTT"	"STC_1"
"TCCTTTCCATGACAGG"	"Cyst.PT"
"TCCTTTCGTTGGGATG"	"Cyst.LOH,TAL-cell"
"TCCTTTCTCGGCTGTG"	"Mac"
"TCCTTTCTCTCTCAAT"	"T-cell"
"TCGAACAAGTGGACTG"	"EC"
"TCGAACAGTCCAAAGG"	"Cyst.PT"
"TCGAAGTAGGAGGCAG"	"PEC"
"TCGAAGTAGGGCAGGA"	"Cyst.PT"
"TCGAAGTAGTGGATTA"	"STC_1"
"TCGAAGTCAATTCTCT"	"VSMC"
"TCGAAGTGTACAGAGC"	"T-cell"
"TCGAAGTGTCCAAATC"	"PEC"
"TCGAAGTTCATGTCAG"	"CTL/NK-cell"
"TCGAAGTTCCTTGACC"	"Mast-cell"
"TCGACCTGTACGTACT"	"VSMC"
"TCGACCTTCCAGCTCT"	"T-cell"
"TCGACGGAGCCATTTG"	"Cyst.LOH,TAL-cell"
"TCGACGGCAAGTGGTG"	"Mast-cell"
"TCGACGGCACTCCGGA"	"T-cell"
"TCGACGGGTCGTGGTC"	"Cyst.PT"
"TCGACGGTCCGACATA"	"CTL/NK-cell"
"TCGATTTAGTTTCGAC"	"Cyst.LOH,TAL-cell"
"TCGATTTCAAGATGGC"	"Cyst.PT"
"TCGATTTGTAATTGGA"	"PEC"
"TCGCACTAGCGGGTAT"	"Mac"
"TCGCACTCAGGGTTGA"	"VSMC"
"TCGCAGGCATCTATCT"	"STC_1"
"TCGCAGGGTCAAATCC"	"VSMC"
"TCGCAGGGTCGTGCCA"	"T-cell"
"TCGCAGGGTGAACCGA"	"VSMC"
"TCGCAGGGTTCCATTT"	"VSMC"
"TCGCTCACAGCCGGTT"	"VSMC"
"TCGCTCACAGGCCTGT"	"T-cell"
"TCGCTCATCTCTAAGG"	"VSMC"
"TCGCTTGAGGATTTCC"	"Cyst.LOH,TAL-cell"
"TCGCTTGGTCGGAACA"	"Cyst.LOH,TAL-cell"
"TCGCTTGGTGGAAATT"	"Cyst.LOH,TAL-cell"
"TCGCTTGTCTCTCCGA"	"Cyst.LOH,TAL-cell"
"TCGGATAAGGCTCTAT"	"Cyst.LOH,TAL-cell"
"TCGGATACACCTGCTT"	"Cyst.LOH,TAL-cell"
"TCGGATATCAGACAAA"	"Mono/Mac"
"TCGGATATCGAGTCCG"	"STC_1"
"TCGGGACAGAAGAACG"	"Cyst.LOH,TAL-cell"
"TCGGGACGTAAGCAAT"	"Cyst.PT"
"TCGGGACTCATCCTGC"	"T-cell"
"TCGGGACTCTATACGG"	"VSMC"
"TCGGGCAGTCATGGCC"	"PEC"
"TCGGGCATCAAAGACA"	"T-cell"
"TCGGGCATCAGTGCGC"	"Mono/Mac"
"TCGGGCATCGATAACC"	"PEC"
"TCGGGCATCTCCCAAC"	"PEC"
"TCGGGTGCAGGTTCAT"	"EC"
"TCGGGTGGTTGCGGCT"	"PEC"
"TCGGGTGTCGGTCGGT"	"Cyst.PT"
"TCGGTCTCACCTGATA"	"STC_1"
"TCGGTCTGTAGTCGTT"	"B-cell"
"TCGTAGACAGCTGAAG"	"VSMC"
"TCGTAGAGTTAATGAG"	"T-cell"
"TCGTCCAAGGTTAGTA"	"Mac"
"TCGTCCAGTCTCTCCA"	"T-cell"
"TCGTCCATCGGAGTAG"	"Cyst.PT"
"TCGTGCTCACTACAGT"	"Mono/Mac"
"TCGTGCTCAGAATTCC"	"STC_1"
"TCGTGCTTCCTCACCA"	"STC_1"
"TCGTGGGAGCCTTTGA"	"Mac"
"TCGTGGGCAACCGTAT"	"T-cell"
"TCGTGGGCACACACTA"	"CTL/NK-cell"
"TCGTGGGCACTCAAGT"	"Cyst.PT"
"TCGTGGGCATTCCTAT"	"Cyst.LOH,TAL-cell"
"TCTAACTAGCACTCAT"	"Cyst.PT"
"TCTAACTCAAGAGGCT"	"Mono/Mac"
"TCTAACTCACAAATAG"	"CTL/NK-cell"
"TCTAACTCACACGTGC"	"STC_1"
"TCTAACTCATCTATCT"	"VSMC"
"TCTAACTTCGGAACTT"	"STC_1"
"TCTACATAGCATGGGT"	"Mast-cell"
"TCTACATAGGGCATGT"	"EC"
"TCTACATAGTCAGCGA"	"STC_1"
"TCTACATGTCCCACGA"	"T-cell"
"TCTACATTCACGACTA"	"T-cell"
"TCTACCGGTAATCAGA"	"CTL/NK-cell"
"TCTACCGGTAGCGAGT"	"T-cell"
"TCTATACCAGTTCCAA"	"Mono/Mac"
"TCTATACGTAAGATCA"	"T-cell"
"TCTATACTCACCATGA"	"VSMC"
"TCTATCAGTAGCTTTG"	"Mono/Mac"
"TCTCACGAGACGAAGA"	"Cyst.LOH,TAL-cell"
"TCTCACGAGCCATTGT"	"Mono/Mac"
"TCTCACGGTGACAGGT"	"Mast-cell"
"TCTCACGGTGGTATGG"	"VSMC"
"TCTCACGTCTCCAATT"	"PEC"
"TCTCACGTCTGCTTTA"	"VSMC"
"TCTCAGCAGACGACTG"	"Mono/Mac"
"TCTCAGCAGTACCGGA"	"Mac"
"TCTCAGCGTTAGCTAC"	"VSMC"
"TCTCCGAAGGCCTAGA"	"T-cell"
"TCTCCGACAGAACCGA"	"Cyst.PT"
"TCTCCGAGTGGAACAC"	"T-cell"
"TCTCCGATCACCGACG"	"Fibroblast"
"TCTCTGGAGTCCCTAA"	"Cyst.PT"
"TCTCTGGCACTGTGAT"	"T-cell"
"TCTCTGGGTACGGATG"	"Mac"
"TCTCTGGTCATAGCAC"	"Mac"
"TCTCTGGTCATTGGTG"	"Mono/Mac"
"TCTCTGGTCCGTGGGT"	"EC"
"TCTCTGGTCGGCTATA"	"EC"
"TCTGCCAAGGAACGTC"	"VSMC"
"TCTGCCAAGTATGACA"	"T-cell"
"TCTGCCACAGAGTCAG"	"Fibroblast"
"TCTGCCACAGTCGGAA"	"STC_2"
"TCTGGCTAGACCTCAT"	"Mono/Mac"
"TCTGGCTAGAGCCTGA"	"PEC"
"TCTGGCTGTGGAGGTT"	"PEC"
"TCTGGCTGTGGATCAG"	"Mast-cell"
"TCTGGCTGTTGGAGGT"	"Cyst.LOH,TAL-cell"
"TCTGTCGGTTTCGCTC"	"T-cell"
"TCTTAGTCAAGAGCTG"	"VSMC"
"TCTTAGTGTCTTCATT"	"Mono/Mac"
"TCTTCCTAGCCTGTCG"	"STC_1"
"TCTTCCTCAAGAGGCT"	"Mac"
"TCTTCCTTCCTTGAAG"	"T-cell"
"TCTTGCGAGAGCCCAA"	"Mac"
"TCTTGCGCAAGGCCTC"	"T-cell"
"TCTTTGACATGACTCA"	"Cyst.PT"
"TCTTTGAGTGTATTGC"	"Mono/Mac"
"TCTTTGATCGAGAATA"	"STC_1"
"TCTTTGATCTGAATCG"	"VSMC"
"TGAACGTAGTAACGTA"	"Cyst.PT"
"TGAACGTCAATTTCGG"	"Mono/Mac"
"TGAACGTCACGTAGAG"	"Cyst.LOH,TAL-cell"
"TGAACGTCAGCCCAGT"	"Cyst.LOH,TAL-cell"
"TGAACGTTCAAGATAG"	"STC_2"
"TGAACGTTCAGCGGAA"	"Cyst.LOH,TAL-cell"
"TGAACGTTCTCCGAGG"	"T-cell"
"TGAATCGAGCAACTTC"	"Mac"
"TGAATCGCACACGGAA"	"Cyst.PT"
"TGAATCGCATTATGCG"	"Mast-cell"
"TGAATCGGTTATAGCC"	"Mono/Mac"
"TGAATCGGTTCTCAGA"	"VSMC"
"TGAATGCAGATTTGCC"	"STC_1"
"TGAATGCAGTGCACAG"	"CTL/NK-cell"
"TGAATGCGTATGTCAC"	"T-cell"
"TGAATGCTCACGTCCT"	"Mac"
"TGACAGTAGCACCAGA"	"T-cell"
"TGACAGTTCATGCAGT"	"EC"
"TGACAGTTCGACCCAG"	"Mac"
"TGACCCTAGGTCCAGA"	"STC_1"
"TGACCCTCAGATCCTA"	"Mac"
"TGACCCTGTCGAACGA"	"Cyst.LOH,TAL-cell"
"TGACCCTTCATGAGTC"	"Cyst.LOH,TAL-cell"
"TGACGCGAGAGTGAAG"	"VSMC"
"TGACGCGAGATAGCTA"	"PEC"
"TGACGCGAGCCACTCG"	"STC_1"
"TGACGCGGTCAATCTG"	"Cyst.LOH,TAL-cell"
"TGACGCGTCCCGTAAA"	"PEC"
"TGACTCCTCAAATGAG"	"CTL/NK-cell"
"TGACTCCTCACCGGTG"	"Mac"
"TGACTCCTCCAAAGGG"	"Mono/Mac"
"TGACTCCTCTGACAGT"	"VSMC"
"TGAGACTAGGTAGACC"	"CTL/NK-cell"
"TGAGACTAGGTCACTT"	"VSMC"
"TGAGACTCAAGGGCAT"	"Cyst.PT"
"TGAGACTCAGTCGGTC"	"B-cell"
"TGAGACTGTAGTCTGT"	"T-cell"
"TGAGACTGTGAATTGA"	"Mono/Mac"
"TGAGCATGTACCACGC"	"T-cell"
"TGAGCATGTAGGTCAG"	"Cyst.PT"
"TGAGCATGTATAGGAT"	"Cyst.LOH,TAL-cell"
"TGAGCATTCAAGAGGC"	"PEC"
"TGAGCATTCGGCGATC"	"PEC"
"TGAGCGCGTGGAAGTC"	"Mono/Mac"
"TGAGGAGCATGTTCGA"	"T-cell"
"TGAGGAGGTAGTGGCA"	"T-cell"
"TGAGGAGGTGAGATAT"	"PEC"
"TGAGGAGTCATCTATC"	"T-cell"
"TGAGGAGTCCGATAAC"	"Cyst.LOH,TAL-cell"
"TGAGGAGTCGCAGAGA"	"STC_1"
"TGAGGGATCATTGCCC"	"T-cell"
"TGAGGGATCGACACTA"	"VSMC"
"TGAGGGATCTGTCCGT"	"Cyst.PT"
"TGAGGTTAGACCATGG"	"T-cell"
"TGAGGTTAGACTGGGT"	"Cyst.IC-A"
"TGAGGTTAGTGTCATC"	"VSMC"
"TGAGGTTCATGCGTGC"	"VSMC"
"TGAGGTTTCCAACTAG"	"VSMC"
"TGAGTCAAGGCATCGA"	"PEC"
"TGAGTCACAAACTAAG"	"Cyst.PT"
"TGAGTCACAAATGCGG"	"Cyst.PT"
"TGAGTCACAGCTACTA"	"Mac"
"TGAGTCACATATCTCT"	"Cyst.PT"
"TGAGTCACATGACAGG"	"Cyst.LOH,TAL-cell"
"TGAGTCATCCATTCGC"	"Mac"
"TGATCAGAGCCAAGCA"	"T-cell"
"TGATCAGAGGAACGTC"	"T-cell"
"TGATCAGAGGGCTAAC"	"STC_1"
"TGATCAGGTTATCCAG"	"PEC"
"TGATCAGTCAGTCTTT"	"CTL/NK-cell"
"TGATCAGTCTCAACGA"	"VSMC"
"TGATCTTAGCCACAAG"	"Cyst.LOH,TAL-cell"
"TGATCTTAGTCCTGTA"	"T-cell"
"TGATCTTCAAGACAAT"	"T-cell"
"TGATGCAGTCGAACAG"	"EC"
"TGATGCAGTTCAGTAC"	"STC_1"
"TGATGGTCAGCTACTA"	"Mono/Mac"
"TGATGGTGTACCGTCG"	"Cyst.LOH,TAL-cell"
"TGATGGTGTACTAGCT"	"Mast-cell"
"TGATTCTAGTGGAAGA"	"Cyst.PT"
"TGATTCTCAAATAAGC"	"CTL/NK-cell"
"TGATTCTCAGCAGTGA"	"Cyst.LOH,TAL-cell"
"TGATTCTGTACTCGTA"	"Fibroblast"
"TGATTTCGTTACGATC"	"T-cell"
"TGATTTCTCCGACGGT"	"VSMC"
"TGCACGGAGCTTAGTC"	"STC_1"
"TGCACGGTCCGGACGT"	"Mono/Mac"
"TGCACGGTCGTCCATC"	"Mast-cell"
"TGCAGATAGACGCAGT"	"Cyst.LOH,TAL-cell"
"TGCAGATCATGTGCTA"	"T-cell"
"TGCAGATGTCCCTCAT"	"Mac"
"TGCAGATGTCCTCCAT"	"CTL/NK-cell"
"TGCAGATGTGTCCATA"	"Cyst.PT"
"TGCAGGCAGTATGAAC"	"Cyst.LOH,TAL-cell"
"TGCAGGCCAAAGTATG"	"PEC"
"TGCAGGCCAACGCATT"	"T-cell"
"TGCAGGCTCTTCTAAC"	"T-cell"
"TGCAGTAAGACCAACG"	"Mono/Mac"
"TGCAGTACACACAGAG"	"Mac"
"TGCAGTATCTACCACC"	"Cyst.PT"
"TGCATCCCAGCGACCT"	"Mono/Mac"
"TGCATCCCAGTGTGCC"	"STC_1"
"TGCATCCGTATACCTG"	"STC_1"
"TGCATGACACATGACT"	"Cyst.LOH,TAL-cell"
"TGCATGACAGGTAGTG"	"Cyst.LOH,TAL-cell"
"TGCATGAGTACACGTT"	"T-cell"
"TGCATGAGTGTGAATA"	"Cyst.LOH,TAL-cell"
"TGCCGAGAGTAGGCCA"	"T-cell"
"TGCCGAGAGTATCTGC"	"Mono/Mac"
"TGCCGAGGTGGAGGTT"	"T-cell"
"TGCCGAGGTTGCTTGA"	"T-cell"
"TGCGATAAGAGTGAAG"	"Mac"
"TGCGATAAGATGCCGA"	"Cyst.PT"
"TGCGATAGTTGTCTAG"	"Cyst.LOH,TAL-cell"
"TGCGGCAAGAGTTCGG"	"T-cell"
"TGCGGCAAGTATGTAG"	"Fibroblast"
"TGCGGCACACCCTAAA"	"T-cell"
"TGCGGGTCACTAGAGG"	"Mac"
"TGCGGGTGTACCACGC"	"Cyst.PT"
"TGCGGGTGTAGTGCGA"	"Cyst.LOH,TAL-cell"
"TGCGGGTGTTCTAAGC"	"STC_1"
"TGCGGGTTCTCTCCGA"	"Cyst.LOH,TAL-cell"
"TGCTCCAAGTTACGGG"	"CTL/NK-cell"
"TGCTCCACACCTTCCA"	"CTL/NK-cell"
"TGCTCCACACGCTGTG"	"T-cell"
"TGCTCCAGTCGGAACA"	"VSMC"
"TGCTCGTAGCAGGTCA"	"Mono/Mac"
"TGCTCGTCACCTATCC"	"Cyst.PT"
"TGCTCGTCAGGAAGTC"	"VSMC"
"TGCTCGTCAGTAGTGG"	"Mono/Mac"
"TGCTCGTCATATCTGG"	"EC"
"TGCTCGTTCCGTTGGG"	"Mac"
"TGCTGAATCACCTCAC"	"Mono/Mac"
"TGCTTCGAGATGCTTC"	"T-cell"
"TGCTTCGTCCAACACA"	"Cyst.LOH,TAL-cell"
"TGCTTCGTCTCATGGA"	"PEC"
"TGCTTGCAGAAGTATC"	"CTL/NK-cell"
"TGCTTGCAGACCGCCT"	"T-cell"
"TGCTTGCGTACGATGG"	"T-cell"
"TGGAACTAGAGCAAGA"	"T-cell"
"TGGAACTCAGCTCGGT"	"T-cell"
"TGGAACTGTCGCATTA"	"PEC"
"TGGAACTGTTACGGAG"	"Mac"
"TGGAACTTCGAATCCA"	"Cyst.LOH,TAL-cell"
"TGGAGAGAGATTCGAA"	"STC_1"
"TGGAGGAAGAAACCAT"	"Cyst.PT"
"TGGAGGAAGCAGAAAG"	"T-cell"
"TGGAGGAAGCCAGTAG"	"T-cell"
"TGGAGGAAGCGATGGT"	"Cyst.LOH,TAL-cell"
"TGGAGGACACCCATAA"	"Cyst.LOH,TAL-cell"
"TGGATCATCATTTGCT"	"VSMC"
"TGGATGTCAACTCGAT"	"Cyst.PT"
"TGGATGTCAGAAATCA"	"CTL/NK-cell"
"TGGATGTGTCGTACTA"	"PEC"
"TGGATGTTCCATGAGT"	"Cyst.LOH,TAL-cell"
"TGGGAAGTCGGTAAGG"	"Mono/Mac"
"TGGGAGAAGACTTCGT"	"STC_1"
"TGGGAGAGTACCCGAC"	"PEC"
"TGGGAGAGTCTTAGTG"	"Cyst.PT"
"TGGGATTAGAGGGTGG"	"Mac"
"TGGGATTGTAAGTCAA"	"T-cell"
"TGGGATTTCATCGACA"	"PEC"
"TGGGATTTCTGCTAGA"	"CTL/NK-cell"
"TGGGCGTCAAGCACAG"	"EC"
"TGGGCTGAGATGTTGA"	"Cyst.PT"
"TGGGCTGGTAAGCTCT"	"Mac"
"TGGGTTAGTGGATACG"	"Cyst.LOH,TAL-cell"
"TGGGTTATCGAACGCC"	"Mono/Mac"
"TGGGTTATCTGGCCAG"	"Cyst.PT"
"TGGTACAAGGATTTCC"	"Cyst.LOH,TAL-cell"
"TGGTACAGTAGCTGTT"	"CTL/NK-cell"
"TGGTACAGTGTAGCAG"	"Mac"
"TGGTAGTAGTCGAATA"	"Mono/Mac"
"TGGTAGTGTCTCAGAT"	"Cyst.LOH,TAL-cell"
"TGGTAGTTCGAGCCTG"	"STC_1"
"TGGTAGTTCTATGCCC"	"Mono/Mac"
"TGGTGATCAATCCTAG"	"Mono/Mac"
"TGGTGATCAGCTATTG"	"PEC"
"TGGTTAGAGCGGTAGT"	"PEC"
"TGGTTAGAGTCAACAA"	"STC_1"
"TGGTTAGGTATGGAAT"	"Mono/Mac"
"TGGTTAGTCTTCTCAA"	"STC_1"
"TGTAACGCACTCTAGA"	"T-cell"
"TGTAACGCAGCTGAAG"	"VSMC"
"TGTAACGCAGTAGAAT"	"PEC"
"TGTAACGGTAGACAGC"	"Mono/Mac"
"TGTAAGCCACCTTCGT"	"Mono/Mac"
"TGTAAGCTCGAATGCT"	"VSMC"
"TGTACAGCACTTGGCG"	"T-cell"
"TGTACAGGTTGACTAC"	"T-cell"
"TGTACAGTCAGGTAAA"	"STC_1"
"TGTACAGTCTTACCAT"	"VSMC"
"TGTAGACTCCTTGACC"	"Cyst.LOH,TAL-cell"
"TGTCAGAGTGGCGCTT"	"STC_2"
"TGTCAGAGTGTCCACG"	"STC_1"
"TGTCCACGTATAGGGC"	"STC_1"
"TGTCCCAAGGGTTGCA"	"STC_1"
"TGTCCCACATGACCCG"	"Mono/Mac"
"TGTCCCAGTAGCCCTG"	"Cyst.PT"
"TGTCCTGCACCCTGTT"	"Cyst.PT"
"TGTCCTGCAGAAATTG"	"T-cell"
"TGTCCTGGTTGGTACT"	"STC_1"
"TGTGAGTGTCGGAACA"	"Mast-cell"
"TGTGAGTTCCTACAAG"	"T-cell"
"TGTGATGCAATTGCAC"	"Cyst.PT"
"TGTGATGCAGACTCTA"	"Mac"
"TGTGATGGTGATACTC"	"EC"
"TGTGATGTCGGCCCAA"	"Fibroblast"
"TGTGCGGAGCATCAGG"	"B-cell"
"TGTGCGGCAAGTGTCT"	"VSMC"
"TGTGGCGAGACTGAGC"	"Cyst.PT"
"TGTGGCGAGGACGGAG"	"T-cell"
"TGTGGCGCAGGGTTGA"	"CTL/NK-cell"
"TGTGGCGGTACCAATC"	"Mono/Mac"
"TGTGTGACAATGAGCG"	"Cyst.PT"
"TGTGTGACACCTATCC"	"VSMC"
"TGTGTGACACGAGGAT"	"CTL/NK-cell"
"TGTGTGACAGTCGCTG"	"T-cell"
"TGTGTGACATCCGCGA"	"Cyst.LOH,TAL-cell"
"TGTGTGATCCGAGCTG"	"Mast-cell"
"TGTTACTCATCGGCCA"	"Cyst.LOH,TAL-cell"
"TGTTACTCATGACTGT"	"Mac"
"TGTTACTGTCGTGCCA"	"VSMC"
"TGTTACTTCGGTGAAG"	"Cyst.PT"
"TGTTACTTCTACACTT"	"Mono/Mac"
"TGTTACTTCTGTAAGC"	"Cyst.LOH,TAL-cell"
"TGTTCATAGCGGATCA"	"Mac"
"TGTTCATAGGGTTAGC"	"Mono/Mac"
"TGTTCATGTACGCTAT"	"Mac"
"TGTTCATGTAGGAGGG"	"Mono/Mac"
"TGTTCATTCCTAACAG"	"Cyst.PT"
"TGTTCCGGTTAGAAGT"	"PEC"
"TGTTCCGTCATGACAC"	"CTL/NK-cell"
"TGTTCCGTCCATTTGT"	"CTL/NK-cell"
"TGTTCTAGTGAAGCTG"	"CTL/NK-cell"
"TGTTGAGGTAGTTCCA"	"T-cell"
"TGTTGAGTCTGAGATC"	"STC_1"
"TGTTGGAAGGCTAGCA"	"Cyst.LOH,TAL-cell"
"TGTTGGACAAGACCGA"	"Cyst.PT"
"TGTTGGACATGACTCA"	"T-cell"
"TGTTGGACATTGGGAG"	"STC_1"
"TGTTTGTAGCCGGAAT"	"Mac"
"TGTTTGTCAGGAATAT"	"CTL/NK-cell"
"TGTTTGTGTCCGGACT"	"Mac"
"TTAATCCCAGTAACGG"	"STC_1"
"TTAATCCGTTTGAAAG"	"STC_1"
"TTAATCCTCTAGCAAC"	"STC_1"
"TTACAGGAGGTACTGG"	"Cyst.LOH,TAL-cell"
"TTACAGGGTGTATTCG"	"T-cell"
"TTACCATAGGGAGGGT"	"Mac"
"TTACCATAGGGCCAAT"	"STC_1"
"TTACCATCAAAGCGTG"	"PEC"
"TTACCATCATAATCGC"	"Cyst.PT"
"TTACCATGTTGTTGTG"	"Cyst.LOH,TAL-cell"
"TTACCATTCCATTGTT"	"T-cell"
"TTACCGCCAGTTGCGC"	"T-cell"
"TTACCGCTCTCCTACG"	"VSMC"
"TTACGCCAGTTGCCCG"	"Cyst.IC-A"
"TTACGCCCATGGAAGC"	"Cyst.PT"
"TTACGCCTCATTGGTG"	"Mac"
"TTACGTTAGCACTTTG"	"EC"
"TTACGTTAGTGGGAAA"	"CTL/NK-cell"
"TTACGTTCACCGTCTT"	"Mono/Mac"
"TTACGTTTCTATCGCC"	"T-cell"
"TTACGTTTCTTAGTTC"	"CTL/NK-cell"
"TTACTGTAGCTGTTAC"	"Cyst.PT"
"TTACTGTGTAGCTGCC"	"T-cell"
"TTACTGTGTGCCTGAC"	"CTL/NK-cell"
"TTACTGTTCAGCAATC"	"T-cell"
"TTACTGTTCGTAACCA"	"T-cell"
"TTAGGCAAGACATCCT"	"Mac"
"TTAGGCACAACGACAG"	"Cyst.LOH,TAL-cell"
"TTAGGCACACAGTCCG"	"STC_2"
"TTAGGGTCAATAACCC"	"T-cell"
"TTAGGGTCACCAGCTG"	"STC_1"
"TTAGGGTGTCAGTCCG"	"STC_1"
"TTAGGGTGTTCCTAGA"	"STC_1"
"TTAGGGTTCACACCCT"	"T-cell"
"TTAGGGTTCGACGATT"	"EC"
"TTAGGGTTCTAGATCG"	"Cyst.LOH,TAL-cell"
"TTAGTCTAGAGTTGAT"	"Cyst.IC-A"
"TTAGTCTAGGCCTAAG"	"T-cell"
"TTAGTCTCATCTCCCA"	"VSMC"
"TTAGTCTGTTCTCCAC"	"B-cell"
"TTATTGCAGAGATGCC"	"T-cell"
"TTATTGCAGTGGTTCT"	"T-cell"
"TTATTGCGTAACTTCG"	"T-cell"
"TTATTGCGTCTACAGT"	"Cyst.PT"
"TTATTGCGTGGCCACT"	"T-cell"
"TTATTGCGTTATGGTC"	"Cyst.PT"
"TTATTGCGTTCCCACT"	"T-cell"
"TTCAATCTCAGGTAAA"	"T-cell"
"TTCAATCTCCACATAG"	"Cyst.LOH,TAL-cell"
"TTCAATCTCGGCTCTT"	"T-cell"
"TTCACCGGTGCATTAC"	"CTL/NK-cell"
"TTCACCGGTGCCTACG"	"T-cell"
"TTCACCGGTGGCTAGA"	"T-cell"
"TTCACGCAGACATCAA"	"STC_1"
"TTCACGCCACACACTA"	"PEC"
"TTCACGCGTAACACGG"	"CTL/NK-cell"
"TTCACGCGTAGTCTTG"	"Cyst.PT"
"TTCACGCGTTCCGCTT"	"PEC"
"TTCAGGACAACTTGCA"	"PEC"
"TTCAGGAGTCCTGGGT"	"Cyst.LOH,TAL-cell"
"TTCATGTAGTCGCGAA"	"STC_1"
"TTCATGTGTCATACCA"	"Cyst.LOH,TAL-cell"
"TTCATGTGTTAAGACA"	"B-cell"
"TTCATTGGTCATCCCT"	"STC_1"
"TTCATTGTCTGCTCTG"	"Cyst.PT"
"TTCCAATAGTCAAGCG"	"VSMC"
"TTCCAATCATCCAATG"	"PEC"
"TTCCAATGTGCGAACA"	"Mac"
"TTCCAATTCACTGAAC"	"Cyst.PT"
"TTCCAATTCATCGCTC"	"T-cell"
"TTCCAATTCGAAGAAT"	"T-cell"
"TTCCACGAGCAACTTC"	"Cyst.PT"
"TTCCACGAGTGCAAAT"	"Mono/Mac"
"TTCCACGCATCGTGGC"	"Mac"
"TTCCACGGTACTCAAC"	"STC_2"
"TTCCACGGTCAGCTTA"	"STC_1"
"TTCCACGGTCGCCACA"	"Fibroblast"
"TTCCGGTGTACGTACT"	"T-cell"
"TTCCGGTGTGACAACG"	"Cyst.PT"
"TTCCGGTGTGGGACAT"	"T-cell"
"TTCCGTGAGAAGCGGG"	"CTL/NK-cell"
"TTCCGTGCACCCTGTT"	"Fibroblast"
"TTCCTAAAGCCAAGCA"	"Mac"
"TTCCTAAAGGATTTCC"	"VSMC"
"TTCCTAAAGGCTAACG"	"Cyst.LOH,TAL-cell"
"TTCCTAACACGAGAAC"	"T-cell"
"TTCCTCTAGACTGAGC"	"Mac"
"TTCCTCTAGCATTGAA"	"Cyst.LOH,TAL-cell"
"TTCCTCTCAGGGTCTC"	"Cyst.PT"
"TTCCTCTCAGGTATGG"	"PEC"
"TTCCTCTGTATCCTCC"	"Cyst.LOH,TAL-cell"
"TTCCTCTGTTCTATCT"	"T-cell"
"TTCCTTCAGGAACTCG"	"Mono/Mac"
"TTCCTTCCAATCAAGA"	"T-cell"
"TTCCTTCCACTCAGAT"	"EC"
"TTCCTTCGTACTTGTG"	"Cyst.LOH,TAL-cell"
"TTCCTTCTCCCGTAAA"	"T-cell"
"TTCGATTCATGTCGTA"	"CTL/NK-cell"
"TTCGATTTCTCCATAT"	"Cyst.LOH,TAL-cell"
"TTCGCTGCAACCAGAG"	"Fibroblast"
"TTCGCTGCATAGGAGC"	"Cyst.LOH,TAL-cell"
"TTCGGTCCACTCTAGA"	"Cyst.LOH,TAL-cell"
"TTCGGTCGTTGTACGT"	"Cyst.LOH,TAL-cell"
"TTCTAACAGGATACCG"	"STC_1"
"TTCTAACCAATACCTG"	"STC_1"
"TTCTAACCAGAACTCT"	"STC_1"
"TTCTAACGTCCCTAAA"	"Cyst.PT"
"TTCTAACGTGTCCATA"	"T-cell"
"TTCTAGTGTCTTGAAC"	"PEC"
"TTCTAGTGTGACAGGT"	"CTL/NK-cell"
"TTCTAGTGTGTTCAGT"	"PEC"
"TTCTCTCCAGTCGCTG"	"T-cell"
"TTCTCTCGTCGCACAC"	"STC_1"
"TTCTCTCTCCTTGAAG"	"EC"
"TTCTCTCTCGCCACTT"	"CTL/NK-cell"
"TTCTGTAAGGTCTTTG"	"VSMC"
"TTCTGTAAGTATAGAC"	"Mono/Mac"
"TTCTGTACAGCATCTA"	"T-cell"
"TTCTTCCAGAAGGTAG"	"STC_1"
"TTCTTCCAGATTTGCC"	"Cyst.PT"
"TTCTTCCGTGAAGCTG"	"T-cell"
"TTCTTCCGTGAGATTA"	"Cyst.LOH,TAL-cell"
"TTCTTCCGTTCGCGTG"	"Cyst.LOH,TAL-cell"
"TTCTTGAAGCATTTCG"	"STC_1"
"TTCTTGAAGCCAGAGT"	"T-cell"
"TTCTTGAAGGATGTTA"	"Mono/Mac"
"TTCTTGACAGCCGTTG"	"STC_1"
"TTCTTGAGTGTATTGC"	"Mono/Mac"
"TTGAACGCACCAAAGG"	"T-cell"
"TTGAACGCAGAACTAA"	"Mast-cell"
"TTGACCCAGCGGTATG"	"Cyst.IC-A"
"TTGACCCAGTTGCCCG"	"B-cell"
"TTGACCCCAACTCCCT"	"CTL/NK-cell"
"TTGACCCCAGACGCTC"	"STC_1"
"TTGAGTGTCGAACGGA"	"Cyst.LOH,TAL-cell"
"TTGCATTCAACTGAAA"	"Cyst.PT"
"TTGCATTGTTCTCCTG"	"Cyst.PT"
"TTGCATTGTTTCGTAG"	"Cyst.PT"
"TTGCATTTCTAGCAAC"	"Mono/Mac"
"TTGCCTGGTTCGCGTG"	"Cyst.LOH,TAL-cell"
"TTGCCTGTCTCATGGA"	"Cyst.LOH,TAL-cell"
"TTGCGTCAGACGCTCC"	"T-cell"
"TTGCGTCAGAGGCGGA"	"EC"
"TTGCGTCCATTGGATC"	"Cyst.PT"
"TTGCTGCGTACTCGCG"	"VSMC"
"TTGCTGCTCTTACCAT"	"Cyst.LOH,TAL-cell"
"TTGGATGGTACCTAAC"	"T-cell"
"TTGGATGTCAAATGAG"	"Mono/Mac"
"TTGGGATAGACCCGCT"	"T-cell"
"TTGGGATGTGTTTGCA"	"Mono/Mac"
"TTGGGCGAGGTTCTAC"	"Cyst.PT"
"TTGGGCGCAAGACCTT"	"VSMC"
"TTGGGCGTCGACCACG"	"VSMC"
"TTGGGTACATGGTGGA"	"B-cell"
"TTGGGTAGTGTTCCTC"	"PEC"
"TTGGTTTAGTTCATCG"	"T-cell"
"TTGTGGAAGGCGAAGG"	"STC_1"
"TTGTGGAGTCTACGAT"	"Mono/Mac"
"TTGTGGAGTGCTCCGA"	"CTL/NK-cell"
"TTGTGGAGTGTTTACG"	"STC_1"
"TTGTGGAGTTCGTAAC"	"STC_1"
"TTGTGGATCTCTTAAC"	"Cyst.LOH,TAL-cell"
"TTGTGTTAGAAGTCTA"	"Cyst.LOH,TAL-cell"
"TTGTGTTAGAGAGCGG"	"CTL/NK-cell"
"TTGTTCAAGAGGCGGA"	"T-cell"
"TTGTTCAAGCCTCTGG"	"Mono/Mac"
"TTGTTCATCAAACCTG"	"Mono/Mac"
"TTGTTGTCAAGACCGA"	"T-cell"
"TTGTTGTGTACCAATC"	"Cyst.IC-A"
"TTGTTGTTCAGCGCGT"	"Cyst.IC-A"
"TTGTTTGCAACCACAT"	"Cyst.PT"
"TTGTTTGGTACGCTTA"	"Cyst.LOH,TAL-cell"
"TTGTTTGGTTTCGTTT"	"Cyst.LOH,TAL-cell"
"TTGTTTGTCACGAACT"	"B-cell"
"TTTACCACATACTGAC"	"Mast-cell"
"TTTACGTAGAGTGGCT"	"T-cell"
"TTTACGTGTGTCTCCT"	"Mono/Mac"
"TTTACGTTCTACTATC"	"T-cell"
"TTTACTGCAGTGGGTA"	"PEC"
"TTTACTGGTACGGTTT"	"Mac"
"TTTACTGGTAGATTGA"	"T-cell"
"TTTACTGGTGGCGCTT"	"Cyst.LOH,TAL-cell"
"TTTACTGGTGTGGACA"	"T-cell"
"TTTACTGTCTACACAG"	"T-cell"
"TTTAGTCAGGCACAAC"	"CTL/NK-cell"
"TTTAGTCCACTGTGAT"	"T-cell"
"TTTAGTCGTACACGCC"	"T-cell"
"TTTAGTCGTGGACTAG"	"Fibroblast"
"TTTAGTCTCGTAATGC"	"B-cell"
"TTTCACAAGGGCTTCC"	"CTL/NK-cell"
"TTTCACACACAGCGCT"	"PEC"
"TTTCACACATTCATCT"	"Cyst.PT"
"TTTCACAGTTACGATC"	"Fibroblast"
"TTTCAGTCAGATTTCG"	"PEC"
"TTTCATGAGACCAACG"	"Cyst.LOH,TAL-cell"
"TTTCATGAGTGGAAGA"	"Cyst.PT"
"TTTCATGTCTGGAGAG"	"PEC"
"TTTCCTCGTCACTAGT"	"STC_1"
"TTTCCTCTCACAGTGT"	"B-cell"
"TTTCGATAGGTGCGAT"	"T-cell"
"TTTCGATGTAAGATCA"	"STC_2"
"TTTCGATTCTAGCATG"	"STC_1"
"TTTGACTAGCGCCTTG"	"Cyst.PT"
"TTTGACTCACCTGTCT"	"Mono/Mac"
"TTTGACTCACGAGAAC"	"Mono/Mac"
"TTTGACTCATCTATCT"	"Cyst.LOH,TAL-cell"
"TTTGACTGTACTCGCG"	"Cyst.LOH,TAL-cell"
"TTTGACTTCCATACAG"	"PEC"
"TTTGACTTCCCATGGG"	"STC_2"
"TTTGACTTCGTTATCT"	"STC_2"
"TTTGATCAGGGTTGCA"	"Mac"
"TTTGATCTCCGCAAAT"	"EC"
"TTTGATCTCGGTCACG"	"CTL/NK-cell"
"TTTGATCTCTACGGTA"	"T-cell"
"TTTGATCTCTCGACGG"	"Mono/Mac"
"TTTGGAGGTGGATACG"	"Cyst.LOH,TAL-cell"
"TTTGGTTAGGGAGGCA"	"T-cell"
"TTTGGTTCAACGATTC"	"Mono/Mac"
"TTTGGTTCAAGACGGT"	"PEC"
"TTTGGTTGTCTAACGT"	"Cyst.LOH,TAL-cell"
"TTTGGTTGTGGAAGTC"	"Mono/Mac"
"TTTGGTTTCTCTCGAC"	"T-cell"
"TTTGTTGAGTCATCGT"	"Cyst.PT"
"TTTGTTGCATTCACAG"	"Cyst.LOH,TAL-cell"
"TTTGTTGGTGACTATC"	"Mast-cell"
"TTTGTTGTCGGTGCAC"	"Mono/Mac"
"TTTGTTGTCTGTAAGC"	"VSMC"
