""	"Ident"
"AAACCCAAGTACAGAT"	"Cyst.PC-CD"
"AAACCCAAGTCACTGT"	"Cyst.PC-CD"
"AAACCCACACAACGCC"	"Cyst.IM-CD"
"AAACCCACATAACAGA"	"Cyst.IM-CD"
"AAACCCAGTTACCCAA"	"Cyst.CD"
"AAACCCATCCTAGCGG"	"Cyst.cTAL"
"AAACCCATCCTTTGAT"	"PEC"
"AAACGAAAGCGAAACC"	"Cyst.IC-A_1"
"AAACGAAGTCTTAGTG"	"Cyst.IC-A_1"
"AAACGAAGTCTTGAGT"	"Podocytes"
"AAACGAAGTTCACGAT"	"Cyst.PC-CD"
"AAACGAATCATGCTAG"	"B-cell_2"
"AAACGAATCCGAAGGA"	"Cyst.PC-CD"
"AAACGAATCGGCATAT"	"Cyst.IM-CD"
"AAACGCTAGTTAGTAG"	"Cyst.PC-CD"
"AAACGCTCACCTGCAG"	"Mast-cell"
"AAACGCTCATTAGGCT"	"Cyst.IC-A_2"
"AAACGCTGTAATTGGA"	"PEC"
"AAACGCTGTGGCTAGA"	"Cyst.IM-CD"
"AAACGCTGTGTAGTGG"	"Cyst.PC-CD"
"AAAGAACAGGAGCTGT"	"Cyst.cTAL"
"AAAGAACAGGCAGGTT"	"Podocytes"
"AAAGAACAGGGTCAAC"	"Cyst.PC-CD"
"AAAGAACGTCCGGACT"	"Cyst.IC-A_1"
"AAAGAACGTGAGTTTC"	"Cyst.IC-A_2"
"AAAGAACGTGGATACG"	"Cyst.cTAL"
"AAAGAACGTTCGGTCG"	"Cyst.cTAL"
"AAAGAACTCTTAGTTC"	"T-cell"
"AAAGGATAGAGTCTTC"	"Cyst.cTAL"
"AAAGGATAGGGCTTCC"	"Cyst.IC-A_1"
"AAAGGATAGTGCGCTC"	"Cyst.IM-CD"
"AAAGGATAGTTCTCTT"	"Cyst.PC-CD"
"AAAGGATTCTCCTACG"	"Cyst.IM-CD"
"AAAGGGCAGGATGGCT"	"Mac/DC"
"AAAGGGCAGGTGCTGA"	"Cyst.cTAL"
"AAAGGGCAGTGGGAAA"	"Cyst.PC-CD"
"AAAGGGCCAAGGTTGG"	"Cyst.cTAL"
"AAAGGGCGTAGTGTGG"	"Cyst.PC-CD"
"AAAGGGCGTGCAAGAC"	"Cyst.IM-CD"
"AAAGGGCGTGCCGAAA"	"Cyst.CD"
"AAAGGGCTCATGGCCG"	"Cyst.cTAL"
"AAAGGTAAGTAGCATA"	"Cyst.CD"
"AAAGGTAAGTTGGCGA"	"Cyst.IM-CD"
"AAAGGTACAAACCGGA"	"Cyst.IM-CD"
"AAAGGTACAATTGCAC"	"VSMC"
"AAAGGTACACTGGCGT"	"T-cell"
"AAAGGTAGTTATGTGC"	"Cyst.PC-CD"
"AAAGTCCGTTACACTG"	"PEC"
"AAAGTCCTCCCGAGTG"	"PEC"
"AAAGTCCTCGCTAGCG"	"Podocytes"
"AAAGTCCTCGTCGGGT"	"Cyst.PC-CD"
"AAAGTCCTCTGAGATC"	"Mac/DC"
"AAAGTGAAGGGTACAC"	"Cyst.PC-CD"
"AAAGTGACACACACTA"	"Cyst.PC-CD"
"AAAGTGACACGAAGAC"	"Cyst.IM-CD"
"AAAGTGACATCGATGT"	"Cyst.cTAL"
"AAAGTGAGTAGGGTAC"	"Mast-cell"
"AAAGTGATCGCGTTTC"	"Mac/DC"
"AAATGGAAGACGGAAA"	"Cyst.IM-CD"
"AAATGGAAGTAGTGCG"	"B-cell_2"
"AAATGGACAACCGTAT"	"Cyst.IC-A_1"
"AAATGGACAAGGTACG"	"EC"
"AAATGGACATGACTAC"	"Cyst.IM-CD"
"AAATGGACATTGACTG"	"T-cell"
"AAATGGAGTAGTGCGA"	"Podocytes"
"AAATGGAGTCCGGTGT"	"Cyst.IC-A_2"
"AAATGGATCCTCTCTT"	"PEC"
"AAATGGATCGGTCAGC"	"Cyst.PT_1"
"AACAAAGAGACGCATG"	"Cyst.IC-A_1"
"AACAAAGAGAGGACTC"	"Cyst.PT_1"
"AACAAAGAGCATGAAT"	"Cyst.PC-CD"
"AACAAAGAGTGCACCC"	"Cyst.IM-CD"
"AACAAAGCAGCTACTA"	"Cyst.IM-CD"
"AACAAAGGTACAGTTC"	"VSMC"
"AACAAAGTCGACACTA"	"Podocytes"
"AACAAAGTCGTGTTCC"	"Cyst.IM-CD"
"AACAAAGTCTCTGCCA"	"Cyst.PC-CD"
"AACAACCAGACCAAAT"	"Cyst.IC-A_2"
"AACAACCAGGATCATA"	"Cyst.IM-CD"
"AACAACCGTAGGTACG"	"Cyst.IC-A_2"
"AACAACCTCACCCTTG"	"Cyst.cTAL"
"AACAAGAAGAGAAGGT"	"PEC"
"AACAAGAAGTGAGTGC"	"Cyst.CD"
"AACAAGACACGTTCGG"	"Cyst.PT_2"
"AACAAGACACTGATTG"	"Cyst.IC-A_2"
"AACAAGAGTAGTCCTA"	"PEC"
"AACAAGAGTTTAGAGA"	"Cyst.PT_1"
"AACAAGATCAGATTGC"	"Cyst.PC-CD"
"AACACACCATGTTACG"	"Cyst.PC-CD"
"AACACACGTGTTATCG"	"Cyst.IC-A_1"
"AACACACGTTCCCAAA"	"Cyst.PT_2"
"AACACACTCATTGCTT"	"Cyst.IC-A_2"
"AACACACTCGGTTCAA"	"Cyst.IC-A_1"
"AACACACTCTCGTGGG"	"Cyst.PC-CD"
"AACAGGGAGTGCGCTC"	"Cyst.IC-A_2"
"AACAGGGCACGTACAT"	"Mast-cell"
"AACAGGGTCCTTCAGC"	"Cyst.PC-CD"
"AACCAACAGATTAGAC"	"Podocytes"
"AACCAACAGTAGTCCT"	"Cyst.PC-CD"
"AACCAACCACGACAGA"	"VSMC"
"AACCAACCAGTAGTTC"	"Cyst.CD"
"AACCAACCATATGAAG"	"Mast-cell"
"AACCAACCATCGCTGG"	"Cyst.PC-CD"
"AACCAACTCAACACCA"	"Cyst.PC-CD"
"AACCAACTCTAAGCCA"	"T-cell"
"AACCACAAGATCGACG"	"Podocytes"
"AACCACACACGTTCGG"	"Cyst.IM-CD"
"AACCACACAGCAGAAC"	"Cyst.IC-A_1"
"AACCACAGTCGCCTAG"	"Cyst.IC-A_1"
"AACCACATCCCACAGG"	"PEC"
"AACCACATCCTGTTGC"	"Cyst.IC-A_2"
"AACCACATCTTTACAC"	"PEC"
"AACCATGAGCTTAAGA"	"Cyst.IM-CD"
"AACCATGCAACGATTC"	"Cyst.IM-CD"
"AACCATGGTCACTTCC"	"PEC"
"AACCATGTCCTGTTAT"	"Cyst.PC-CD"
"AACCCAAAGATCACCT"	"Cyst.IM-CD"
"AACCCAAAGTCAGAGC"	"Cyst.cTAL"
"AACCCAACAGTTCCAA"	"Cyst.PC-CD"
"AACCCAAGTCTCAGAT"	"Cyst.PT_2"
"AACCCAAGTTGGCCTG"	"Cyst.PC-CD"
"AACCCAATCCCTCAAC"	"PEC"
"AACCTGAAGCCTGTCG"	"EC"
"AACCTGAAGGGATCGT"	"VSMC"
"AACCTGACAATGACCT"	"Cyst.PC-CD"
"AACCTGACACAAAGCG"	"Podocytes"
"AACCTGACATTAAAGG"	"PEC"
"AACCTGATCCTTCTAA"	"Cyst.PC-CD"
"AACCTTTAGCGTTCAT"	"PEC"
"AACCTTTAGCTAAACA"	"Cyst.IM-CD"
"AACCTTTCAATCTAGC"	"Cyst.IM-CD"
"AACCTTTGTACTAACC"	"Cyst.IC-A_2"
"AACCTTTGTGTCGATT"	"Podocytes"
"AACCTTTGTTAATCGC"	"Cyst.PC-CD"
"AACCTTTTCCGAAATC"	"Cyst.IM-CD"
"AACGAAAAGGATACAT"	"Cyst.PT_2"
"AACGAAAAGGTGCTGA"	"Cyst.CD"
"AACGAAACAATCTGCA"	"EC"
"AACGAAAGTAGATCGG"	"Cyst.PC-CD"
"AACGAAAGTCGTGTTA"	"Cyst.IC-A_1"
"AACGAAAGTTCGGGTC"	"Cyst.IC-A_1"
"AACGGGAAGCACTCAT"	"Cyst.PT_2"
"AACGGGAAGTTCCATG"	"T-cell"
"AACGGGAGTAGTCCTA"	"Cyst.IC-A_1"
"AACGGGAGTCGAAGCA"	"Cyst.IC-A_2"
"AACGGGATCCATAAGC"	"Cyst.PC-CD"
"AACGGGATCTCACGAA"	"EC"
"AACGTCAAGCTGACTT"	"Cyst.cTAL"
"AACGTCACACCAGCGT"	"Cyst.IC-A_1"
"AACGTCACATTAAGCC"	"Cyst.IC-A_1"
"AACGTCAGTTAAGCAA"	"Cyst.IM-CD"
"AACGTCATCACTGATG"	"Cyst.PC-CD"
"AACGTCATCTAGCAAC"	"Cyst.IC-A_1"
"AACGTCATCTTGGTCC"	"VSMC"
"AACTTCTGTAGGTGCA"	"Cyst.PC-CD"
"AACTTCTTCCTCTCTT"	"Cyst.IC-A_2"
"AAGAACACACATTGTG"	"Cyst.PC-CD"
"AAGAACACACTCCGAG"	"Cyst.PT_2"
"AAGAACACATAATCCG"	"Cyst.IC-A_2"
"AAGAACAGTATGAGCG"	"Cyst.cTAL"
"AAGAACAGTGTAGGAC"	"Cyst.IC-A_1"
"AAGAACAGTTGCATTG"	"Cyst.PC-CD"
"AAGACAAAGCAAGTGC"	"Cyst.PC-CD"
"AAGACAAAGGACAGTC"	"Cyst.IC-A_1"
"AAGACAACAATAGGGC"	"Cyst.PC-CD"
"AAGACAACATCGTGGC"	"T-cell"
"AAGACAATCAGTCATG"	"Mast-cell"
"AAGACAATCTCAGAAC"	"Cyst.IM-CD"
"AAGACTCAGAACAGGA"	"Cyst.PC-CD"
"AAGACTCAGATAACAC"	"Podocytes"
"AAGACTCAGGATTTCC"	"Cyst.PC-CD"
"AAGACTCAGGCTATCT"	"Cyst.IC-A_2"
"AAGACTCCAGCAGTTT"	"Cyst.cTAL"
"AAGACTCGTAGTCGTT"	"B-cell_2"
"AAGACTCTCCATTTGT"	"Podocytes"
"AAGACTCTCCTAGAGT"	"Cyst.PC-CD"
"AAGACTCTCGCAATTG"	"Cyst.IM-CD"
"AAGATAGAGCTGAGTG"	"Cyst.IM-CD"
"AAGATAGCACAGACGA"	"Podocytes"
"AAGATAGCAGCTTTGA"	"Cyst.IM-CD"
"AAGCATCAGCCTCTGG"	"Cyst.PC-CD"
"AAGCATCAGGGTCTTT"	"Cyst.PC-CD"
"AAGCATCCATAGAATG"	"Cyst.PC-CD"
"AAGCCATAGTTCACTG"	"Cyst.PC-CD"
"AAGCCATCAATTGGTC"	"Cyst.PC-CD"
"AAGCCATCACCTGCGA"	"PEC"
"AAGCCATCACGATTCA"	"Cyst.PT_1"
"AAGCCATCAGAATCGG"	"Cyst.IM-CD"
"AAGCCATCAGCAGACA"	"PEC"
"AAGCCATCAGCTCTGG"	"Cyst.PT_2"
"AAGCCATCATCCGTGG"	"EC"
"AAGCCATGTATCTCGA"	"T-cell"
"AAGCCATGTTGCGGCT"	"Cyst.PC-CD"
"AAGCCATTCGCAACAT"	"Podocytes"
"AAGCCATTCGGACCAC"	"Cyst.IM-CD"
"AAGCCATTCTCATGCC"	"Cyst.IM-CD"
"AAGCCATTCTGGCCAG"	"Cyst.cTAL"
"AAGCGAGAGCCTTTCC"	"PEC"
"AAGCGAGCAAGAGCTG"	"Cyst.cTAL"
"AAGCGAGCAGGCTCTG"	"B-cell_1"
"AAGCGAGGTATCGCGC"	"Cyst.cTAL"
"AAGCGAGGTCGGTACC"	"Cyst.PC-CD"
"AAGCGAGGTGGCTCTG"	"EC"
"AAGCGAGTCCCAAGTA"	"VSMC"
"AAGCGAGTCCCAGGAC"	"Cyst.CD"
"AAGCGTTGTAGTATAG"	"PEC"
"AAGCGTTGTGCTGATT"	"PEC"
"AAGCGTTTCGGTCATA"	"PEC"
"AAGGAATAGAAGTATC"	"Cyst.PC-CD"
"AAGGAATAGTGGTGAC"	"Mast-cell"
"AAGGAATCAAGCTCTA"	"Cyst.IC-A_2"
"AAGGAATCACGATTCA"	"Cyst.cTAL"
"AAGGAATCATGGCGCT"	"Cyst.PC-CD"
"AAGGAATGTCCCACGA"	"Cyst.IC-A_2"
"AAGGAATGTGTTCGAT"	"Podocytes"
"AAGGAATTCGGATAAA"	"Cyst.IM-CD"
"AAGGAATTCTGGTGGC"	"Mac/DC"
"AAGGAATTCTTGGATG"	"Cyst.PC-CD"
"AAGGTAAAGACCAAAT"	"Cyst.IM-CD"
"AAGGTAAAGAGAAGGT"	"Cyst.PC-CD"
"AAGGTAAAGAGTTCGG"	"T-cell"
"AAGGTAAAGCAGTAAT"	"PEC"
"AAGGTAAAGGTTACCT"	"Podocytes"
"AAGGTAACACAACGAG"	"VSMC"
"AAGGTAACAGTTGCGC"	"Cyst.PC-CD"
"AAGGTAACATCGCCTT"	"Mac/DC"
"AAGGTAATCGATACTG"	"PEC"
"AAGGTAATCTGCGATA"	"Cyst.PC-CD"
"AAGTACCAGAGATTCA"	"Cyst.IC-A_2"
"AAGTACCAGGTCCCGT"	"Cyst.PC-CD"
"AAGTACCCACACCGCA"	"Cyst.PC-CD"
"AAGTACCGTATTGAGA"	"Cyst.IC-A_1"
"AAGTACCGTTTACCAG"	"Cyst.PC-CD"
"AAGTACCTCCGCTAGG"	"PEC"
"AAGTCGTAGCCGGATA"	"Cyst.cTAL"
"AAGTCGTAGTGTAGTA"	"Cyst.PT_2"
"AAGTCGTCATCTCGTC"	"EC"
"AAGTCGTGTGCCTAAT"	"Cyst.IC-A_2"
"AAGTGAACAGAACCGA"	"Cyst.IM-CD"
"AAGTGAAGTACGGATG"	"Cyst.IC-A_2"
"AAGTGAAGTGAATTGA"	"Podocytes"
"AAGTGAAGTTAGGGAC"	"Cyst.PT_2"
"AAGTGAAGTTTGCCGG"	"Cyst.PC-CD"
"AAGTGAATCACCGACG"	"PEC"
"AAGTTCGAGGAGAGGC"	"PEC"
"AAGTTCGTCACTGATG"	"Cyst.PC-CD"
"AAGTTCGTCTTCTTCC"	"Cyst.PC-CD"
"AATAGAGCAACTCATG"	"Cyst.PC-CD"
"AATAGAGCAAGAAACT"	"Cyst.PC-CD"
"AATAGAGCACTCCTGT"	"T-cell"
"AATAGAGTCCTAACAG"	"Cyst.IM-CD"
"AATAGAGTCCTACCGT"	"Cyst.IM-CD"
"AATAGAGTCGGAAGGT"	"Cyst.cTAL"
"AATAGAGTCTCACGAA"	"T-cell"
"AATCACGAGAAGAGCA"	"Cyst.IC-A_1"
"AATCACGAGCACTGGA"	"Cyst.IM-CD"
"AATCACGAGCGAGGAG"	"Cyst.IM-CD"
"AATCACGAGGCTAGCA"	"Cyst.IM-CD"
"AATCACGCAACGGCCT"	"Cyst.PT_2"
"AATCACGCAGACCATT"	"Cyst.cTAL"
"AATCACGTCGTGCATA"	"T-cell"
"AATCACGTCTCTCGCA"	"Cyst.PC-CD"
"AATCGACAGTGGTTGG"	"Cyst.PT_1"
"AATCGACCACGGTCTG"	"Cyst.PC-CD"
"AATCGACCACTCAAGT"	"PEC"
"AATCGACCATCGCTGG"	"Cyst.IC-A_1"
"AATCGACTCAAATAGG"	"Mac/DC"
"AATCGACTCCTTGACC"	"PEC"
"AATCGACTCGACATAC"	"Cyst.IC-A_2"
"AATCGACTCTCCAAGA"	"Cyst.PC-CD"
"AATCGACTCTCCACTG"	"B-cell_1"
"AATCGTGCAAATAGCA"	"Cyst.IM-CD"
"AATCGTGCATGTCTAG"	"Cyst.IM-CD"
"AATCGTGTCGGACAAG"	"Cyst.IM-CD"
"AATGAAGAGACTCCGC"	"EC"
"AATGAAGAGCGTGAGT"	"Cyst.PC-CD"
"AATGAAGAGTCGAAAT"	"PEC"
"AATGAAGAGTCTCTGA"	"Cyst.PC-CD"
"AATGAAGCAACGCATT"	"Cyst.PT_2"
"AATGAAGCAAGAGCTG"	"Mac/DC"
"AATGAAGGTATCGGTT"	"Cyst.IC-A_2"
"AATGAAGGTCGAACGA"	"Cyst.PC-CD"
"AATGAAGGTCGCATTA"	"Cyst.PC-CD"
"AATGAAGTCCCTTGGT"	"Cyst.IM-CD"
"AATGAAGTCGCCAATA"	"Cyst.PC-CD"
"AATGAAGTCTCCCTAG"	"Cyst.PT_1"
"AATGAAGTCTGGGATT"	"Cyst.PC-CD"
"AATGACCAGGACAAGA"	"Cyst.IC-A_1"
"AATGACCCAGGTTTAC"	"Cyst.IC-A_1"
"AATGACCGTCAACCTA"	"Cyst.PC-CD"
"AATGACCGTCCGTACG"	"Mast-cell"
"AATGACCTCTTGATTC"	"Cyst.PC-CD"
"AATGCCAGTAGCTCGC"	"Cyst.cTAL"
"AATGCCATCCATATGG"	"PEC"
"AATGGAAAGATTGCGG"	"Podocytes"
"AATGGAAAGTAAAGCT"	"B-cell_1"
"AATGGAACAACCGTGC"	"Cyst.cTAL"
"AATGGAATCTGTCTCG"	"Cyst.IC-A_2"
"AATGGCTAGTTGTCGT"	"Cyst.IM-CD"
"AATGGCTCAGACAAAT"	"VSMC"
"AATGGCTTCGCATAGT"	"Cyst.CD"
"AATGGCTTCTTTCTAG"	"Cyst.IM-CD"
"AATTCCTAGATTACCC"	"Cyst.PC-CD"
"AATTCCTAGGTCGACA"	"PEC"
"AATTCCTCAATAGGAT"	"PEC"
"AATTCCTCACTGTGTA"	"Podocytes"
"AATTCCTTCGGAGATG"	"Cyst.PC-CD"
"AATTTCCGTACTAGCT"	"PEC"
"AATTTCCGTGGGATTG"	"Mast-cell"
"AATTTCCGTTGGACTT"	"PEC"
"AATTTCCTCGACATTG"	"Cyst.PC-CD"
"ACAAAGAAGAAGTGTT"	"Podocytes"
"ACAAAGAAGAGTTGCG"	"EC"
"ACAAAGACAGATCCTA"	"Cyst.IM-CD"
"ACAAAGAGTTCAGCTA"	"Cyst.PC-CD"
"ACAAAGAGTTCGGCGT"	"Cyst.IM-CD"
"ACAAAGAGTTCTCCTG"	"Cyst.PC-CD"
"ACAAAGAGTTGGACTT"	"Cyst.CD"
"ACAAAGATCGCAGATT"	"T-cell"
"ACAAAGATCTAGGCAT"	"Cyst.IC-A_1"
"ACAACCAAGCGGGTTA"	"Cyst.IC-A_1"
"ACAACCAAGGAGGGTG"	"Cyst.IM-CD"
"ACAACCAAGGCTAACG"	"Cyst.PC-CD"
"ACAACCACAACAGATA"	"Cyst.PC-CD"
"ACAACCACAGCCCAGT"	"Cyst.CD"
"ACAACCAGTAGGACCA"	"Cyst.IC-A_2"
"ACAACCAGTTCAATCG"	"Cyst.PC-CD"
"ACAACCAGTTGAAGTA"	"Cyst.CD"
"ACAAGCTAGCATTTCG"	"Cyst.IM-CD"
"ACAAGCTAGGTTGACG"	"PEC"
"ACAAGCTAGTGGACGT"	"Cyst.CD"
"ACAAGCTAGTGGCAGT"	"Cyst.PC-CD"
"ACAAGCTAGTTCCATG"	"Cyst.IM-CD"
"ACAAGCTCACCCTAGG"	"Cyst.PT_1"
"ACAAGCTCATGGGTTT"	"Cyst.PC-CD"
"ACAAGCTTCATCGGGC"	"Cyst.PC-CD"
"ACAAGCTTCCGCGATG"	"Cyst.IC-A_1"
"ACACAGTAGGAACGCT"	"Podocytes"
"ACACAGTAGTTCACTG"	"Cyst.PC-CD"
"ACACAGTCACTACTTT"	"Cyst.PC-CD"
"ACACAGTGTACTCCGG"	"VSMC"
"ACACAGTGTAGTGGCA"	"Cyst.IC-A_1"
"ACACAGTTCAGCTGTA"	"Cyst.cTAL"
"ACACCAAAGGATTTCC"	"Cyst.IC-A_1"
"ACACCAACAGACTGCC"	"Mast-cell"
"ACACCAAGTACAGAGC"	"PEC"
"ACACCAAGTGCATGTT"	"PEC"
"ACACCAATCTTCGGTC"	"Cyst.CD"
"ACACGCGAGAGGTCAC"	"Cyst.IM-CD"
"ACACGCGAGTCATGCT"	"Cyst.PC-CD"
"ACACGCGCATCGCTGG"	"Cyst.IM-CD"
"ACACGCGGTACGTTCA"	"Cyst.cTAL"
"ACACGCGGTAGGTGCA"	"Cyst.PC-CD"
"ACACGCGGTATTAAGG"	"Cyst.PC-CD"
"ACACGCGGTCTGCGCA"	"Cyst.PC-CD"
"ACACTGAAGCCACTCG"	"Cyst.cTAL"
"ACACTGAGTGTATCCA"	"Cyst.IC-A_1"
"ACACTGATCAAGGCTT"	"Cyst.cTAL"
"ACACTGATCCACCTGT"	"Cyst.PT_1"
"ACACTGATCTGCGGGT"	"Cyst.IC-A_1"
"ACACTGATCTTGGAAC"	"Cyst.cTAL"
"ACAGAAAAGAGGTTAT"	"Cyst.cTAL"
"ACAGAAAAGCAGTACG"	"Cyst.IC-A_2"
"ACAGAAACAGAAGCGT"	"Mast-cell"
"ACAGAAACATTAAGCC"	"Cyst.IC-A_2"
"ACAGAAAGTGCCCAGT"	"Cyst.PC-CD"
"ACAGAAAGTTGCCATA"	"Cyst.PC-CD"
"ACAGAAATCCAGCACG"	"Podocytes"
"ACAGAAATCTCGTGGG"	"Cyst.PC-CD"
"ACAGCCGAGGGTCACA"	"Cyst.IM-CD"
"ACAGCCGGTACGTGAG"	"Podocytes"
"ACAGCCGGTTGCAAGG"	"Cyst.IM-CD"
"ACAGGGAAGATTGACA"	"Cyst.IM-CD"
"ACAGGGAAGGTGCTAG"	"Podocytes"
"ACAGGGACATCTCATT"	"PEC"
"ACAGGGATCCGAACGC"	"Cyst.IM-CD"
"ACAGGGATCGCTAAAC"	"Cyst.PC-CD"
"ACAGGGATCTTAAGGC"	"Cyst.PC-CD"
"ACATCCCCACGCACCA"	"Podocytes"
"ACATCCCCATCTAACG"	"Cyst.PC-CD"
"ACATCCCGTGACTGAG"	"PEC"
"ACATCCCGTTACCCAA"	"Mac/DC"
"ACATCCCTCGACATTG"	"Podocytes"
"ACATCCCTCGGTCGAC"	"Cyst.IM-CD"
"ACATCCCTCTCTCTTC"	"Cyst.IM-CD"
"ACATCGAAGACTAAGT"	"Cyst.PC-CD"
"ACATCGAGTAACACGG"	"Cyst.PC-CD"
"ACATCGAGTATTTCGG"	"Cyst.PC-CD"
"ACATCGATCCACGTGG"	"Cyst.IC-A_1"
"ACATCGATCGATCCCT"	"Cyst.PC-CD"
"ACATCGATCGTACACA"	"Cyst.PC-CD"
"ACATGCACACCGAATT"	"Cyst.PC-CD"
"ACATGCACACCTCTGT"	"Cyst.PC-CD"
"ACATGCACAGAGCTAG"	"Podocytes"
"ACATGCACATCCGGTG"	"VSMC"
"ACATGCACATTGCCTC"	"Cyst.IM-CD"
"ACATGCATCAGAACCT"	"Cyst.PC-CD"
"ACATGCATCGCCACTT"	"Cyst.PC-CD"
"ACATGCATCGGACTGC"	"T-cell"
"ACATTTCAGCTATCTG"	"T-cell"
"ACATTTCAGCTGAAGC"	"Cyst.IM-CD"
"ACATTTCAGTAATTGG"	"EC"
"ACATTTCCAATACCCA"	"PEC"
"ACATTTCCAGGTCCGT"	"Cyst.IC-A_2"
"ACATTTCGTCAGCGTC"	"Podocytes"
"ACATTTCGTCGTGGTC"	"VSMC"
"ACATTTCGTGCTCTCT"	"Mast-cell"
"ACATTTCGTTACTCAG"	"Cyst.IM-CD"
"ACATTTCGTTGAAGTA"	"PEC"
"ACATTTCTCGGTGAAG"	"PEC"
"ACCAAACAGATGACCG"	"Cyst.IC-A_2"
"ACCAAACAGCCATTGT"	"Cyst.PC-CD"
"ACCAAACCAGAATTCC"	"Podocytes"
"ACCAAACGTTTAAGGA"	"Cyst.PC-CD"
"ACCAAACTCAGACCGC"	"Cyst.PC-CD"
"ACCAAACTCGTGTGGC"	"Cyst.PC-CD"
"ACCAAACTCTGCGATA"	"Cyst.cTAL"
"ACCAACAAGAACCCGA"	"Cyst.IM-CD"
"ACCAACAAGCAGTACG"	"Cyst.IC-A_1"
"ACCAACAAGCCAGTAG"	"Cyst.PC-CD"
"ACCAACACAAACCATC"	"Cyst.IM-CD"
"ACCAACACACAGAGAC"	"Cyst.IC-A_2"
"ACCAACAGTGCAGATG"	"Cyst.CD"
"ACCAACAGTTAAGTCC"	"Mac/DC"
"ACCACAAAGACTTAAG"	"PEC"
"ACCACAAGTAAGTTAG"	"EC"
"ACCACAAGTCTTGGTA"	"Cyst.IM-CD"
"ACCACAAGTGATTGGG"	"Cyst.PC-CD"
"ACCACAAGTGTGCTTA"	"Cyst.PC-CD"
"ACCACAAGTTCTATCT"	"PEC"
"ACCACAAGTTTCCCAC"	"Cyst.IC-A_2"
"ACCACAATCAATCTCT"	"Cyst.PC-CD"
"ACCACAATCCGCTTAC"	"Cyst.CD"
"ACCACAATCTACGCGG"	"Cyst.IC-A_2"
"ACCACAATCTGCGGGT"	"Cyst.PC-CD"
"ACCATTTAGGCAGTCA"	"Mac/DC"
"ACCATTTAGTTAACAG"	"Cyst.PC-CD"
"ACCATTTCAGTGGGTA"	"Cyst.PC-CD"
"ACCATTTGTCCAAGAG"	"Cyst.IC-A_1"
"ACCATTTGTTATTCTC"	"Cyst.IM-CD"
"ACCATTTTCAGCTGAT"	"Cyst.IC-A_1"
"ACCATTTTCATGGCCG"	"Cyst.IM-CD"
"ACCATTTTCCCTGGTT"	"Podocytes"
"ACCATTTTCTTTACAC"	"Cyst.PC-CD"
"ACCCAAAAGATCACTC"	"Cyst.CD"
"ACCCAAAAGCAGAAAG"	"Podocytes"
"ACCCAAAAGGGCTGAT"	"Cyst.IM-CD"
"ACCCAAAAGTTTGTCG"	"Cyst.PC-CD"
"ACCCAAACAGCCGGTT"	"Podocytes"
"ACCCAAACAGTCGGTC"	"Podocytes"
"ACCCAAAGTACAGGTG"	"Cyst.IM-CD"
"ACCCAAAGTCATCAGT"	"Cyst.IM-CD"
"ACCCAAAGTGGCTTGC"	"Cyst.PC-CD"
"ACCCAAATCCATGATG"	"Cyst.PC-CD"
"ACCCAAATCGTTGTAG"	"Cyst.PC-CD"
"ACCCTCAAGTGATAAC"	"Cyst.IM-CD"
"ACCCTCACACCATATG"	"Cyst.cTAL"
"ACCCTCAGTAACCCTA"	"Cyst.PC-CD"
"ACCCTCAGTACGTAGG"	"VSMC"
"ACCCTCAGTTAACCTG"	"T-cell"
"ACCCTCATCGGATTAC"	"Cyst.PC-CD"
"ACCCTCATCTGCGGCA"	"Mac/DC"
"ACCCTTGAGCCGGATA"	"Cyst.PC-CD"
"ACCCTTGCACGCTGCA"	"PEC"
"ACCCTTGCATCCGATA"	"Cyst.PC-CD"
"ACCCTTGCATGTGACT"	"Cyst.PC-CD"
"ACCCTTGGTAAGCTCT"	"Cyst.PC-CD"
"ACCCTTGGTCCGAAAG"	"Cyst.IM-CD"
"ACCCTTGGTTTACCAG"	"Cyst.CD"
"ACCCTTGTCAAGCCGC"	"Podocytes"
"ACCCTTGTCCGGCTTT"	"PEC"
"ACCGTTCAGAATGTTG"	"Cyst.IM-CD"
"ACCGTTCAGCAGGTCA"	"Cyst.IC-A_2"
"ACCGTTCCAGTACTAC"	"PEC"
"ACCGTTCGTAGTTAGA"	"Cyst.IC-A_2"
"ACCGTTCGTATCGAAA"	"T-cell"
"ACCGTTCGTCCTCATC"	"Cyst.cTAL"
"ACCGTTCGTCGCGGTT"	"Cyst.IC-A_1"
"ACCGTTCTCCCTTGTG"	"Cyst.PC-CD"
"ACCGTTCTCGAGAACG"	"Cyst.IC-A_2"
"ACCGTTCTCGGCTGGT"	"Podocytes"
"ACCTACCAGGAAGAAC"	"Cyst.IC-A_2"
"ACCTACCAGTCACTGT"	"Podocytes"
"ACCTACCAGTTCCAGT"	"PEC"
"ACCTACCCAACGGGTA"	"Cyst.IM-CD"
"ACCTACCCAAGGGCAT"	"Podocytes"
"ACCTACCGTGTTTCTT"	"Cyst.cTAL"
"ACCTACCTCAACTGGT"	"Cyst.IM-CD"
"ACCTGAAAGGATTACA"	"Cyst.PC-CD"
"ACCTGAACAAAGGTTA"	"Mac/DC"
"ACCTGAACATAGTCAC"	"Cyst.IC-A_2"
"ACCTGAAGTTATCCAG"	"Cyst.IM-CD"
"ACCTGAATCGTTCCCA"	"PEC"
"ACCTGTCAGCAAGTGC"	"Podocytes"
"ACCTGTCAGGAGGTTC"	"Cyst.cTAL"
"ACCTGTCGTACAGTCT"	"Cyst.IM-CD"
"ACCTGTCGTGCCGAAA"	"Cyst.IC-A_2"
"ACCTGTCTCAAACCCA"	"Cyst.IM-CD"
"ACCTGTCTCCACACCT"	"Cyst.PC-CD"
"ACCTGTCTCGGACCAC"	"Mast-cell"
"ACGATCAAGCTACTAC"	"Cyst.PC-CD"
"ACGATCAAGGGCCTCT"	"Cyst.PC-CD"
"ACGATCAGTAGCTGCC"	"Mac/DC"
"ACGATCAGTATCGCAT"	"Cyst.IM-CD"
"ACGATCATCAAGATAG"	"Podocytes"
"ACGATCATCATGACAC"	"Cyst.IM-CD"
"ACGATGTAGAAATTGC"	"Cyst.PC-CD"
"ACGATGTAGCTGGTGA"	"EC"
"ACGATGTAGTAACCTC"	"Mac/DC"
"ACGATGTAGTAAGCAT"	"Cyst.cTAL"
"ACGATGTGTCATATGC"	"Cyst.CD"
"ACGATGTGTTAAAGTG"	"Podocytes"
"ACGATGTGTTAACAGA"	"T-cell"
"ACGATGTGTTACCCTC"	"Cyst.PC-CD"
"ACGATGTTCCGCGGAT"	"PEC"
"ACGATGTTCTTTGATC"	"Cyst.PC-CD"
"ACGCACGCAAAGCGTG"	"Cyst.IC-A_2"
"ACGCACGCACAGTATC"	"Cyst.PC-CD"
"ACGCACGCAGGGTCTC"	"EC"
"ACGCACGGTCCGGTCA"	"Podocytes"
"ACGCACGGTGATACTC"	"Cyst.IC-A_1"
"ACGCACGGTTCGAACT"	"EC"
"ACGCACGTCGCCACTT"	"VSMC"
"ACGCACGTCTTACGTT"	"Cyst.PC-CD"
"ACGCACGTCTTTCAGT"	"EC"
"ACGGAAGAGACAACTA"	"Cyst.cTAL"
"ACGGAAGAGGAACGTC"	"Cyst.IC-A_1"
"ACGGAAGCAACCGTGC"	"Podocytes"
"ACGGAAGGTGATGTAA"	"Cyst.PC-CD"
"ACGGAAGTCGTAACAC"	"Cyst.PC-CD"
"ACGGAAGTCTCTATGT"	"Cyst.IC-A_1"
"ACGGGTCCAATTCTTC"	"T-cell"
"ACGGGTCCACCACATA"	"Cyst.PC-CD"
"ACGGGTCTCCTTGACC"	"Cyst.PC-CD"
"ACGGGTCTCTGAATGC"	"Cyst.PC-CD"
"ACGGTCGAGGCATCTT"	"VSMC"
"ACGGTCGCAAACAGGC"	"Cyst.IM-CD"
"ACGGTCGCATCCGTGG"	"T-cell"
"ACGGTCGGTACCCGAC"	"Cyst.PC-CD"
"ACGGTCGGTCTCACAA"	"Cyst.cTAL"
"ACGGTCGTCATGGTAC"	"Cyst.PC-CD"
"ACGGTCGTCCATAAGC"	"Cyst.IM-CD"
"ACGGTTACACCCTATC"	"Cyst.PC-CD"
"ACGGTTACAGACGATG"	"Cyst.IM-CD"
"ACGGTTACAGCAGGAT"	"PEC"
"ACGGTTAGTACGCTTA"	"PEC"
"ACGGTTAGTATCGTTG"	"Cyst.IC-A_2"
"ACGGTTATCCATCGTC"	"Cyst.cTAL"
"ACGTAACAGAGTCAAT"	"Cyst.IM-CD"
"ACGTAACAGGCATCAG"	"PEC"
"ACGTAACAGTCGAATA"	"Cyst.IM-CD"
"ACGTAACGTCGAGCTC"	"Cyst.IC-A_1"
"ACGTAACGTCGTGGAA"	"Cyst.IC-A_2"
"ACGTAACTCAGAGTGG"	"EC"
"ACGTAACTCCGTTTCG"	"Cyst.cTAL"
"ACGTAACTCGAAACAA"	"Cyst.cTAL"
"ACGTAACTCGCCTCTA"	"Cyst.IC-A_1"
"ACGTACAAGAGTCAGC"	"Cyst.PC-CD"
"ACGTACAAGTCAGGGT"	"Cyst.IM-CD"
"ACGTACACACTGAGTT"	"Mac/DC"
"ACGTACACAGCTTCCT"	"Cyst.PC-CD"
"ACGTACACAGTCGTTA"	"Mac/DC"
"ACGTACAGTATCGAGG"	"Cyst.IM-CD"
"ACGTACAGTCTTGAAC"	"PEC"
"ACGTACAGTTACCGTA"	"Cyst.PC-CD"
"ACGTACAGTTGATCGT"	"Mast-cell"
"ACGTACATCGCCTAGG"	"VSMC"
"ACGTAGTGTACCGTGC"	"PEC"
"ACGTCCTCAGGATCTT"	"Podocytes"
"ACGTCCTCAGTTGTCA"	"Podocytes"
"ACGTCCTGTTAGGCCC"	"VSMC"
"ACGTCCTTCATTACCT"	"Cyst.PC-CD"
"ACGTCCTTCCGGTAGC"	"Cyst.IC-A_2"
"ACGTTCCCAAATGGTA"	"Cyst.IC-A_2"
"ACGTTCCCACTTCAGA"	"Podocytes"
"ACGTTCCCAGCCATTA"	"Cyst.IM-CD"
"ACGTTCCGTGTCCACG"	"Cyst.PC-CD"
"ACGTTCCGTTAAGGGC"	"B-cell_2"
"ACGTTCCTCCGAGTGC"	"Cyst.IM-CD"
"ACTACGAAGTTACGTC"	"Cyst.PC-CD"
"ACTACGACAATCGTCA"	"Cyst.PC-CD"
"ACTACGACACAAGCCC"	"Cyst.PC-CD"
"ACTACGACATACTGAC"	"Cyst.IM-CD"
"ACTACGAGTCGGAACA"	"Cyst.cTAL"
"ACTACGAGTGGCTGAA"	"Cyst.IC-A_2"
"ACTACGATCAACTACG"	"Cyst.cTAL"
"ACTACGATCGCAACAT"	"Cyst.CD"
"ACTATCTGTCCCTGTT"	"Cyst.PC-CD"
"ACTATCTGTGTGTGTT"	"Cyst.IC-A_1"
"ACTATCTTCAGAATAG"	"VSMC"
"ACTATCTTCTCCGAGG"	"Cyst.CD"
"ACTATCTTCTGCGGCA"	"Cyst.PC-CD"
"ACTATGGAGCTCAGAG"	"Cyst.PC-CD"
"ACTATGGCAACAAGTA"	"Cyst.IC-A_2"
"ACTATGGCAACGATCT"	"PEC"
"ACTATGGCATCACAGT"	"Cyst.IM-CD"
"ACTATGGGTAATGCGG"	"VSMC"
"ACTATGGGTGCTGATT"	"Mast-cell"
"ACTATGGTCCACTTCG"	"Cyst.IM-CD"
"ACTATTCAGGAGGTTC"	"Cyst.IC-A_2"
"ACTATTCAGTAGAATC"	"Podocytes"
"ACTATTCCAACTCATG"	"EC"
"ACTATTCCACGCCACA"	"Cyst.PC-CD"
"ACTATTCCAGTCCGTG"	"Cyst.PC-CD"
"ACTATTCCATCGGTTA"	"Cyst.PC-CD"
"ACTATTCCATCTGGGC"	"Cyst.PC-CD"
"ACTATTCGTGCTATTG"	"Cyst.PC-CD"
"ACTATTCTCGTTATCT"	"Cyst.IM-CD"
"ACTCCCACAACGTTAC"	"Cyst.PC-CD"
"ACTCCCACACAACGAG"	"Cyst.PC-CD"
"ACTCCCAGTATCCTTT"	"Cyst.cTAL"
"ACTCCCAGTGTGATGG"	"PEC"
"ACTCTCGAGACGCTCC"	"Cyst.IM-CD"
"ACTCTCGGTCATCTAG"	"Mast-cell"
"ACTCTCGTCCTGCTAC"	"Cyst.IM-CD"
"ACTGATGAGATGTAGT"	"Cyst.IC-A_2"
"ACTGATGAGGGTTAGC"	"Cyst.IC-A_2"
"ACTGATGAGGTGGCTA"	"T-cell"
"ACTGATGCAAATACGA"	"EC"
"ACTGATGGTAGCGTAG"	"Cyst.PC-CD"
"ACTGATGGTATGCGTT"	"Cyst.cTAL"
"ACTGATGGTCCTGGTG"	"Cyst.IM-CD"
"ACTGATGGTGAGTTTC"	"Cyst.IM-CD"
"ACTGATGGTGGCACTC"	"Cyst.IC-A_1"
"ACTGATGTCCACGTCT"	"Mast-cell"
"ACTGATGTCCTGTAAG"	"B-cell_1"
"ACTGATGTCGGCATCG"	"Cyst.PC-CD"
"ACTGCAAAGCCATTCA"	"Cyst.cTAL"
"ACTGCAACAATGGCAG"	"PEC"
"ACTGCAAGTGGATCAG"	"Cyst.PT_2"
"ACTGCAATCCATAGGT"	"Cyst.cTAL"
"ACTGCAATCTTTGCGC"	"Cyst.IC-A_2"
"ACTGTCCAGACATAAC"	"Mast-cell"
"ACTGTCCAGACATCAA"	"Cyst.PC-CD"
"ACTGTCCAGATGCTGG"	"Cyst.IM-CD"
"ACTGTCCCACTTTAGG"	"Cyst.PC-CD"
"ACTGTCCGTACCCGAC"	"Cyst.PC-CD"
"ACTGTCCGTCACCGAC"	"EC"
"ACTGTCCGTTCATCGA"	"Cyst.PC-CD"
"ACTGTCCGTTTCAGAC"	"Cyst.PC-CD"
"ACTGTCCGTTTGGAGG"	"Cyst.PC-CD"
"ACTGTGAAGACGCCAA"	"Cyst.IM-CD"
"ACTGTGAAGATTGACA"	"Podocytes"
"ACTGTGAAGTATCTGC"	"Cyst.CD"
"ACTGTGAAGTTAACGA"	"T-cell"
"ACTGTGACAAGTATCC"	"Mast-cell"
"ACTGTGACATCTCCCA"	"Cyst.PC-CD"
"ACTGTGATCATGGGAG"	"PEC"
"ACTGTGATCTCCAAGA"	"Cyst.IC-A_2"
"ACTTAGGAGACAACAT"	"Cyst.IM-CD"
"ACTTAGGCATAGGTAA"	"B-cell_2"
"ACTTAGGGTCTACAGT"	"Cyst.IM-CD"
"ACTTAGGTCATCCCGT"	"PEC"
"ACTTAGGTCATTTGCT"	"Cyst.IM-CD"
"ACTTATCCAACACTAC"	"Cyst.PC-CD"
"ACTTATCCAACGATCT"	"Cyst.IM-CD"
"ACTTATCCATACAGAA"	"Cyst.IM-CD"
"ACTTATCGTCTGCCTT"	"PEC"
"ACTTATCTCCTCTCTT"	"Cyst.PC-CD"
"ACTTATCTCTGCTTTA"	"Cyst.PC-CD"
"ACTTCCGAGGCTGGAT"	"Cyst.CD"
"ACTTCCGCATATAGCC"	"Cyst.IM-CD"
"ACTTCCGTCTTAATCC"	"Cyst.IM-CD"
"ACTTCGCAGGGCAACT"	"Cyst.IC-A_1"
"ACTTCGCCAAAGACTA"	"Mac/DC"
"ACTTCGCCAACTCGAT"	"Cyst.IM-CD"
"ACTTCGCCAGTAGTGG"	"Cyst.IC-A_2"
"ACTTCGCGTACTTGTG"	"Cyst.PC-CD"
"ACTTCGCGTTACACAC"	"PEC"
"ACTTCGCTCCTCTAAT"	"Cyst.IC-A_2"
"ACTTTCAAGCATGTTC"	"PEC"
"ACTTTCAAGGTTCTTG"	"Cyst.PT_2"
"ACTTTCACACTAGGCC"	"VSMC"
"ACTTTCACACTATCGA"	"T-cell"
"ACTTTCAGTAGTAAGT"	"Mac/DC"
"ACTTTCATCACCGCTT"	"Mac/DC"
"ACTTTGTAGAGGCGGA"	"Cyst.PC-CD"
"ACTTTGTAGATAGCTA"	"Cyst.PC-CD"
"ACTTTGTAGCCAAGTG"	"Cyst.IC-A_2"
"ACTTTGTAGGGAGGTG"	"Cyst.PC-CD"
"ACTTTGTCAAATTGCC"	"Cyst.IM-CD"
"ACTTTGTCACCATAAC"	"Cyst.IC-A_1"
"ACTTTGTCAGCTGCCA"	"Cyst.CD"
"ACTTTGTCAGTGACCC"	"PEC"
"ACTTTGTCATCTATCT"	"T-cell"
"ACTTTGTGTTAGTTCG"	"PEC"
"AGAAATGAGAAATCCA"	"Cyst.PC-CD"
"AGAAATGAGAGCAAGA"	"Cyst.IM-CD"
"AGAAATGAGGTAAGAG"	"Cyst.cTAL"
"AGAAATGAGTACCCTA"	"Cyst.IM-CD"
"AGAAATGCAATACCTG"	"EC"
"AGAAATGCACACGTGC"	"Cyst.PC-CD"
"AGAAATGCACCGTACG"	"Cyst.IM-CD"
"AGAAATGCAGAGTAAT"	"Cyst.IC-A_2"
"AGAAATGGTACGTACT"	"Cyst.PC-CD"
"AGAAATGGTGAGGAAA"	"PEC"
"AGAAATGGTGTCATGT"	"PEC"
"AGAACAAAGACCAAGC"	"Cyst.PT_2"
"AGAACAAAGAGAGTGA"	"Cyst.IM-CD"
"AGAACAAAGATTGCGG"	"Cyst.cTAL"
"AGAACAACAATAACGA"	"Cyst.PC-CD"
"AGAACAACATCTAGAC"	"Cyst.IC-A_1"
"AGAACAAGTAGCTCGC"	"Cyst.IM-CD"
"AGAACAAGTTAAGACA"	"Cyst.PC-CD"
"AGAACAATCCACGTGG"	"Cyst.cTAL"
"AGAACAATCCGTGTGG"	"Cyst.PC-CD"
"AGAACAATCGAACCAT"	"PEC"
"AGAACAATCGGCTTCT"	"Cyst.PC-CD"
"AGAACCTAGAGCAAGA"	"Cyst.PC-CD"
"AGAACCTAGCTTGTGT"	"Cyst.IC-A_2"
"AGAACCTCAAGCCCAC"	"T-cell"
"AGAACCTCACCTGTCT"	"Cyst.PC-CD"
"AGAACCTCATGGCTGC"	"Mast-cell"
"AGAACCTGTCATCACA"	"Cyst.IC-A_1"
"AGAACCTGTGGATCAG"	"Cyst.cTAL"
"AGAACCTTCTATCGCC"	"PEC"
"AGAAGCGAGTAGAATC"	"Cyst.IC-A_1"
"AGAAGCGCATAGCTGT"	"EC"
"AGAAGCGTCCATTGCC"	"Cyst.cTAL"
"AGAAGTAAGACCATTC"	"PEC"
"AGAAGTAAGCTAGATA"	"Podocytes"
"AGAAGTACACACGTGC"	"Cyst.IM-CD"
"AGAAGTACACGCTGCA"	"Cyst.IC-A_1"
"AGAAGTACAGAAGCTG"	"Cyst.IC-A_1"
"AGAAGTAGTGAATATG"	"Cyst.IM-CD"
"AGAAGTATCATTTGGG"	"VSMC"
"AGAAGTATCGCGTAGC"	"Cyst.PC-CD"
"AGACAAAAGCACACCC"	"Podocytes"
"AGACAAAAGCATTTGC"	"T-cell"
"AGACAAAGTAACAGGC"	"Cyst.PC-CD"
"AGACAAAGTATACCTG"	"Cyst.PC-CD"
"AGACAAAGTCCCTCAT"	"Cyst.PC-CD"
"AGACAAAGTTAAGTCC"	"Cyst.IM-CD"
"AGACAAATCAAGGAGC"	"Podocytes"
"AGACAAATCGGAGCAA"	"Cyst.cTAL"
"AGACAAATCTGTCGCT"	"Cyst.PC-CD"
"AGACACTTCCAACTGA"	"VSMC"
"AGACAGGCAGCGCGTT"	"Cyst.PC-CD"
"AGACAGGGTAGGGAGG"	"Cyst.PC-CD"
"AGACAGGGTGCAAGAC"	"Cyst.IM-CD"
"AGACAGGTCCGTAATG"	"Cyst.PC-CD"
"AGACCATAGAGGGTAA"	"Mac/DC"
"AGACCATAGCATTGAA"	"Podocytes"
"AGACCATAGGGACCAT"	"PEC"
"AGACCATGTATACCTG"	"VSMC"
"AGACCATTCACCCATC"	"Cyst.cTAL"
"AGACCCGAGCAAGTGC"	"Cyst.PC-CD"
"AGACCCGCAGCATACT"	"Cyst.IM-CD"
"AGACCCGCATTGGCAT"	"Cyst.PC-CD"
"AGACCCGTCGCGAAGA"	"Cyst.PC-CD"
"AGACTCAAGATACCAA"	"Cyst.IM-CD"
"AGACTCAAGCTAAATG"	"Cyst.cTAL"
"AGACTCACAACGCATT"	"Cyst.IC-A_2"
"AGACTCACACTAACCA"	"VSMC"
"AGACTCACATAGAGGC"	"Cyst.IC-A_2"
"AGACTCACATCGCCTT"	"Podocytes"
"AGACTCACATGCTGCG"	"Cyst.PC-CD"
"AGACTCAGTAATACCC"	"PEC"
"AGACTCAGTCGTTCAA"	"T-cell"
"AGACTCAGTCTCACAA"	"Podocytes"
"AGACTCATCATCGCTC"	"Podocytes"
"AGACTCATCCTGATAG"	"Cyst.cTAL"
"AGACTCATCGGAAACG"	"Cyst.IM-CD"
"AGAGAATAGGATGGCT"	"Cyst.IM-CD"
"AGAGAATCAACACTAC"	"Cyst.PC-CD"
"AGAGAATCAGAAGCGT"	"EC"
"AGAGAATCATACGCAT"	"Cyst.PC-CD"
"AGAGAATCATCCAATG"	"Cyst.IM-CD"
"AGAGAATGTCCAAATC"	"Cyst.IM-CD"
"AGAGAATTCAGACCCG"	"PEC"
"AGAGAGCTCGGCTGGT"	"Cyst.IM-CD"
"AGAGCAGAGGGTAATT"	"PEC"
"AGAGCAGAGGGTATAT"	"Cyst.PC-CD"
"AGAGCAGAGTCAACAA"	"Cyst.IC-A_1"
"AGAGCAGCAGTGGTGA"	"VSMC"
"AGAGCAGGTAAGGAGA"	"Cyst.IM-CD"
"AGAGCAGGTGCCAAGA"	"Cyst.IC-A_2"
"AGAGCAGTCTCACCCA"	"VSMC"
"AGAGCCCAGGCTTAAA"	"B-cell_1"
"AGAGCCCAGGCTTAGG"	"Cyst.PC-CD"
"AGAGCCCAGGTAAGAG"	"Cyst.PC-CD"
"AGAGCCCCAGTTGGTT"	"Cyst.IM-CD"
"AGAGCCCGTATCGTAC"	"PEC"
"AGAGCCCTCGCTCATC"	"Podocytes"
"AGATAGAAGACTGAGC"	"Cyst.cTAL"
"AGATAGACAAGGATGC"	"PEC"
"AGATAGACATTGACAC"	"Cyst.IM-CD"
"AGATAGAGTGTGCTTA"	"EC"
"AGATAGATCGTACACA"	"Cyst.IM-CD"
"AGATCCAAGTCTCGTA"	"PEC"
"AGATCCACAGGAGGTT"	"Podocytes"
"AGATCCAGTCAGACGA"	"B-cell_2"
"AGATCCAGTCGACGCT"	"Podocytes"
"AGATCCAGTGCAAGAC"	"PEC"
"AGATCCATCTCATTGT"	"PEC"
"AGATCGTCATGAAGCG"	"Cyst.PC-CD"
"AGATCGTGTAAGTTGA"	"Cyst.PC-CD"
"AGATCGTGTACCTAAC"	"Mac/DC"
"AGATCGTTCACCGACG"	"Cyst.IM-CD"
"AGATCGTTCGGATAAA"	"Podocytes"
"AGATCGTTCTCCGAAA"	"Cyst.PC-CD"
"AGATGAAAGTTAACAG"	"Cyst.PC-CD"
"AGATGAACATGTGGTT"	"PEC"
"AGATGAAGTATTGGCT"	"T-cell"
"AGATGAAGTCGAGTTT"	"Cyst.PC-CD"
"AGATGAAGTTCGATTG"	"Cyst.PC-CD"
"AGATGAATCCCGAGGT"	"T-cell"
"AGATGCTAGATTACCC"	"PEC"
"AGATGCTAGCGGATCA"	"Cyst.PC-CD"
"AGATGCTAGCTGAAAT"	"Cyst.IC-A_1"
"AGATGCTAGGGAGAAT"	"Cyst.PT_2"
"AGATGCTCAATAAGGT"	"Mast-cell"
"AGATGCTCATTAGGAA"	"Cyst.PC-CD"
"AGATGCTGTACGACAG"	"Cyst.IC-A_2"
"AGATGCTGTCTAGGCC"	"Cyst.PC-CD"
"AGATGCTGTTTACTGG"	"Cyst.IM-CD"
"AGATGCTTCAGATGCT"	"VSMC"
"AGCATCAAGACGAGCT"	"Cyst.IM-CD"
"AGCATCAAGACTACGG"	"Cyst.IC-A_1"
"AGCATCAAGTTGGAGC"	"Mast-cell"
"AGCATCAGTACACTCA"	"Cyst.cTAL"
"AGCATCAGTTCCAGGC"	"Cyst.PC-CD"
"AGCCAATAGACATCCT"	"Cyst.PC-CD"
"AGCCAATAGTGATTCC"	"Podocytes"
"AGCCAATCACGACGTC"	"Cyst.IC-A_2"
"AGCCAATCATCTAACG"	"Cyst.PC-CD"
"AGCCAATTCGACGCGT"	"PEC"
"AGCCACGAGACGCCCT"	"PEC"
"AGCCACGAGGTCACTT"	"Cyst.PC-CD"
"AGCCACGCATCTTTCA"	"Cyst.PC-CD"
"AGCCACGGTCGTTCAA"	"Cyst.PC-CD"
"AGCCACGGTGGCTGAA"	"VSMC"
"AGCCACGGTGTCATCA"	"Mac/DC"
"AGCCACGTCGCAAGAG"	"Cyst.IM-CD"
"AGCCAGCAGCGAGGAG"	"Cyst.IC-A_1"
"AGCCAGCAGGTCATCT"	"Cyst.IM-CD"
"AGCCAGCCAACTGAAA"	"T-cell"
"AGCCAGCGTACTAGCT"	"T-cell"
"AGCCAGCGTAGCCAGA"	"Cyst.cTAL"
"AGCCAGCTCAGACAAA"	"Cyst.PC-CD"
"AGCCAGCTCGGCTGTG"	"Cyst.PC-CD"
"AGCCAGCTCTCTGGTC"	"Cyst.PC-CD"
"AGCGATTCAAGTGATA"	"Cyst.IM-CD"
"AGCGATTGTCAAAGTA"	"Cyst.PC-CD"
"AGCGATTGTGTTACTG"	"Cyst.CD"
"AGCGATTGTTACCCAA"	"PEC"
"AGCGATTGTTCTTGCC"	"Cyst.PC-CD"
"AGCGATTTCACTACGA"	"Cyst.IC-A_2"
"AGCGATTTCTGATTCT"	"PEC"
"AGCGCCAAGAAGCGAA"	"PEC"
"AGCGCCAAGCATCAGG"	"Cyst.IM-CD"
"AGCGCCAAGGGCGAGA"	"Cyst.PC-CD"
"AGCGCCAAGTCCGTCG"	"Cyst.PT_2"
"AGCGCCACACAGCATT"	"Podocytes"
"AGCGCCACAGCGTTTA"	"PEC"
"AGCGCCAGTAGTATAG"	"Cyst.IM-CD"
"AGCGCCAGTATTTCGG"	"Cyst.IM-CD"
"AGCGCCAGTTCCTACC"	"T-cell"
"AGCGCTGAGAGGCGGA"	"Cyst.IM-CD"
"AGCGCTGCAAACTAAG"	"Cyst.IM-CD"
"AGCGCTGTCCAATCTT"	"PEC"
"AGCGCTGTCGCCGAGT"	"Podocytes"
"AGCGTATAGATTAGCA"	"Podocytes"
"AGCGTATAGCGTTACT"	"Cyst.PC-CD"
"AGCGTATCACTTCAAG"	"Cyst.IM-CD"
"AGCGTATCACTTCAGA"	"PEC"
"AGCGTATCAGCCCAGT"	"EC"
"AGCGTATGTAACGATA"	"VSMC"
"AGCGTATGTTTGCCGG"	"Cyst.PC-CD"
"AGCGTCGAGATCCCGC"	"Cyst.PC-CD"
"AGCGTCGCACGGTGAA"	"VSMC"
"AGCGTCGCAGAGAAAG"	"Cyst.PC-CD"
"AGCGTCGCATCCTGTC"	"Cyst.IM-CD"
"AGCGTCGGTCATGACT"	"Cyst.PC-CD"
"AGCTACAAGCCTCGTG"	"Podocytes"
"AGCTACAAGGCGTCCT"	"Cyst.PC-CD"
"AGCTACAAGGTAAACT"	"Cyst.PC-CD"
"AGCTACACAGCTGTTA"	"Cyst.PC-CD"
"AGCTACACATATCGGT"	"Cyst.PC-CD"
"AGCTACAGTCTTACAG"	"VSMC"
"AGCTACATCGCTGTTC"	"Cyst.PC-CD"
"AGCTCAAAGGTTGAGC"	"Cyst.PC-CD"
"AGCTCAAGTCACTACA"	"Cyst.IM-CD"
"AGCTCAATCCTTCGAC"	"Cyst.PC-CD"
"AGCTCAATCGAGAAAT"	"Cyst.PC-CD"
"AGCTCAATCTGTAACG"	"Podocytes"
"AGCTTCCCACGTATAC"	"Cyst.PC-CD"
"AGCTTCCTCACCGGTG"	"EC"
"AGCTTCCTCTCATGCC"	"Cyst.IM-CD"
"AGGAAATAGGGCTGAT"	"Cyst.CD"
"AGGAAATAGTAGACCG"	"VSMC"
"AGGAAATCAAATGGAT"	"Podocytes"
"AGGAAATGTAGACGGT"	"Cyst.PC-CD"
"AGGAAATGTAGCTGAG"	"Cyst.PC-CD"
"AGGAAATGTTGCAAGG"	"VSMC"
"AGGAAATTCGTGGGTC"	"PEC"
"AGGAAATTCTTTGCGC"	"Cyst.CD"
"AGGAATAAGTTGCCCG"	"Cyst.IC-A_2"
"AGGAATACAAATGATG"	"Cyst.IC-A_2"
"AGGAATACAGGAGGAG"	"PEC"
"AGGAATAGTAGGCTGA"	"Cyst.PC-CD"
"AGGACGAAGTCACTGT"	"Cyst.IC-A_1"
"AGGACGAAGTTCCAGT"	"Cyst.PC-CD"
"AGGACGAGTACTAGCT"	"Mast-cell"
"AGGACGAGTATCGTAC"	"EC"
"AGGACGAGTATGCTAC"	"Cyst.PT_2"
"AGGACGAGTGTGATGG"	"Podocytes"
"AGGACGATCAACCCGG"	"Cyst.IM-CD"
"AGGACGATCTCTATAC"	"PEC"
"AGGACTTAGACGGATC"	"Cyst.IM-CD"
"AGGACTTAGATGTTGA"	"Cyst.IM-CD"
"AGGACTTAGTCATGGG"	"Cyst.IM-CD"
"AGGACTTTCCCATACC"	"EC"
"AGGACTTTCGAATGCT"	"Cyst.IC-A_1"
"AGGAGGTAGTGAGTTA"	"Cyst.PC-CD"
"AGGAGGTGTCACTCGG"	"Cyst.PC-CD"
"AGGAGGTGTCCGCAGT"	"Cyst.IM-CD"
"AGGAGGTGTCGCCACA"	"Cyst.PC-CD"
"AGGAGGTTCACGTAGT"	"PEC"
"AGGAGGTTCGTAGGAG"	"Podocytes"
"AGGATAAAGCGATGGT"	"Podocytes"
"AGGATAAAGGTGGCTA"	"Podocytes"
"AGGATAAAGTAGCATA"	"Podocytes"
"AGGATAACATATTCGG"	"Cyst.IM-CD"
"AGGATAAGTACACGTT"	"Cyst.PT_1"
"AGGATAAGTCCTCAGG"	"PEC"
"AGGATAATCACTACGA"	"Cyst.PT_1"
"AGGATAATCAGACCCG"	"Mast-cell"
"AGGATAATCATTACGG"	"VSMC"
"AGGATCTCAATTCTCT"	"Cyst.PC-CD"
"AGGATCTCAGCTCTGG"	"PEC"
"AGGATCTGTCATCAGT"	"Cyst.PC-CD"
"AGGATCTGTGAAAGTT"	"Cyst.cTAL"
"AGGATCTGTGAGACGT"	"Cyst.IC-A_1"
"AGGATCTTCACGAACT"	"EC"
"AGGCATTAGGCTAGCA"	"PEC"
"AGGCATTAGGTATCTC"	"Cyst.PC-CD"
"AGGCATTAGTAAAGCT"	"PEC"
"AGGCATTCAACACGAG"	"Cyst.IM-CD"
"AGGCATTCAAGAGATT"	"Podocytes"
"AGGCATTGTCATAAAG"	"Cyst.PC-CD"
"AGGCCACAGATTTGCC"	"PEC"
"AGGCCACAGCCACAAG"	"Cyst.cTAL"
"AGGCCACAGCTTCGTA"	"Cyst.PC-CD"
"AGGCCACAGGATACCG"	"Cyst.PC-CD"
"AGGCCACAGTTAGAAC"	"Podocytes"
"AGGCCACTCAGTGGGA"	"EC"
"AGGCCACTCCATCTGC"	"PEC"
"AGGCCACTCGAACGGA"	"Cyst.IM-CD"
"AGGCCACTCGTTATCT"	"Cyst.CD"
"AGGCCACTCTTCCACG"	"Cyst.IM-CD"
"AGGCTGCAGGGATGTC"	"Cyst.IM-CD"
"AGGCTGCCAGGACTAG"	"Cyst.IC-A_1"
"AGGCTGCGTAGGCAGT"	"PEC"
"AGGCTGCGTTTACACG"	"Cyst.IM-CD"
"AGGCTGCTCATTACTC"	"Mast-cell"
"AGGCTGCTCGGCTGGT"	"Cyst.PC-CD"
"AGGGAGTAGTGAACAT"	"Cyst.IM-CD"
"AGGGAGTCACTGTCGG"	"Cyst.IC-A_2"
"AGGGAGTCATACCATG"	"Cyst.IM-CD"
"AGGGAGTGTCCCTCAT"	"EC"
"AGGGAGTTCTCCTGCA"	"Cyst.PC-CD"
"AGGGCCTAGAGTTGCG"	"Cyst.PC-CD"
"AGGGCCTAGGAAGTAG"	"Cyst.CD"
"AGGGCCTGTCGCGTTG"	"Cyst.IC-A_2"
"AGGGCCTGTCTTGAAC"	"Cyst.cTAL"
"AGGGCCTGTTCGAGCC"	"PEC"
"AGGGCCTTCCTACGAA"	"Podocytes"
"AGGGCCTTCGAAGCAG"	"Cyst.PT_2"
"AGGGCTCAGATGAAGG"	"Cyst.PC-CD"
"AGGGCTCAGATGCCGA"	"Cyst.cTAL"
"AGGGCTCAGGGCCTCT"	"Cyst.IM-CD"
"AGGGCTCCAGGTGAGT"	"Cyst.PC-CD"
"AGGGCTCGTAGTCTTG"	"T-cell"
"AGGGCTCGTTGGCCGT"	"PEC"
"AGGGTCCAGGTCCCTG"	"Cyst.IM-CD"
"AGGGTCCCAAATCGGG"	"PEC"
"AGGGTCCCAACATACC"	"Cyst.PC-CD"
"AGGGTCCGTGCCCTTT"	"Cyst.PC-CD"
"AGGGTGAAGATGCTTC"	"Cyst.PC-CD"
"AGGGTGAAGGATTTAG"	"Cyst.PC-CD"
"AGGGTGAAGGTGCAGT"	"Cyst.IM-CD"
"AGGGTGAAGTAGGCCA"	"Podocytes"
"AGGGTGACAGCGGTCT"	"Cyst.PC-CD"
"AGGGTGACAGTTACCA"	"Cyst.IC-A_2"
"AGGGTGAGTACCTTCC"	"Cyst.PC-CD"
"AGGGTGAGTCTGCAAT"	"Cyst.IM-CD"
"AGGGTGAGTTAGCGGA"	"Mac/DC"
"AGGGTTTAGCGCTGAA"	"Cyst.IM-CD"
"AGGGTTTCATAACCCA"	"PEC"
"AGGGTTTGTACCAGAG"	"Cyst.PC-CD"
"AGGGTTTGTGAGAACC"	"Cyst.PC-CD"
"AGGGTTTTCAATGTCG"	"Cyst.IM-CD"
"AGGGTTTTCCATGCAA"	"Cyst.PC-CD"
"AGGGTTTTCGTCAAAC"	"Cyst.PC-CD"
"AGGTAGGAGGCTCAAG"	"Cyst.IM-CD"
"AGGTAGGAGGGATGTC"	"Cyst.CD"
"AGGTAGGCACTGCGAC"	"Podocytes"
"AGGTAGGCAGACCAAG"	"Cyst.cTAL"
"AGGTAGGCAGCTCCTT"	"Cyst.PC-CD"
"AGGTAGGGTTTCGTGA"	"VSMC"
"AGGTAGGTCCAGTGCG"	"Cyst.IC-A_1"
"AGGTAGGTCGGTCTGG"	"Mast-cell"
"AGGTCATAGTACAACA"	"Cyst.IM-CD"
"AGGTCATCAAACTGCT"	"Cyst.cTAL"
"AGGTCATCAGCTCCTT"	"Cyst.PC-CD"
"AGGTCATGTAAGTTAG"	"Cyst.PC-CD"
"AGGTCATGTTAATCGC"	"Cyst.PC-CD"
"AGGTCATGTTGAGGAC"	"VSMC"
"AGGTCATTCATTTGCT"	"Cyst.cTAL"
"AGGTCATTCGACCTAA"	"Cyst.IC-A_1"
"AGGTCATTCGGCATTA"	"Cyst.PC-CD"
"AGGTCTAAGAGGGTAA"	"Cyst.PC-CD"
"AGGTCTAAGGTGCCAA"	"Podocytes"
"AGGTCTACAAACACGG"	"Cyst.CD"
"AGGTCTACACACACTA"	"PEC"
"AGGTCTACACATGACT"	"Cyst.PT_1"
"AGGTCTACAGATTCGT"	"PEC"
"AGGTCTACATGGAGAC"	"T-cell"
"AGGTCTACATGGGTTT"	"Cyst.IC-A_1"
"AGGTCTACATTGGATC"	"Cyst.PC-CD"
"AGGTCTAGTACCGTGC"	"Cyst.IM-CD"
"AGGTCTAGTGGAAGTC"	"Cyst.PC-CD"
"AGGTCTATCAGTCAGT"	"Podocytes"
"AGGTGTTAGTCGAATA"	"Cyst.PC-CD"
"AGGTGTTCACTCATAG"	"EC"
"AGGTGTTCAGAAGCGT"	"Cyst.PC-CD"
"AGGTGTTGTAACGATA"	"Cyst.PC-CD"
"AGGTGTTTCCATCTAT"	"Cyst.IC-A_1"
"AGGTGTTTCCCGAACG"	"Cyst.cTAL"
"AGGTTACAGAGGATGA"	"Cyst.cTAL"
"AGGTTACGTCGGTGTC"	"Cyst.PT_1"
"AGGTTACTCCTAACAG"	"Cyst.PC-CD"
"AGGTTACTCGAACGGA"	"Cyst.IC-A_1"
"AGGTTACTCTAACACG"	"Podocytes"
"AGGTTACTCTCCAATT"	"Mac/DC"
"AGGTTGTAGGACTATA"	"Cyst.IC-A_1"
"AGGTTGTAGTAAACGT"	"Podocytes"
"AGGTTGTAGTCGAATA"	"T-cell"
"AGGTTGTCAGACCGCT"	"Cyst.PC-CD"
"AGGTTGTGTATGCAAA"	"PEC"
"AGGTTGTGTATGCGGA"	"Cyst.PC-CD"
"AGGTTGTGTCCTGGTG"	"Cyst.PC-CD"
"AGGTTGTGTGAATTGA"	"Cyst.PT_1"
"AGGTTGTTCTCCACTG"	"Cyst.PC-CD"
"AGTAACCAGAGTGTGC"	"Cyst.IM-CD"
"AGTAACCCATAAGCGG"	"Cyst.PC-CD"
"AGTAACCGTGTTAAAG"	"Podocytes"
"AGTAACCTCCGGTAGC"	"PEC"
"AGTACCACAGTCGCAC"	"Cyst.PC-CD"
"AGTACCATCACTACTT"	"Cyst.IC-A_1"
"AGTACTGGTGGTCTTA"	"Cyst.cTAL"
"AGTACTGTCCATGCAA"	"Podocytes"
"AGTACTGTCCATTGGA"	"Cyst.IM-CD"
"AGTACTGTCTACTCAT"	"Cyst.PC-CD"
"AGTAGCTAGGAAGAAC"	"PEC"
"AGTAGCTGTACTCAAC"	"Cyst.PC-CD"
"AGTAGCTGTCGCAACC"	"Cyst.IM-CD"
"AGTAGCTGTGAGGAAA"	"Cyst.PC-CD"
"AGTAGCTGTTGTTGCA"	"PEC"
"AGTAGCTTCGCCATAA"	"VSMC"
"AGTAGTCAGCGAGTCA"	"Cyst.PC-CD"
"AGTAGTCCAGACCCGT"	"PEC"
"AGTAGTCCATGACAAA"	"Cyst.IM-CD"
"AGTAGTCGTGATATAG"	"Cyst.PC-CD"
"AGTAGTCGTTGTTGTG"	"Mac/DC"
"AGTCAACAGCGTCTGC"	"Cyst.IM-CD"
"AGTCAACAGTCACTAC"	"Cyst.IM-CD"
"AGTCAACCACAGCTTA"	"Cyst.PC-CD"
"AGTCAACCAGAACGCA"	"PEC"
"AGTCAACCATTGAGGG"	"T-cell"
"AGTCAACCATTGTAGC"	"PEC"
"AGTCAACGTAAGATCA"	"T-cell"
"AGTCAACGTCAGATTC"	"Cyst.PC-CD"
"AGTCAACGTGCCTAAT"	"Cyst.IM-CD"
"AGTCAACTCCACTGAA"	"Cyst.IC-A_1"
"AGTCAACTCTAGAACC"	"T-cell"
"AGTCACAAGCATGATA"	"Podocytes"
"AGTCACAAGGGCATGT"	"Cyst.IC-A_1"
"AGTCACACATTAGGCT"	"Mast-cell"
"AGTCACAGTCAACCTA"	"Cyst.PC-CD"
"AGTCACATCAGGGTAG"	"Cyst.IM-CD"
"AGTCACATCCTTACCG"	"Cyst.cTAL"
"AGTCATGCAATAAGGT"	"Cyst.IM-CD"
"AGTCATGTCAGCTGTA"	"Mast-cell"
"AGTCTCCCAGCACACC"	"B-cell_1"
"AGTCTCCGTTGGGACA"	"Cyst.PC-CD"
"AGTGACTAGCAAGCCA"	"T-cell"
"AGTGACTAGTATGAGT"	"PEC"
"AGTGACTCAGCATGCC"	"Mac/DC"
"AGTGACTCATGCCATA"	"Mast-cell"
"AGTGACTGTCACTAGT"	"Cyst.IM-CD"
"AGTGACTTCGCGATCG"	"Cyst.cTAL"
"AGTGATCAGGTAGCCA"	"Mac/DC"
"AGTGATCGTAGATCGG"	"T-cell"
"AGTGATCGTGGAGAAA"	"Cyst.PC-CD"
"AGTGATCGTTCATCGA"	"Mac/DC"
"AGTGATCGTTTCGCTC"	"Podocytes"
"AGTGCCGCACATGTTG"	"Mac/DC"
"AGTGCCGCAGTCTGGC"	"B-cell_1"
"AGTGCCGGTTCCATTT"	"Cyst.IM-CD"
"AGTGCCGTCTTGGTGA"	"Cyst.PC-CD"
"AGTGTTGAGAGTCTTC"	"Cyst.PC-CD"
"AGTGTTGAGGCGACAT"	"T-cell"
"AGTGTTGCAAAGACGC"	"PEC"
"AGTGTTGCAGGACTAG"	"Cyst.IC-A_1"
"AGTGTTGCAGTGGTGA"	"Mac/DC"
"AGTGTTGGTATCACCA"	"Cyst.CD"
"AGTGTTGGTATGGAGC"	"T-cell"
"AGTGTTGGTCAACCAT"	"Cyst.IC-A_1"
"AGTGTTGGTTCAGCGC"	"Cyst.IM-CD"
"AGTGTTGGTTGCTCAA"	"Podocytes"
"AGTGTTGGTTTGTGGT"	"PEC"
"AGTGTTGTCTAATTCC"	"Cyst.IM-CD"
"AGTTAGCGTGCAACGA"	"Cyst.cTAL"
"AGTTAGCTCGATCCCT"	"Cyst.IM-CD"
"AGTTCCCAGGGACTGT"	"Podocytes"
"AGTTCCCCAGGTTTAC"	"EC"
"AGTTCCCGTGAGGATC"	"Podocytes"
"AGTTCCCTCGTGCACG"	"Cyst.cTAL"
"AGTTCGACAAGACGAC"	"Cyst.IC-A_1"
"AGTTCGACAGCTATTG"	"VSMC"
"AGTTCGACATGTGCTA"	"Podocytes"
"AGTTCGAGTAACCAGG"	"VSMC"
"AGTTCGAGTGGTGATG"	"PEC"
"AGTTCGATCCAGTTCC"	"Cyst.cTAL"
"AGTTCGATCGAAGCCC"	"T-cell"
"ATACCGAAGATCGGTG"	"Cyst.IC-A_1"
"ATACCGACAGAATCGG"	"Cyst.IM-CD"
"ATACCGATCCCAGTGG"	"Cyst.IC-A_2"
"ATACCGATCGCAGTGC"	"Cyst.cTAL"
"ATACCTTCAAGTATCC"	"PEC"
"ATACCTTGTACGTGTT"	"Cyst.IM-CD"
"ATACCTTTCCATTTAC"	"Podocytes"
"ATACTTCAGACATGCG"	"PEC"
"ATACTTCAGAGTGACC"	"Cyst.IM-CD"
"ATACTTCAGTTACGTC"	"Cyst.IM-CD"
"ATACTTCAGTTCGGTT"	"Cyst.IC-A_1"
"ATACTTCCAACTGCCG"	"Cyst.PC-CD"
"ATACTTCCAAGGTTGG"	"T-cell"
"ATACTTCCACCCTGTT"	"Mac/DC"
"ATACTTCCAGGTCAAG"	"Cyst.PC-CD"
"ATACTTCCATTAAAGG"	"Podocytes"
"ATACTTCGTAGGAGGG"	"Cyst.cTAL"
"ATACTTCGTCTTTCAT"	"Cyst.PC-CD"
"ATACTTCGTTCTTGTT"	"Mac/DC"
"ATACTTCTCTTGGCTC"	"Mac/DC"
"ATAGACCAGCATCCTA"	"PEC"
"ATAGACCAGTCTAGAA"	"B-cell_2"
"ATAGACCCACAAGTGG"	"VSMC"
"ATAGACCGTGATTCTG"	"PEC"
"ATAGACCTCCGCTGTT"	"Cyst.cTAL"
"ATAGACCTCCTACACC"	"T-cell"
"ATAGACCTCTGAATGC"	"Cyst.PC-CD"
"ATAGAGAAGGAGGTTC"	"PEC"
"ATAGAGAGTCACCTTC"	"Cyst.IM-CD"
"ATAGAGAGTGACTCTA"	"PEC"
"ATAGGCTAGAACGTGC"	"Podocytes"
"ATAGGCTAGCTCCACG"	"Cyst.IC-A_1"
"ATAGGCTAGGCTCACC"	"Podocytes"
"ATAGGCTAGTGAGTGC"	"Cyst.IC-A_2"
"ATAGGCTCAATCTAGC"	"Podocytes"
"ATAGGCTGTAACGCGA"	"Cyst.PC-CD"
"ATAGGCTGTGATAGTA"	"Cyst.PT_2"
"ATAGGCTTCCACCCTA"	"Mast-cell"
"ATAGGCTTCCAGGACC"	"Cyst.cTAL"
"ATATCCTCAAGGATGC"	"Cyst.PC-CD"
"ATATCCTCAGTCGAGA"	"Podocytes"
"ATATCCTCATCCTCAC"	"PEC"
"ATATCCTGTGTTTGCA"	"Cyst.IM-CD"
"ATCACAGAGAATCCCT"	"Cyst.PC-CD"
"ATCACAGAGACGAAGA"	"Cyst.cTAL"
"ATCACAGAGAGTGACC"	"Cyst.IC-A_1"
"ATCACAGAGCCGTAAG"	"VSMC"
"ATCACAGAGGATTTGA"	"VSMC"
"ATCACAGAGTGTAGAT"	"Cyst.PC-CD"
"ATCACAGTCACACCGG"	"Cyst.IM-CD"
"ATCACAGTCCAAGCCG"	"Cyst.IM-CD"
"ATCACAGTCTGGACCG"	"Cyst.IC-A_2"
"ATCACGAAGACTTCCA"	"Cyst.IM-CD"
"ATCACGAAGTATGAGT"	"Cyst.IM-CD"
"ATCACGACAAGGTTGG"	"Cyst.PC-CD"
"ATCACGACACTATCCC"	"VSMC"
"ATCACGACAGGATGAC"	"VSMC"
"ATCACGACAGGCTTGC"	"Cyst.cTAL"
"ATCACGAGTTGTACGT"	"Cyst.IC-A_2"
"ATCACGATCACCATCC"	"VSMC"
"ATCACGATCTCTCTAA"	"Cyst.PC-CD"
"ATCACGATCTGGGCCA"	"Cyst.IM-CD"
"ATCACTTAGACTTGTC"	"Cyst.PC-CD"
"ATCACTTAGCGTTAGG"	"Cyst.cTAL"
"ATCACTTAGGCACGAT"	"Cyst.PC-CD"
"ATCACTTAGGCCATAG"	"Cyst.PC-CD"
"ATCACTTAGGGAGAAT"	"EC"
"ATCACTTCAAATGCTC"	"Cyst.IC-A_2"
"ATCACTTCAAGACCGA"	"Cyst.IM-CD"
"ATCACTTCAAGTCCAT"	"Cyst.PC-CD"
"ATCACTTCACATATGC"	"Cyst.IC-A_2"
"ATCACTTTCCATTGGA"	"PEC"
"ATCAGGTCAACCGATT"	"Cyst.PC-CD"
"ATCAGGTGTATTGAGA"	"Cyst.CD"
"ATCAGGTGTTATAGAG"	"Cyst.IM-CD"
"ATCAGGTTCCTCAGGG"	"PEC"
"ATCATTCAGAGTGTGC"	"Cyst.PC-CD"
"ATCATTCAGTCACTCA"	"Podocytes"
"ATCATTCAGTGCTCAT"	"Cyst.PC-CD"
"ATCATTCGTCTCGACG"	"Cyst.PC-CD"
"ATCATTCGTGGCACTC"	"Cyst.cTAL"
"ATCATTCGTGGTCCGT"	"PEC"
"ATCATTCTCTCCACTG"	"Cyst.PC-CD"
"ATCATTCTCTGGAGAG"	"Cyst.IC-A_2"
"ATCCACCAGCCTTTCC"	"Cyst.PC-CD"
"ATCCACCAGGTAGACC"	"Cyst.PC-CD"
"ATCCACCCAGGCTTGC"	"Cyst.PC-CD"
"ATCCACCGTCCATAGT"	"Cyst.PT_2"
"ATCCACCGTCCCTCAT"	"Cyst.IM-CD"
"ATCCACCGTGCGGTAA"	"PEC"
"ATCCACCGTGGTCCGT"	"Cyst.IC-A_1"
"ATCCACCTCCACTAGA"	"EC"
"ATCCACCTCTCATTTG"	"Cyst.IM-CD"
"ATCCACCTCTGTGCTC"	"Mac/DC"
"ATCCATTAGCACACCC"	"Cyst.CD"
"ATCCATTCAGTAGATA"	"Cyst.IM-CD"
"ATCCATTGTACACGTT"	"Cyst.IM-CD"
"ATCCATTGTGGGTTGA"	"VSMC"
"ATCCCTGAGACATACA"	"Cyst.IM-CD"
"ATCCCTGAGTATGCAA"	"Cyst.PC-CD"
"ATCCCTGCACCTGTCT"	"T-cell"
"ATCCCTGCATGACTTG"	"PEC"
"ATCCCTGGTTAAGGAT"	"Cyst.IC-A_2"
"ATCCCTGTCATCGTAG"	"T-cell"
"ATCCCTGTCTCATAGG"	"Cyst.IM-CD"
"ATCCGTCAGGTGATCG"	"Cyst.CD"
"ATCCGTCAGTACCGGA"	"Podocytes"
"ATCCGTCCACCGTCGA"	"Cyst.IC-A_2"
"ATCCGTCCAGGTCAAG"	"Cyst.IC-A_1"
"ATCCGTCGTTTACTTC"	"Cyst.PT_2"
"ATCCGTCTCACCGGTG"	"Cyst.PC-CD"
"ATCCTATAGAGCGACT"	"Cyst.PC-CD"
"ATCCTATGTGTGATGG"	"PEC"
"ATCCTATTCCGAGTGC"	"Cyst.PC-CD"
"ATCCTATTCGCTCTCA"	"Mast-cell"
"ATCCTATTCTGGGCCA"	"Cyst.PC-CD"
"ATCGATGAGATACAGT"	"Mac/DC"
"ATCGATGAGGCGTTAG"	"PEC"
"ATCGATGGTAGGCAGT"	"VSMC"
"ATCGATGTCAAAGAAC"	"Cyst.PC-CD"
"ATCGATGTCACCTCGT"	"Cyst.PC-CD"
"ATCGATGTCAGGAAAT"	"Cyst.PC-CD"
"ATCGATGTCGAGTCTA"	"Mast-cell"
"ATCGCCTAGCTGTCCG"	"EC"
"ATCGCCTAGTCTGCGC"	"Cyst.IC-A_2"
"ATCGCCTCAAGAAATC"	"Podocytes"
"ATCGCCTCACTAGTAC"	"Cyst.PC-CD"
"ATCGCCTTCACGGGCT"	"EC"
"ATCGCCTTCCATAAGC"	"Mac/DC"
"ATCGCCTTCCGGACGT"	"PEC"
"ATCGGATAGCGACCCT"	"VSMC"
"ATCGGATAGTACTCGT"	"Cyst.cTAL"
"ATCGGATAGTCGTTAC"	"Cyst.CD"
"ATCGGATAGTGGCAGT"	"Cyst.IC-A_1"
"ATCGGATCAACGGCTC"	"Podocytes"
"ATCGGATCAGCTGTTA"	"PEC"
"ATCGGATCATACTGTG"	"PEC"
"ATCGGATGTCTGTCCT"	"Cyst.PC-CD"
"ATCGGATTCAGACATC"	"PEC"
"ATCGGATTCGGCGATC"	"Cyst.IM-CD"
"ATCGGCGAGGTGCAGT"	"EC"
"ATCGGCGCAAAGCTCT"	"PEC"
"ATCGGCGCACATGGTT"	"PEC"
"ATCGGCGGTATCCCAA"	"Cyst.IM-CD"
"ATCGGCGGTATCCCTC"	"EC"
"ATCGGCGGTCACGACC"	"Cyst.PC-CD"
"ATCGGCGGTTCCTTGC"	"Cyst.PC-CD"
"ATCGGCGTCAAGTAAG"	"Cyst.IM-CD"
"ATCGGCGTCGCTCTAC"	"Cyst.PC-CD"
"ATCGTAGAGGTTCTTG"	"Cyst.CD"
"ATCGTAGCAAGAGAGA"	"Cyst.IM-CD"
"ATCGTAGCATTGCTGA"	"T-cell"
"ATCGTAGGTGATAGAT"	"PEC"
"ATCGTAGTCGACCTAA"	"Cyst.IM-CD"
"ATCGTAGTCTTGGATG"	"PEC"
"ATCGTCCCACGACAGA"	"Podocytes"
"ATCGTCCCACGGTGAA"	"B-cell_1"
"ATCGTCCGTCAACCAT"	"Cyst.IC-A_1"
"ATCGTCCGTGGCGTAA"	"Podocytes"
"ATCGTCCGTTGGAGGT"	"Cyst.IC-A_2"
"ATCGTCCTCCCTCTTT"	"Cyst.cTAL"
"ATCGTCCTCCTGTACC"	"T-cell"
"ATCGTGAAGCTAAACA"	"Cyst.IM-CD"
"ATCGTGAAGTGCACAG"	"Cyst.IC-A_2"
"ATCGTGAGTAGAGTTA"	"Cyst.PC-CD"
"ATCGTGAGTCATCCCT"	"Cyst.IC-A_1"
"ATCGTGAGTTAGAGTA"	"Cyst.IC-A_1"
"ATCGTGAGTTCATCTT"	"EC"
"ATCGTGAGTTCCGCGA"	"Mac/DC"
"ATCGTGATCACCGCTT"	"Cyst.PT_1"
"ATCGTGATCCCGAAAT"	"PEC"
"ATCGTGATCCTTTAGT"	"Cyst.IM-CD"
"ATCTCTAAGCAGCGAT"	"PEC"
"ATCTCTAAGCTGAAAT"	"Cyst.PC-CD"
"ATCTCTACAAGTATCC"	"Cyst.IM-CD"
"ATCTCTACACTAGAGG"	"Cyst.IM-CD"
"ATCTCTACATTGGGAG"	"Cyst.IM-CD"
"ATCTCTAGTACGATCT"	"Mac/DC"
"ATCTCTATCACTCCGT"	"Cyst.PC-CD"
"ATCTTCAGTGTTCAGT"	"Cyst.IC-A_1"
"ATCTTCATCATTGCCC"	"Mast-cell"
"ATGAAAGAGCCATTTG"	"T-cell"
"ATGAAAGCAACAGTGG"	"Cyst.IC-A_2"
"ATGAAAGCACAATCTG"	"Cyst.PC-CD"
"ATGAAAGGTCAACACT"	"Cyst.PC-CD"
"ATGAAAGGTCGTTATG"	"VSMC"
"ATGAAAGTCATCGGGC"	"Mast-cell"
"ATGAAAGTCGTCGCTT"	"Cyst.PC-CD"
"ATGACCAAGAACGCGT"	"Cyst.IM-CD"
"ATGACCAAGACCAACG"	"Cyst.IM-CD"
"ATGACCAAGTTTGTCG"	"Cyst.PC-CD"
"ATGACCAGTCTTGGTA"	"Cyst.IM-CD"
"ATGACCAGTGACCTGC"	"Cyst.IM-CD"
"ATGACCAGTTCGGGTC"	"Cyst.PC-CD"
"ATGACCATCGAACGGA"	"VSMC"
"ATGACCATCGTTCAGA"	"Podocytes"
"ATGAGGGAGATTGAGT"	"Cyst.IC-A_1"
"ATGAGGGAGTTGTAGA"	"Cyst.IM-CD"
"ATGAGGGCAAGAGAGA"	"Cyst.PC-CD"
"ATGAGGGCACACAGCC"	"Cyst.IC-A_1"
"ATGAGGGCAGAGCGTA"	"Cyst.IC-A_1"
"ATGAGGGCAGAGCTAG"	"Cyst.IM-CD"
"ATGAGGGGTGGCATCC"	"Mast-cell"
"ATGAGGGTCACTTCTA"	"Podocytes"
"ATGAGGGTCTCCATAT"	"Cyst.PC-CD"
"ATGAGGGTCTCGCGTT"	"Podocytes"
"ATGAGTCAGTCACACT"	"Cyst.PC-CD"
"ATGATCGAGGAAAGTG"	"EC"
"ATGATCGCAAACAGGC"	"Cyst.PT_2"
"ATGATCGCAAGACGAC"	"Cyst.PT_1"
"ATGATCGCAATAGTCC"	"VSMC"
"ATGATCGCACTACACA"	"Cyst.PT_1"
"ATGATCGCAGGCACAA"	"Cyst.IM-CD"
"ATGATCGCAGTAACAA"	"Cyst.IC-A_2"
"ATGATCGGTTCTCGTC"	"Cyst.cTAL"
"ATGCATGAGAAGAGCA"	"Cyst.IC-A_1"
"ATGCATGAGCTGTTCA"	"Cyst.PC-CD"
"ATGCATGCAACGGGTA"	"EC"
"ATGCATGCATGCGGTC"	"Cyst.PC-CD"
"ATGCATGCATGTGCTA"	"PEC"
"ATGCATGGTCACCACG"	"Cyst.PC-CD"
"ATGCATGGTCCTGTCT"	"Cyst.IM-CD"
"ATGCATGGTCGCGGTT"	"Cyst.cTAL"
"ATGCATGTCAGCTCTC"	"Cyst.PT_2"
"ATGCATGTCTACGCGG"	"Podocytes"
"ATGCCTCAGTTACGTC"	"T-cell"
"ATGCCTCCAAAGCGTG"	"Cyst.IC-A_1"
"ATGCCTCGTACGCGTC"	"PEC"
"ATGCCTCGTTACTCAG"	"Cyst.PC-CD"
"ATGCCTCTCATTCACT"	"T-cell"
"ATGCGATAGTGCCGAA"	"Podocytes"
"ATGCGATCAAACGTGG"	"Cyst.IC-A_1"
"ATGCGATGTATCCCTC"	"Podocytes"
"ATGCGATGTCGGCACT"	"Cyst.cTAL"
"ATGCGATGTTCTCACC"	"Cyst.IC-A_2"
"ATGCGATTCGTTGTGA"	"Cyst.PC-CD"
"ATGCGATTCTAGTCAG"	"T-cell"
"ATGGAGGCAAGGCAAC"	"PEC"
"ATGGAGGCAAGTACCT"	"Cyst.IM-CD"
"ATGGAGGCACCCTGTT"	"Cyst.PC-CD"
"ATGGAGGCAGTAACAA"	"Cyst.IM-CD"
"ATGGAGGCATCGATGT"	"Cyst.PC-CD"
"ATGGAGGGTTGCAAGG"	"Cyst.PC-CD"
"ATGGAGGTCACACCCT"	"Cyst.PC-CD"
"ATGGAGGTCCTAAGTG"	"Cyst.IC-A_1"
"ATGGAGGTCGACTCCT"	"Cyst.PC-CD"
"ATGGAGGTCTTACCAT"	"PEC"
"ATGGATCAGAGCATCG"	"Cyst.IC-A_2"
"ATGGATCCAGCACACC"	"Mac/DC"
"ATGGATCGTGCAACAG"	"Cyst.PC-CD"
"ATGGATCTCATAGCAC"	"Cyst.PC-CD"
"ATGGATCTCGAACGCC"	"Cyst.PC-CD"
"ATGGGAGAGAGGATCC"	"Cyst.PC-CD"
"ATGGGAGCACACGCCA"	"Cyst.cTAL"
"ATGGGAGCACCATATG"	"Cyst.CD"
"ATGGGAGCAGCTCTGG"	"Cyst.PC-CD"
"ATGGGAGGTTCTTGCC"	"Podocytes"
"ATGGGTTCAGTGTATC"	"Cyst.PC-CD"
"ATGGGTTGTAAGTTGA"	"Podocytes"
"ATGGGTTGTTAGCGGA"	"Cyst.IM-CD"
"ATGGGTTTCACTTGGA"	"Podocytes"
"ATGGGTTTCGTCGACG"	"Cyst.IC-A_2"
"ATGGTTGAGCTGTCCG"	"Cyst.PC-CD"
"ATGGTTGCATATGAAG"	"Cyst.PC-CD"
"ATGGTTGGTGATTGGG"	"PEC"
"ATGGTTGGTGCGCTCA"	"PEC"
"ATGGTTGTCGATGCAT"	"Cyst.CD"
"ATGTCCCAGTGGACGT"	"Cyst.PC-CD"
"ATGTCCCCATCTCAAG"	"Cyst.PC-CD"
"ATGTCCCGTCCAGGTC"	"Cyst.IC-A_2"
"ATGTCCCGTTGATGTC"	"Podocytes"
"ATGTCCCGTTGCTCAA"	"Cyst.PC-CD"
"ATGTCCCTCGAGTGAG"	"Cyst.IC-A_2"
"ATGTCTTAGTTCACTG"	"Cyst.IM-CD"
"ATGTCTTTCGGACTGC"	"Cyst.PT_1"
"ATGTCTTTCTGACGCG"	"Cyst.PC-CD"
"ATTACCTCACACACTA"	"B-cell_2"
"ATTACCTGTGATACAA"	"Podocytes"
"ATTACCTTCACTTCTA"	"Cyst.cTAL"
"ATTACCTTCGTAACTG"	"Cyst.IC-A_2"
"ATTACTCAGTCTGCAT"	"VSMC"
"ATTACTCCAACCGTAT"	"VSMC"
"ATTACTCCAAGGCAAC"	"Cyst.PC-CD"
"ATTACTCGTGCTCTCT"	"Cyst.IM-CD"
"ATTACTCGTGGAGAAA"	"Cyst.IM-CD"
"ATTACTCTCCGCTGTT"	"Cyst.PC-CD"
"ATTACTCTCCTTGAAG"	"Cyst.IM-CD"
"ATTACTCTCTTCACAT"	"PEC"
"ATTATCCAGCGTTGTT"	"Cyst.PC-CD"
"ATTATCCAGTTGCGAG"	"Cyst.IC-A_1"
"ATTATCCCACTATGTG"	"Cyst.IC-A_2"
"ATTATCCGTATCGTTG"	"Podocytes"
"ATTATCCGTGGATGAC"	"Podocytes"
"ATTATCCTCTCCGAAA"	"Mast-cell"
"ATTATCCTCTGGCCAG"	"Cyst.PC-CD"
"ATTCACTAGGATATAC"	"Cyst.cTAL"
"ATTCACTAGGCTAGCA"	"Cyst.CD"
"ATTCACTAGGTCCTGC"	"Cyst.PT_2"
"ATTCACTAGTACAGAT"	"T-cell"
"ATTCACTAGTAGCCAG"	"Cyst.IM-CD"
"ATTCACTCAAGACCGA"	"Cyst.IC-A_2"
"ATTCACTCAGCTTTCC"	"Cyst.IC-A_1"
"ATTCACTCATGGTGGA"	"Cyst.IM-CD"
"ATTCACTGTTCAGTAC"	"Cyst.PT_1"
"ATTCACTTCGCGGACT"	"T-cell"
"ATTCAGGCAAGTGATA"	"VSMC"
"ATTCAGGCACCAATTG"	"Cyst.IC-A_1"
"ATTCAGGCATGGGTCC"	"Cyst.PT_2"
"ATTCAGGGTAAGTAGT"	"Mac/DC"
"ATTCAGGGTGACAACG"	"Cyst.IC-A_1"
"ATTCATCAGGGCAGTT"	"Cyst.PC-CD"
"ATTCATCCAAAGGCTG"	"B-cell_1"
"ATTCATCCACAGAAGC"	"Cyst.IM-CD"
"ATTCATCGTAACGGTG"	"Cyst.PT_1"
"ATTCATCGTGCGGCTT"	"Cyst.cTAL"
"ATTCATCGTTTACGAC"	"Cyst.PC-CD"
"ATTCATCTCTCTCCGA"	"Cyst.PC-CD"
"ATTCCATAGAGATGCC"	"Cyst.IC-A_2"
"ATTCCATAGATGGCAC"	"Cyst.IM-CD"
"ATTCCATAGTTGCGCC"	"PEC"
"ATTCCATCAAACTCTG"	"EC"
"ATTCCATGTGATCATC"	"Cyst.IM-CD"
"ATTCCCGAGATTGTGA"	"Cyst.PC-CD"
"ATTCCCGCAGCTCGGT"	"VSMC"
"ATTCCCGCAGGACTAG"	"Cyst.PC-CD"
"ATTCCCGCATTGACTG"	"Cyst.IC-A_1"
"ATTCCCGGTCTCACAA"	"Cyst.PC-CD"
"ATTCCCGTCAAACGTC"	"PEC"
"ATTCCCGTCGGCTATA"	"Cyst.PC-CD"
"ATTCCTACACGCGCAT"	"PEC"
"ATTCCTATCAATCCGA"	"Cyst.IM-CD"
"ATTCGTTAGATGGTAT"	"Cyst.PT_2"
"ATTCGTTAGCATCCTA"	"Mast-cell"
"ATTCGTTAGTAGGGTC"	"Cyst.IM-CD"
"ATTCGTTCAAAGGGCT"	"EC"
"ATTCGTTCACTGGCCA"	"Cyst.IM-CD"
"ATTCGTTGTGTCTCCT"	"Mast-cell"
"ATTCGTTTCAACCTCC"	"Cyst.IC-A_2"
"ATTCGTTTCCAGCCTT"	"Cyst.PC-CD"
"ATTCTACCAGATACCT"	"PEC"
"ATTCTACGTAGTCTTG"	"Cyst.PC-CD"
"ATTCTACTCGTGCGAC"	"PEC"
"ATTCTTGAGTACTCGT"	"Cyst.IM-CD"
"ATTCTTGGTGACCGTC"	"PEC"
"ATTCTTGGTGGCAGAT"	"VSMC"
"ATTCTTGTCGGTAAGG"	"VSMC"
"ATTGGGTAGTCTGCGC"	"Cyst.PT_1"
"ATTGGGTGTGTACGCC"	"Cyst.IC-A_1"
"ATTGGGTTCCGCGAGT"	"PEC"
"ATTGGGTTCGCAATTG"	"Cyst.PT_2"
"ATTGGGTTCTGTCGTC"	"Cyst.PC-CD"
"ATTGTTCAGGTGGTTG"	"PEC"
"ATTGTTCAGTAACGAT"	"Cyst.PC-CD"
"ATTGTTCCACCTCTGT"	"Podocytes"
"ATTGTTCCAGCACAGA"	"Cyst.PC-CD"
"ATTGTTCCAGCAGATG"	"Cyst.PT_1"
"ATTGTTCCATGCCGCA"	"Cyst.IM-CD"
"ATTGTTCGTGCACGCT"	"PEC"
"ATTGTTCGTGCCCAGT"	"Cyst.IM-CD"
"ATTGTTCTCATTACCT"	"Cyst.PC-CD"
"ATTGTTCTCGTGCACG"	"Cyst.IC-A_1"
"ATTTACCAGTCAGAGC"	"VSMC"
"ATTTACCAGTCCTACA"	"Cyst.IM-CD"
"ATTTACCCAGAACATA"	"Cyst.PC-CD"
"ATTTACCCAGAATTCC"	"Cyst.IM-CD"
"ATTTACCCAGGTGGAT"	"Cyst.PC-CD"
"ATTTACCGTATCTCGA"	"PEC"
"ATTTACCGTCTCACAA"	"Cyst.IM-CD"
"ATTTACCGTGGGCTTC"	"Podocytes"
"ATTTACCGTTGTAGCT"	"Cyst.IC-A_2"
"ATTTACCTCAAGCCGC"	"Cyst.IC-A_2"
"ATTTACCTCATCACAG"	"Mast-cell"
"ATTTCACAGGGAGGGT"	"Cyst.cTAL"
"ATTTCACAGTTTGAGA"	"Cyst.IM-CD"
"ATTTCACCAACGGGTA"	"Cyst.PT_1"
"ATTTCACCAGTCAGTT"	"Cyst.PC-CD"
"ATTTCACCATTAAGCC"	"Cyst.IC-A_2"
"ATTTCACGTAACGATA"	"Cyst.IC-A_2"
"ATTTCACTCGTGGCTG"	"Cyst.PC-CD"
"ATTTCACTCTTCGTGC"	"T-cell"
"ATTTCTGAGTGGATTA"	"Cyst.IM-CD"
"ATTTCTGAGTTGCTGT"	"B-cell_2"
"ATTTCTGGTCGGCCTA"	"PEC"
"ATTTCTGGTCTCAAGT"	"Cyst.IM-CD"
"ATTTCTGGTGTATTGC"	"Cyst.IC-A_2"
"ATTTCTGTCATTCTTG"	"Cyst.IM-CD"
"ATTTCTGTCGGCTGTG"	"Cyst.IC-A_2"
"ATTTCTGTCTCGCGTT"	"Cyst.PT_2"
"CAAAGAAAGTTCCAGT"	"Cyst.IM-CD"
"CAAAGAAGTAGGACCA"	"Cyst.PC-CD"
"CAAAGAAGTAGTCGTT"	"Cyst.PC-CD"
"CAAAGAAGTCACGCTG"	"PEC"
"CAAAGAAGTGTGAGCA"	"Cyst.PC-CD"
"CAAAGAAGTTAGGGAC"	"Mac/DC"
"CAAAGAAGTTATGTCG"	"Cyst.IC-A_2"
"CAAAGAAGTTGTTGAC"	"Podocytes"
"CAAAGAATCAACCCGG"	"Cyst.IM-CD"
"CAACAACAGAGACAAG"	"Cyst.PC-CD"
"CAACAACAGCCTAACT"	"Cyst.PC-CD"
"CAACAACAGTCTTCGA"	"Cyst.PC-CD"
"CAACAACCACTGAGTT"	"PEC"
"CAACAACCAGCACAGA"	"Cyst.IC-A_1"
"CAACAACGTATGACAA"	"Cyst.PC-CD"
"CAACAGTAGACAACTA"	"Cyst.PC-CD"
"CAACAGTGTCGTCTCT"	"EC"
"CAACAGTGTGCGTGCT"	"Cyst.IM-CD"
"CAACAGTGTGTGGTCC"	"PEC"
"CAACCAAAGCGCACAA"	"Cyst.PC-CD"
"CAACCAAAGGGACCAT"	"Cyst.CD"
"CAACCAAAGGGACTGT"	"PEC"
"CAACCAACATCCGTGG"	"Cyst.PC-CD"
"CAACCAACATTCCTCG"	"B-cell_1"
"CAACCAAGTAGTCCTA"	"Cyst.PC-CD"
"CAACCAAGTGTTCGAT"	"Cyst.IM-CD"
"CAACCAAGTTCCGCAG"	"VSMC"
"CAACCAATCACTGGGC"	"VSMC"
"CAACCTCAGCTGACCC"	"Cyst.IC-A_1"
"CAACCTCAGGCTGTAG"	"Cyst.cTAL"
"CAACCTCCAACTTGGT"	"Cyst.IM-CD"
"CAACCTCCAGCCGGTT"	"Cyst.IC-A_2"
"CAACCTCGTGCAATAA"	"PEC"
"CAACCTCTCCAGTTCC"	"Cyst.IM-CD"
"CAACCTCTCGCAGTGC"	"Podocytes"
"CAACGATAGACCAAAT"	"Cyst.IM-CD"
"CAACGATAGATGAAGG"	"Cyst.IM-CD"
"CAACGATAGTGAGTGC"	"Cyst.IC-A_2"
"CAACGATCAGCTCCTT"	"B-cell_2"
"CAACGATGTGGTCCGT"	"B-cell_1"
"CAACGATTCCCATGGG"	"Cyst.IC-A_2"
"CAACGATTCCGAAGGA"	"Podocytes"
"CAACGATTCGTCAACA"	"Cyst.IC-A_2"
"CAACGGCAGACTGTTC"	"Cyst.IC-A_2"
"CAACGGCAGCAAACAT"	"Cyst.PC-CD"
"CAACGGCAGTAGACCG"	"Cyst.PC-CD"
"CAACGGCAGTGTGTTC"	"PEC"
"CAACGGCCAACTTGCA"	"Cyst.IC-A_2"
"CAACGGCCACACCAGC"	"Cyst.PC-CD"
"CAACGGCCACGCGGTT"	"Mac/DC"
"CAACGGCGTACGTTCA"	"Cyst.PC-CD"
"CAAGACTAGATAGTCA"	"Cyst.IC-A_1"
"CAAGACTAGCATCCCG"	"Cyst.IM-CD"
"CAAGACTCAATCTCTT"	"Cyst.IM-CD"
"CAAGACTCAGCAGTCC"	"Cyst.IC-A_2"
"CAAGACTGTACGGTTT"	"PEC"
"CAAGACTGTTAGCGGA"	"Cyst.PC-CD"
"CAAGACTGTTGGGTAG"	"Cyst.IC-A_1"
"CAAGAGGAGCAATTCC"	"Cyst.PC-CD"
"CAAGAGGCAATGAAAC"	"Cyst.cTAL"
"CAAGAGGCAGGTCAAG"	"Cyst.IC-A_2"
"CAAGAGGCATGACTTG"	"Cyst.IC-A_1"
"CAAGAGGGTCATCGGC"	"B-cell_2"
"CAAGAGGGTCCAGGTC"	"PEC"
"CAAGAGGGTGGGTCAA"	"Cyst.IC-A_1"
"CAAGAGGGTTCAGGTT"	"VSMC"
"CAAGCTAGTTACGATC"	"Cyst.PC-CD"
"CAAGGGAAGTCCTGCG"	"Podocytes"
"CAAGGGAAGTTGAAGT"	"Cyst.PC-CD"
"CAAGGGACAACGGCCT"	"Cyst.IC-A_1"
"CAAGGGAGTAACATAG"	"PEC"
"CAAGGGATCAGACTGT"	"Cyst.IC-A_2"
"CAAGGGATCCAACCGG"	"VSMC"
"CAAGGGATCGATTTCT"	"VSMC"
"CAATACGAGAGTGAAG"	"EC"
"CAATACGCAAATGCGG"	"Mast-cell"
"CAATACGCAATAGAGT"	"EC"
"CAATACGCATGGAACG"	"Cyst.PC-CD"
"CAATACGGTCTGATCA"	"Cyst.PC-CD"
"CAATCGAAGATGGCAC"	"Cyst.PC-CD"
"CAATCGAGTACCGTGC"	"Cyst.PC-CD"
"CAATCGAGTAGGTCAG"	"Cyst.IC-A_2"
"CAATCGAGTGTCCCTT"	"Podocytes"
"CAATGACAGATGTAGT"	"PEC"
"CAATGACCAAAGGCAC"	"PEC"
"CAATGACCAGCTAACT"	"Cyst.PC-CD"
"CAATGACCATAGAATG"	"Cyst.IC-A_1"
"CAATGACCATTGACTG"	"Podocytes"
"CAATGACGTACACGCC"	"PEC"
"CAATGACGTAGATTGA"	"Cyst.IM-CD"
"CAATGACGTATGCGTT"	"Cyst.IM-CD"
"CAATGACGTCGGTGAA"	"Cyst.IM-CD"
"CAATGACGTGCGCTCA"	"B-cell_2"
"CAATGACGTTGAGTCT"	"Cyst.IM-CD"
"CAATGACTCCTCTAGC"	"VSMC"
"CAATGACTCGAAGTGG"	"Cyst.PC-CD"
"CAATGACTCTAAGAAG"	"PEC"
"CAATTTCAGAAGCCTG"	"Cyst.IC-A_2"
"CAATTTCCACACCGCA"	"EC"
"CAATTTCCACGAAAGC"	"Cyst.cTAL"
"CAATTTCCAGGTCAAG"	"Podocytes"
"CAATTTCCATCCGCGA"	"Cyst.IM-CD"
"CAATTTCGTGAGATTA"	"Cyst.IC-A_1"
"CAATTTCTCTCAACGA"	"Cyst.cTAL"
"CACAACACAAATGCTC"	"Cyst.PC-CD"
"CACAACAGTATAGGAT"	"Cyst.PC-CD"
"CACAACAGTGAACCGA"	"Cyst.IM-CD"
"CACAACAGTGACAACG"	"Mac/DC"
"CACAACAGTGTGATGG"	"PEC"
"CACAACAGTTCCGCGA"	"Cyst.IM-CD"
"CACAACATCAAGTGTC"	"Cyst.IM-CD"
"CACAACATCACCTGGG"	"Cyst.IC-A_2"
"CACAACATCCAAAGGG"	"Podocytes"
"CACAACATCGAAGGAC"	"Cyst.PC-CD"
"CACAACATCGACATCA"	"Cyst.IM-CD"
"CACACAAAGCACAAAT"	"Cyst.PC-CD"
"CACACAAGTTTAGACC"	"Podocytes"
"CACACAATCCTAGCTC"	"Podocytes"
"CACACAATCTTAGCTT"	"VSMC"
"CACAGATAGACTCAAA"	"PEC"
"CACAGATAGAGCCTGA"	"Mac/DC"
"CACAGATAGCACCGTC"	"Cyst.IM-CD"
"CACAGATAGTAACCTC"	"PEC"
"CACAGATAGTGGTCAG"	"Cyst.cTAL"
"CACAGATGTGCCAAGA"	"T-cell"
"CACAGATGTTCTAAGC"	"Cyst.IC-A_1"
"CACAGATGTTGTGTTG"	"VSMC"
"CACAGATTCGACGTCG"	"Cyst.IM-CD"
"CACAGATTCTTGTTAC"	"Cyst.IM-CD"
"CACAGGCAGGGCTGAT"	"Cyst.cTAL"
"CACAGGCTCAAAGGTA"	"PEC"
"CACAGGCTCCCAGCGA"	"Cyst.cTAL"
"CACAGGCTCCGGGACT"	"Cyst.PC-CD"
"CACAGGCTCTGTAACG"	"Cyst.CD"
"CACATGAAGAGGCTGT"	"Cyst.IM-CD"
"CACATGAAGTTTCGGT"	"Cyst.IM-CD"
"CACATGACATCCGGTG"	"Cyst.IM-CD"
"CACATGAGTCGTCATA"	"Cyst.CD"
"CACATGAGTGTCATTG"	"Cyst.PC-CD"
"CACATGATCACTGGTA"	"PEC"
"CACCAAACACTGTGTA"	"VSMC"
"CACCAAACATGATCTG"	"Cyst.IC-A_1"
"CACCAAACATTGTCGA"	"Cyst.IM-CD"
"CACCAAAGTTATGGTC"	"PEC"
"CACCAAAGTTGGACCC"	"Cyst.cTAL"
"CACCAAATCACACCGG"	"Cyst.IM-CD"
"CACCAAATCCCATGGG"	"Podocytes"
"CACCAAATCTGTACAG"	"Cyst.PC-CD"
"CACCGTTAGGATAATC"	"PEC"
"CACCGTTCACAAGTGG"	"Cyst.PC-CD"
"CACCGTTCACTTGAGT"	"B-cell_1"
"CACCGTTCAGAGTTCT"	"Cyst.cTAL"
"CACCGTTCAGATCCTA"	"Cyst.PC-CD"
"CACCGTTGTCAACGCC"	"VSMC"
"CACCGTTGTCCAGGTC"	"Cyst.IC-A_2"
"CACCGTTGTTAGGGAC"	"Cyst.PC-CD"
"CACCGTTTCCACTGGG"	"Cyst.PC-CD"
"CACCGTTTCCTTCTAA"	"PEC"
"CACGAATAGATGCTTC"	"Podocytes"
"CACGAATAGGCACCAA"	"PEC"
"CACGAATAGGGACTGT"	"Cyst.IM-CD"
"CACGAATCACAGGATG"	"Cyst.IC-A_2"
"CACGAATCACGCGCTA"	"Cyst.PC-CD"
"CACGAATCAGCACAAG"	"Cyst.IC-A_2"
"CACGAATTCCTAAACG"	"PEC"
"CACGGGTAGCACACCC"	"Cyst.IM-CD"
"CACGGGTAGGTGAGCT"	"PEC"
"CACGGGTAGTTACGGG"	"Mast-cell"
"CACGGGTAGTTCCATG"	"VSMC"
"CACGGGTTCAGGAGAC"	"Cyst.IM-CD"
"CACGGGTTCTCTAGGA"	"PEC"
"CACGTGGCACCGGCTA"	"Cyst.CD"
"CACGTGGGTGTGATGG"	"Podocytes"
"CACGTGGTCTTGATTC"	"Cyst.IC-A_2"
"CACGTGGTCTTTCCGG"	"Cyst.PC-CD"
"CACGTTCAGCGTCTGC"	"Cyst.cTAL"
"CACGTTCCACAAACGG"	"Cyst.cTAL"
"CACGTTCTCCACCTCA"	"B-cell_1"
"CACTGAAGTTCTAACG"	"PEC"
"CACTGAAGTTTACTGG"	"Cyst.PC-CD"
"CACTGAATCCCTAGGG"	"Cyst.PC-CD"
"CACTGGGAGATGTTCC"	"Cyst.IM-CD"
"CACTGGGAGGCCCGTT"	"Mast-cell"
"CACTGGGGTACCTATG"	"VSMC"
"CACTGGGTCGGTAACT"	"Cyst.cTAL"
"CACTGGGTCTATACGG"	"Cyst.PT_2"
"CACTGTCAGAAGGGAT"	"Podocytes"
"CACTGTCAGCTCTTCC"	"Cyst.IC-A_2"
"CACTGTCCACAAGTGG"	"Mac/DC"
"CACTGTCTCATTCATC"	"Cyst.PC-CD"
"CACTGTCTCCATGAGT"	"Cyst.cTAL"
"CACTGTCTCCGACATA"	"Cyst.PC-CD"
"CACTTCGAGACGGTTG"	"Cyst.cTAL"
"CACTTCGAGCACTAGG"	"Cyst.PT_1"
"CACTTCGCACCAGTTA"	"Mast-cell"
"CACTTCGCAGCTAACT"	"PEC"
"CACTTCGGTACATTGC"	"Cyst.IM-CD"
"CACTTCGGTGAATGAT"	"T-cell"
"CACTTCGTCAGGAACG"	"Cyst.IC-A_2"
"CACTTCGTCCAGTGCG"	"Cyst.IC-A_2"
"CACTTCGTCGACATCA"	"Podocytes"
"CACTTCGTCGAGTCCG"	"Cyst.PC-CD"
"CACTTCGTCGCCGTGA"	"Cyst.IM-CD"
"CAGAGCCAGAATACAC"	"Podocytes"
"CAGAGCCAGGCCCACT"	"Cyst.PC-CD"
"CAGAGCCGTATCGAGG"	"Cyst.IM-CD"
"CAGAGCCGTCGCGTTG"	"PEC"
"CAGAGCCTCGGTCACG"	"VSMC"
"CAGATACAGCCATCCG"	"Cyst.IM-CD"
"CAGATACAGGACATCG"	"Cyst.IC-A_1"
"CAGATACAGTGAGCCA"	"Cyst.IM-CD"
"CAGATACCAATCTGCA"	"Cyst.IM-CD"
"CAGATACGTAATGATG"	"PEC"
"CAGATACGTATCTTCT"	"Cyst.PC-CD"
"CAGATACGTCTTACTT"	"EC"
"CAGATACTCCGAGAAG"	"Cyst.PC-CD"
"CAGATACTCCTATTTG"	"EC"
"CAGATACTCTACACTT"	"Cyst.PC-CD"
"CAGATCAAGAGTTGCG"	"Cyst.IM-CD"
"CAGATCATCACCCATC"	"Cyst.IC-A_2"
"CAGATCATCTCCTGAC"	"PEC"
"CAGATTGAGGCTGTAG"	"Podocytes"
"CAGATTGAGTTTCGAC"	"Mac/DC"
"CAGATTGCACATGAAA"	"Cyst.PC-CD"
"CAGATTGCAGATTTCG"	"Cyst.IC-A_1"
"CAGATTGGTCTAGGCC"	"Cyst.IM-CD"
"CAGATTGGTGAGTCAG"	"Mac/DC"
"CAGATTGGTGGCCACT"	"Cyst.IM-CD"
"CAGATTGTCCACTTTA"	"EC"
"CAGCAATGTGTAAATG"	"Cyst.IM-CD"
"CAGCAATTCGCAATGT"	"PEC"
"CAGCAATTCTCATTTG"	"Mac/DC"
"CAGCACGAGGATTTGA"	"Cyst.IM-CD"
"CAGCACGAGTTGTAGA"	"Cyst.IM-CD"
"CAGCACGCAACAAAGT"	"Cyst.IC-A_1"
"CAGCACGCAACGCATT"	"Cyst.PC-CD"
"CAGCACGCATCCGTTC"	"Cyst.PC-CD"
"CAGCACGGTAAGAACT"	"Cyst.PC-CD"
"CAGCACGGTGACCGTC"	"Cyst.cTAL"
"CAGCACGGTTGTGCAT"	"Cyst.PC-CD"
"CAGCACGTCGATACTG"	"Cyst.PC-CD"
"CAGCAGCAGGACAACC"	"PEC"
"CAGCAGCGTCTCGGAC"	"Cyst.PT_1"
"CAGCCAGAGCGTTCAT"	"Cyst.IC-A_1"
"CAGCCAGAGTGAATAC"	"Cyst.CD"
"CAGCCAGGTCGTAATC"	"Cyst.IM-CD"
"CAGCCAGGTCTCACGG"	"Cyst.cTAL"
"CAGCCAGTCCATTTGT"	"Cyst.CD"
"CAGCCAGTCTTTCCGG"	"Cyst.PT_1"
"CAGCGTGGTGGAGAAA"	"EC"
"CAGGCCAAGACCTTTG"	"Mast-cell"
"CAGGCCACATGTACGT"	"Cyst.IM-CD"
"CAGGCCAGTCAACACT"	"Cyst.IM-CD"
"CAGGCCAGTCGCTTGG"	"Cyst.PC-CD"
"CAGGCCAGTGAGATAT"	"Cyst.PC-CD"
"CAGGCCAGTGATACCT"	"VSMC"
"CAGGCCAGTTGCAAGG"	"PEC"
"CAGGCCATCGAGAGAC"	"Podocytes"
"CAGGGCTAGGAAAGTG"	"Cyst.IM-CD"
"CAGGGCTAGTTACGAA"	"Cyst.cTAL"
"CAGGGCTGTTGCGAAG"	"Cyst.IM-CD"
"CAGGTATCATATAGCC"	"Cyst.PC-CD"
"CAGGTATGTCGGAACA"	"Cyst.IC-A_2"
"CAGGTATGTTAGGACG"	"Cyst.IC-A_2"
"CAGGTATTCGTTTACT"	"VSMC"
"CAGTGCGAGGACATCG"	"Podocytes"
"CAGTGCGCAAGCGCTC"	"Mast-cell"
"CAGTGCGCACAGTGTT"	"Cyst.PC-CD"
"CAGTGCGCACTTCTCG"	"Cyst.IM-CD"
"CAGTGCGCAGAAGCGT"	"Podocytes"
"CAGTGCGGTCTTCAAG"	"Cyst.PC-CD"
"CAGTGCGTCAGATTGC"	"Cyst.PC-CD"
"CAGTTAGAGTAGCAAT"	"Cyst.PC-CD"
"CAGTTAGCATACATCG"	"Cyst.IM-CD"
"CAGTTAGGTCAAAGAT"	"Cyst.IM-CD"
"CAGTTAGGTCGCGTCA"	"Cyst.IC-A_1"
"CAGTTAGGTCTCGCGA"	"PEC"
"CAGTTAGGTGTGCCTG"	"Cyst.PC-CD"
"CAGTTAGTCTACACAG"	"Cyst.PC-CD"
"CAGTTCCAGCATCAAA"	"Cyst.PC-CD"
"CAGTTCCAGGTGCCTC"	"Cyst.IC-A_1"
"CAGTTCCCACGCGTGT"	"Mast-cell"
"CAGTTCCGTAGTTAGA"	"Cyst.IM-CD"
"CAGTTCCGTATGTCTG"	"Cyst.PC-CD"
"CAGTTCCGTCACCTTC"	"PEC"
"CATAAGCAGATTGAGT"	"Podocytes"
"CATAAGCCATAGGTAA"	"Cyst.PT_2"
"CATAAGCGTAATGTGA"	"Podocytes"
"CATAAGCTCGCGCCAA"	"Cyst.IM-CD"
"CATACAGAGTCATGCT"	"Mast-cell"
"CATACAGAGTGCGCTC"	"Cyst.cTAL"
"CATACAGCAACTGAAA"	"PEC"
"CATACAGCACGAGAAC"	"Cyst.cTAL"
"CATACAGCACTCCTGT"	"Podocytes"
"CATACAGCACTCTAGA"	"B-cell_1"
"CATACAGGTACAGCGA"	"Cyst.cTAL"
"CATACAGGTATGTCAC"	"Cyst.IM-CD"
"CATACAGTCAAGAGTA"	"Cyst.PC-CD"
"CATACCCCATCAGTCA"	"Cyst.PT_1"
"CATACCCCATTCTTCA"	"Cyst.IC-A_2"
"CATACCCGTCCCGGTA"	"EC"
"CATACCCGTTCTAAGC"	"Cyst.PC-CD"
"CATACCCGTTGTAGCT"	"Cyst.IC-A_2"
"CATACCCTCACTTGTT"	"T-cell"
"CATACCCTCCGAGGCT"	"PEC"
"CATACCCTCCTCTGCA"	"Cyst.PT_2"
"CATACTTAGAAGAGCA"	"Cyst.IM-CD"
"CATACTTAGACTGAGC"	"Cyst.cTAL"
"CATACTTAGCCAAGTG"	"Cyst.IM-CD"
"CATACTTAGCCGATCC"	"VSMC"
"CATACTTAGGCTGTAG"	"VSMC"
"CATACTTCATACAGCT"	"Cyst.IC-A_2"
"CATACTTGTACTCAAC"	"Cyst.IC-A_1"
"CATACTTGTGTGTGTT"	"Cyst.IM-CD"
"CATACTTGTTAAACCC"	"Podocytes"
"CATACTTTCCCAATAG"	"Cyst.PC-CD"
"CATACTTTCCTTGACC"	"EC"
"CATACTTTCGTTGTAG"	"Cyst.PC-CD"
"CATACTTTCTTCACAT"	"VSMC"
"CATAGACAGCCTCGTG"	"Cyst.IC-A_1"
"CATAGACAGCGTTCAT"	"Cyst.IM-CD"
"CATAGACCAATACCTG"	"Cyst.IM-CD"
"CATAGACCACTCACTC"	"PEC"
"CATAGACCAGAATGTA"	"PEC"
"CATAGACCAGGTTCGC"	"Cyst.IC-A_1"
"CATAGACGTGGCATCC"	"PEC"
"CATAGACTCCATACTT"	"Cyst.PC-CD"
"CATAGACTCCTCACGT"	"Cyst.IM-CD"
"CATAGACTCTATGCCC"	"Podocytes"
"CATCAAGAGCAGTAAT"	"Cyst.IC-A_1"
"CATCAAGAGTTCCAGT"	"T-cell"
"CATCCACAGTTGCTGT"	"EC"
"CATCCACCAAGGTTGG"	"Mac/DC"
"CATCCACCAATCTCTT"	"Cyst.PC-CD"
"CATCCACCAGGCGATA"	"Cyst.PC-CD"
"CATCCACTCCTGATAG"	"Cyst.IM-CD"
"CATCCCAAGACAACTA"	"Cyst.PC-CD"
"CATCCCACAATAGTGA"	"Cyst.IM-CD"
"CATCCCACAGTTTCAG"	"Cyst.PC-CD"
"CATCCCACATATGCGT"	"Cyst.IM-CD"
"CATCCCAGTGAGCGAT"	"Cyst.IM-CD"
"CATCCCAGTTACCTGA"	"Cyst.IC-A_2"
"CATCCCATCAACACGT"	"Cyst.PC-CD"
"CATCCCATCGCCGATG"	"VSMC"
"CATCCCATCGGTTGTA"	"Cyst.PC-CD"
"CATCCCATCTAGCCAA"	"PEC"
"CATCCGTAGCCATTTG"	"Cyst.IM-CD"
"CATCCGTAGGCATTTC"	"Cyst.PC-CD"
"CATCCGTCAGAAATCA"	"PEC"
"CATCCGTCATGGAACG"	"B-cell_2"
"CATCCGTGTACCGGAA"	"Cyst.PC-CD"
"CATCCGTGTTGAATCC"	"Cyst.cTAL"
"CATCCGTTCTACACAG"	"Cyst.IC-A_1"
"CATCGCTAGATCGGTG"	"Cyst.PC-CD"
"CATCGCTAGTAATACG"	"Cyst.IC-A_1"
"CATCGCTAGTCCTGTA"	"Cyst.IM-CD"
"CATCGCTAGTCGCCAC"	"VSMC"
"CATCGCTCAACTACGT"	"Cyst.IM-CD"
"CATCGCTCATTAGGAA"	"Podocytes"
"CATCGGGAGCACAAAT"	"EC"
"CATCGGGAGGGAGGCA"	"Cyst.PC-CD"
"CATCGGGAGTCACAGG"	"PEC"
"CATCGGGGTCGAACGA"	"Cyst.PC-CD"
"CATCGGGGTTGCTCGG"	"VSMC"
"CATCGGGTCACCCATC"	"Cyst.PC-CD"
"CATCGGGTCGACGCGT"	"Podocytes"
"CATCGTCAGAAGCGCT"	"Podocytes"
"CATCGTCCACTGGACC"	"Cyst.IC-A_1"
"CATCGTCCAGGACATG"	"Cyst.PC-CD"
"CATCGTCGTCCAGTTA"	"Cyst.PT_2"
"CATCGTCGTGAGGATC"	"Cyst.PC-CD"
"CATCGTCGTTCCCAAA"	"Cyst.PC-CD"
"CATCGTCGTTTGAAAG"	"EC"
"CATCGTCTCCAGTTCC"	"EC"
"CATCGTCTCCGACAGC"	"Cyst.PC-CD"
"CATCGTCTCCGTCACT"	"Cyst.PC-CD"
"CATCGTCTCGAGCCAC"	"Cyst.IM-CD"
"CATCGTCTCGTCTACC"	"Cyst.IC-A_2"
"CATGAGTAGCGATGGT"	"Cyst.PC-CD"
"CATGAGTAGCGTGTTT"	"VSMC"
"CATGAGTCAAGCAATA"	"T-cell"
"CATGAGTCACCTGATA"	"Mast-cell"
"CATGAGTCAGCAGACA"	"Cyst.cTAL"
"CATGAGTGTCTTGTCC"	"Cyst.PC-CD"
"CATGAGTGTGGGAGAG"	"Cyst.IM-CD"
"CATGAGTTCTAAGCGT"	"Cyst.IC-A_2"
"CATGAGTTCTGATGGT"	"Cyst.IM-CD"
"CATGCAAAGCGCCTTG"	"Cyst.cTAL"
"CATGCAACAATCGCAT"	"Cyst.IM-CD"
"CATGCAAGTAACAAGT"	"Cyst.IM-CD"
"CATGCAAGTAGAGGAA"	"EC"
"CATGCAAGTCGAATGG"	"Podocytes"
"CATGCAAGTGAATGTA"	"Cyst.PC-CD"
"CATGCAAGTGCCGGTT"	"Cyst.cTAL"
"CATGCAATCTAGAGCT"	"Cyst.cTAL"
"CATGCCTCAGCACCCA"	"Cyst.PC-CD"
"CATGCCTTCATTACCT"	"Podocytes"
"CATGCCTTCTGACAGT"	"VSMC"
"CATGCGGAGGAGAATG"	"VSMC"
"CATGCGGCAAATCCCA"	"PEC"
"CATGCGGCACTCCGGA"	"T-cell"
"CATGCGGCAGACCGCT"	"Cyst.PC-CD"
"CATGCGGCAGGACAGT"	"PEC"
"CATGCGGGTGGCAGAT"	"Cyst.PC-CD"
"CATGCGGTCCCGTAAA"	"Podocytes"
"CATGCGGTCGGCGATC"	"Cyst.IC-A_2"
"CATGCTCAGAGTTCGG"	"Cyst.PC-CD"
"CATGCTCAGTAATTGG"	"Cyst.IM-CD"
"CATGCTCCAATTAGGA"	"Cyst.PC-CD"
"CATGCTCTCATTGCTT"	"Cyst.PC-CD"
"CATGCTCTCTGAATCG"	"Cyst.IM-CD"
"CATGGATCAAACTAAG"	"Cyst.PC-CD"
"CATGGATCATGACGTT"	"Podocytes"
"CATGGATCATGCTGCG"	"Mast-cell"
"CATGGATGTGATGGCA"	"Cyst.IM-CD"
"CATGGATGTTATCTGG"	"Cyst.IM-CD"
"CATGGATGTTGCCATA"	"T-cell"
"CATGGATGTTTGGAAA"	"Podocytes"
"CATGGTACAAATCGGG"	"Cyst.PC-CD"
"CATGGTAGTATGCGGA"	"Cyst.PC-CD"
"CATGGTATCGTTCCTG"	"Cyst.PC-CD"
"CATTCATCACACCGAC"	"EC"
"CATTCATCATTGCCGG"	"Mast-cell"
"CATTCATGTCGTTTCC"	"Cyst.PC-CD"
"CATTCATGTGATATAG"	"Podocytes"
"CATTCATGTTGAAGTA"	"Cyst.PC-CD"
"CATTCATTCGAATCCA"	"PEC"
"CATTCCGTCGATTGAC"	"Cyst.IC-A_1"
"CATTCCGTCTCACCCA"	"Cyst.PC-CD"
"CATTCCGTCTCTGACC"	"Cyst.IC-A_2"
"CATTCTAAGAGACAAG"	"Cyst.IM-CD"
"CATTCTAAGGAGAATG"	"Cyst.IC-A_1"
"CATTCTAAGTCACTCA"	"Cyst.PC-CD"
"CATTCTAAGTTGCATC"	"Cyst.PC-CD"
"CATTCTACAGCATCTA"	"Cyst.IM-CD"
"CATTCTACATTGAGCT"	"VSMC"
"CATTCTAGTACAGTTC"	"Cyst.IC-A_2"
"CATTCTAGTCAATCTG"	"Cyst.PC-CD"
"CATTCTATCGATTTCT"	"Cyst.PC-CD"
"CATTGAGCAGAAGCGT"	"PEC"
"CATTGAGCAGCGATTT"	"PEC"
"CATTGAGGTCGCATTA"	"Cyst.PC-CD"
"CATTGAGGTCTCTCTG"	"PEC"
"CATTGAGGTGGATGAC"	"Cyst.IC-A_1"
"CATTGCCGTGGTCTGC"	"Cyst.PC-CD"
"CATTGCCGTTCCACAA"	"Mac/DC"
"CATTGCCTCAACTACG"	"Cyst.PC-CD"
"CATTGCCTCATATGGC"	"PEC"
"CATTGTTAGATGATTG"	"PEC"
"CATTGTTAGCGCTGAA"	"Cyst.IM-CD"
"CATTGTTAGTGGCGAT"	"Cyst.PC-CD"
"CATTGTTCACTCTCGT"	"Cyst.cTAL"
"CATTGTTCAGCGGTTC"	"Cyst.PC-CD"
"CATTGTTGTATCGTTG"	"Podocytes"
"CATTGTTTCAATGTCG"	"Cyst.IM-CD"
"CATTGTTTCGACATTG"	"PEC"
"CATTGTTTCGCTAGCG"	"Cyst.CD"
"CATTTCAAGACAGTCG"	"Cyst.PC-CD"
"CATTTCAAGTAAACTG"	"T-cell"
"CATTTCAGTACCCACG"	"Cyst.PC-CD"
"CATTTCAGTTGGAGGT"	"VSMC"
"CATTTCATCTCCACTG"	"Mast-cell"
"CCAAGCGAGACATACA"	"Cyst.IM-CD"
"CCAAGCGAGCATTTCG"	"Cyst.CD"
"CCAAGCGAGTCTGGTT"	"Cyst.IC-A_2"
"CCAAGCGAGTTGAATG"	"Cyst.IC-A_1"
"CCAAGCGCAGAGTTGG"	"Cyst.IM-CD"
"CCAAGCGGTAAGGTCG"	"EC"
"CCAAGCGGTGTATCCA"	"Cyst.IC-A_1"
"CCAATGAAGATGCCGA"	"PEC"
"CCAATGACAGCGTTGC"	"Cyst.PC-CD"
"CCAATGAGTCGGATTT"	"Cyst.IM-CD"
"CCAATGAGTCTAACTG"	"Cyst.PC-CD"
"CCAATGAGTGAAAGTT"	"Cyst.PC-CD"
"CCAATTTAGCTTTCTT"	"EC"
"CCAATTTGTCTCGCGA"	"Podocytes"
"CCAATTTGTGAGGATC"	"Cyst.PC-CD"
"CCAATTTTCAGCCTCT"	"Cyst.IM-CD"
"CCACAAAAGTATTCCG"	"EC"
"CCACAAAAGTTCACTG"	"VSMC"
"CCACAAACAAGCAATA"	"Cyst.IC-A_1"
"CCACAAAGTACACTCA"	"Cyst.IM-CD"
"CCACAAAGTACAGAAT"	"Cyst.PC-CD"
"CCACAAAGTATTTCCT"	"Cyst.PC-CD"
"CCACAAATCCAAGCAT"	"Cyst.IM-CD"
"CCACAAATCTGAATGC"	"Cyst.PC-CD"
"CCACACTAGATTGACA"	"PEC"
"CCACACTTCGAGAAAT"	"Mast-cell"
"CCACCATAGTTCCTGA"	"Cyst.IM-CD"
"CCACCATGTGTCCGGT"	"Podocytes"
"CCACCATTCCATTGGA"	"PEC"
"CCACCATTCTACTGAG"	"PEC"
"CCACCATTCTCGTCGT"	"Cyst.IC-A_1"
"CCACGAGAGCACGTCC"	"Cyst.cTAL"
"CCACGAGAGCAGCGAT"	"Cyst.IM-CD"
"CCACGAGAGTCAGGGT"	"Mac/DC"
"CCACGAGCAAAGGCGT"	"PEC"
"CCACGAGCAGACCCGT"	"Podocytes"
"CCACGAGTCAGCTTCC"	"PEC"
"CCACGTTCAGTTAGAA"	"Cyst.PC-CD"
"CCACGTTGTGCGGTAA"	"Cyst.PC-CD"
"CCACGTTTCGTGGACC"	"PEC"
"CCACTTGAGCTCGTGC"	"Cyst.PC-CD"
"CCACTTGCACGCTGCA"	"Mac/DC"
"CCACTTGGTGAACGGT"	"Cyst.PC-CD"
"CCATAAGAGCGACCCT"	"Mac/DC"
"CCATAAGTCCATTTGT"	"T-cell"
"CCATAAGTCGTCAAAC"	"VSMC"
"CCATCACCAGGAGGAG"	"Cyst.CD"
"CCATCACCATGGGAAC"	"Cyst.IC-A_2"
"CCATCACGTAGTCGTT"	"Cyst.IM-CD"
"CCATCACGTTCGGTCG"	"Cyst.IC-A_1"
"CCATCACTCAGACCTA"	"EC"
"CCATCACTCCTGGGTG"	"Cyst.PC-CD"
"CCATCACTCTCTCTTC"	"Cyst.PC-CD"
"CCCAACTAGACCTCAT"	"Cyst.IM-CD"
"CCCAACTCAAGCGGAT"	"Mac/DC"
"CCCAACTCACGTCTCT"	"Cyst.PC-CD"
"CCCAACTCAGAGAGGG"	"B-cell_2"
"CCCAACTGTGTTAAAG"	"Cyst.IM-CD"
"CCCAACTTCGCAGATT"	"Cyst.PC-CD"
"CCCATTGAGATTAGTG"	"Cyst.PC-CD"
"CCCATTGAGGTAAACT"	"Cyst.IM-CD"
"CCCATTGCAAACCATC"	"PEC"
"CCCATTGCATGCCGCA"	"EC"
"CCCATTGTCAACTACG"	"Mast-cell"
"CCCATTGTCCAGTGCG"	"Cyst.PC-CD"
"CCCGAAGAGCTACAAA"	"Cyst.PC-CD"
"CCCGAAGCACGCCAGT"	"VSMC"
"CCCGAAGCAGCAAGAC"	"Cyst.IC-A_2"
"CCCGAAGGTTCCCAAA"	"Podocytes"
"CCCGAAGTCCGATAAC"	"Cyst.PC-CD"
"CCCGAAGTCGTCGGGT"	"Mac/DC"
"CCCGGAAAGAAGCGAA"	"Cyst.IC-A_2"
"CCCGGAAAGGAGTATT"	"Cyst.IM-CD"
"CCCGGAAAGTTACGTC"	"T-cell"
"CCCGGAACAGCCTTCT"	"Podocytes"
"CCCGGAAGTGGCTAGA"	"EC"
"CCCTAACCAAGGGCAT"	"T-cell"
"CCCTAACGTAGTAAGT"	"Cyst.PC-CD"
"CCCTAACGTGCCAAGA"	"Cyst.cTAL"
"CCCTAACTCCGCTTAC"	"Cyst.cTAL"
"CCCTCAAAGACAGTCG"	"Cyst.PC-CD"
"CCCTCAAAGAGTGTTA"	"Podocytes"
"CCCTCAAGTACCTAGT"	"Cyst.IC-A_1"
"CCCTCAAGTAGTTACC"	"PEC"
"CCCTCAAGTGCAGGAT"	"VSMC"
"CCCTCAATCCGAGCTG"	"Cyst.PT_2"
"CCCTCTCAGACTTCAC"	"PEC"
"CCCTCTCAGAGATGCC"	"Cyst.IM-CD"
"CCCTCTCTCATCCTAT"	"Cyst.IC-A_2"
"CCCTCTCTCGCGCTGA"	"Cyst.IC-A_1"
"CCCTCTCTCGTGCAGC"	"Cyst.IM-CD"
"CCCTCTCTCTGGTTGA"	"Cyst.cTAL"
"CCCTCTCTCTTTCCAA"	"Cyst.IM-CD"
"CCCTGATAGAGTGGCT"	"Podocytes"
"CCCTGATCAAGTGATA"	"Cyst.PC-CD"
"CCCTTAGAGGTTGGAC"	"Cyst.IC-A_1"
"CCCTTAGAGTCGAATA"	"Cyst.PC-CD"
"CCCTTAGGTATGATCC"	"Cyst.IM-CD"
"CCCTTAGGTGGCCACT"	"Cyst.IM-CD"
"CCGAACGAGTGATAAC"	"Cyst.PC-CD"
"CCGAACGCAAGGCTTT"	"Cyst.IM-CD"
"CCGAACGCAGATCACT"	"Cyst.IC-A_1"
"CCGATCTAGCCGCTTG"	"Podocytes"
"CCGATCTAGCGATCGA"	"PEC"
"CCGATCTAGCGGATCA"	"Podocytes"
"CCGATCTAGGGACCAT"	"Cyst.IM-CD"
"CCGATCTCACACGGAA"	"Cyst.PC-CD"
"CCGATCTCATGTACGT"	"PEC"
"CCGATCTGTTCTCACC"	"Cyst.IM-CD"
"CCGATCTTCTTGCAAG"	"Cyst.IM-CD"
"CCGATGGAGCCTATTG"	"Cyst.IC-A_2"
"CCGATGGAGCTTTGTG"	"T-cell"
"CCGATGGAGGAACGTC"	"Cyst.PC-CD"
"CCGATGGAGTTTGTCG"	"Cyst.PC-CD"
"CCGATGGCAAATGAGT"	"Cyst.PT_2"
"CCGATGGCAAGTTGGG"	"B-cell_1"
"CCGATGGCACACGCCA"	"Cyst.PC-CD"
"CCGATGGCATCTGGGC"	"Mac/DC"
"CCGATGGGTATCGCGC"	"B-cell_2"
"CCGATGGGTGCTCTCT"	"Podocytes"
"CCGATGGTCTAGCAAC"	"Podocytes"
"CCGATGGTCTGCCCTA"	"Cyst.cTAL"
"CCGCAAGAGAAGTCTA"	"Cyst.IC-A_1"
"CCGCAAGCAATTTCGG"	"T-cell"
"CCGCAAGCACAGCCAC"	"Cyst.PC-CD"
"CCGCAAGGTCATCCCT"	"Cyst.PC-CD"
"CCGCAAGGTTCCACGG"	"Cyst.IM-CD"
"CCGCAAGTCATGGATC"	"Cyst.IM-CD"
"CCGCAAGTCGACATAC"	"Cyst.PC-CD"
"CCGCAAGTCGCTGCGA"	"PEC"
"CCGCAAGTCTGAGAGG"	"EC"
"CCGGACAGTTGATGTC"	"Cyst.IC-A_2"
"CCGGACATCTAGCCAA"	"Podocytes"
"CCGGGTAAGACGCCCT"	"VSMC"
"CCGGGTAAGATACGAT"	"Mast-cell"
"CCGGGTAAGCGACTGA"	"Mac/DC"
"CCGGGTAAGCTCATAC"	"T-cell"
"CCGGGTAAGTAAGACT"	"T-cell"
"CCGGGTAAGTTACGGG"	"Cyst.PC-CD"
"CCGGGTAGTGGCTGCT"	"Cyst.PC-CD"
"CCGGTAGCAAGACTGG"	"Cyst.cTAL"
"CCGGTAGCATTAAGCC"	"VSMC"
"CCGGTAGGTCACTACA"	"EC"
"CCGGTAGGTGCATTAC"	"Cyst.IC-A_1"
"CCGGTAGGTGCATTTG"	"Cyst.PC-CD"
"CCGGTAGTCGACCATA"	"Cyst.PC-CD"
"CCGGTGACACATCCCT"	"Cyst.PC-CD"
"CCGGTGAGTACAGGTG"	"Cyst.PC-CD"
"CCGGTGATCAACGTGT"	"Mac/DC"
"CCGGTGATCGGATACT"	"Cyst.PC-CD"
"CCGTAGGCACGGGTAA"	"Cyst.IM-CD"
"CCGTAGGCAGTCGCTG"	"Podocytes"
"CCGTAGGCATTGGATC"	"T-cell"
"CCGTAGGGTCCTGTCT"	"Cyst.IC-A_2"
"CCGTGAGAGGTGGGTT"	"Mac/DC"
"CCGTGAGCACTGCATA"	"T-cell"
"CCGTGAGCAGAGCGTA"	"Cyst.PC-CD"
"CCGTGAGCAGTTGAAA"	"Cyst.PC-CD"
"CCGTGAGCATTGCTGA"	"Cyst.IM-CD"
"CCGTGAGGTAGCTGTT"	"Cyst.IM-CD"
"CCGTGAGGTGTACGCC"	"PEC"
"CCGTGAGTCCCATTCG"	"PEC"
"CCGTGAGTCGACGCGT"	"B-cell_1"
"CCGTGAGTCGAGCCAC"	"Cyst.IM-CD"
"CCGTTCACAGTGTGGA"	"Cyst.IM-CD"
"CCGTTCAGTTGCTGAT"	"Mac/DC"
"CCGTTCATCCAATCTT"	"Cyst.cTAL"
"CCGTTCATCTGGCCGA"	"Cyst.PC-CD"
"CCTAACCAGCGTCAGA"	"PEC"
"CCTAACCAGTTAACAG"	"Cyst.IC-A_2"
"CCTAACCCATCGATCA"	"Cyst.PC-CD"
"CCTAACCGTACGAAAT"	"Podocytes"
"CCTAACCGTCACCGAC"	"Podocytes"
"CCTAACCGTGGCTGCT"	"Cyst.IM-CD"
"CCTAACCGTTCGTAAC"	"PEC"
"CCTAACCTCCCGTAAA"	"Cyst.IC-A_1"
"CCTAACCTCGCAATTG"	"Cyst.PC-CD"
"CCTAACCTCGTGTGGC"	"Mast-cell"
"CCTAACCTCTGGGAGA"	"Cyst.IC-A_2"
"CCTAAGAAGACTAAGT"	"Cyst.PC-CD"
"CCTAAGAAGGCATCGA"	"Cyst.PC-CD"
"CCTAAGAAGGCGCTTC"	"Cyst.PC-CD"
"CCTAAGAAGTAGCAAT"	"Cyst.IM-CD"
"CCTAAGACACGCTGTG"	"Cyst.cTAL"
"CCTAAGACAGAATGTA"	"Cyst.IM-CD"
"CCTAAGAGTAATGCGG"	"VSMC"
"CCTAAGAGTACGATGG"	"Cyst.IC-A_2"
"CCTACGTCAAGTCCCG"	"Cyst.PC-CD"
"CCTACGTCAGTTAGGG"	"VSMC"
"CCTACGTGTGGGCTTC"	"Cyst.PT_2"
"CCTACGTTCACTGGGC"	"Cyst.cTAL"
"CCTATCGAGCCAGTAG"	"T-cell"
"CCTATCGAGTCACAGG"	"Cyst.IC-A_1"
"CCTATCGCAATGGCCC"	"Cyst.PC-CD"
"CCTATCGCAGGACTAG"	"Cyst.IC-A_1"
"CCTATCGGTATACCCA"	"Podocytes"
"CCTATCGGTCGAGTGA"	"EC"
"CCTATCGTCAAGTGTC"	"Cyst.IC-A_1"
"CCTATCGTCTTTCAGT"	"Cyst.IM-CD"
"CCTCAACAGCAGCCTC"	"T-cell"
"CCTCAACAGGATAATC"	"PEC"
"CCTCAACCAAGGTACG"	"PEC"
"CCTCAACCACATACTG"	"Cyst.IM-CD"
"CCTCAACCAGATTTCG"	"Cyst.IC-A_1"
"CCTCAACGTGTTATCG"	"Cyst.cTAL"
"CCTCAACTCACCGCTT"	"Podocytes"
"CCTCACAAGTTGAAAC"	"Cyst.IC-A_1"
"CCTCACACATGACGGA"	"T-cell"
"CCTCACACATGGATCT"	"Cyst.IM-CD"
"CCTCACAGTATCACGT"	"Cyst.cTAL"
"CCTCACAGTCACTCGG"	"Cyst.IC-A_1"
"CCTCACATCATTGCTT"	"Cyst.cTAL"
"CCTCACATCTGAGTCA"	"Cyst.IM-CD"
"CCTCAGTAGACCTCAT"	"Podocytes"
"CCTCAGTAGCATCCTA"	"Podocytes"
"CCTCAGTAGTCCTACA"	"Cyst.PC-CD"
"CCTCAGTGTATACCCA"	"Cyst.PC-CD"
"CCTCATGAGGCTCACC"	"Podocytes"
"CCTCATGCAAATAAGC"	"Cyst.PC-CD"
"CCTCATGGTCATTGCA"	"Cyst.CD"
"CCTCATGTCGCACGGT"	"Cyst.IC-A_2"
"CCTCATGTCGCTACGG"	"Mast-cell"
"CCTCATGTCTTCGATT"	"Cyst.IM-CD"
"CCTCCAAAGGCATCAG"	"Cyst.IM-CD"
"CCTCCAACAAGCGAGT"	"Cyst.PC-CD"
"CCTCCAACACCGCTAG"	"Cyst.cTAL"
"CCTCCAATCCGCTTAC"	"Cyst.PC-CD"
"CCTCCAATCTGGTGCG"	"Podocytes"
"CCTCCTCAGCTGACTT"	"Cyst.PC-CD"
"CCTCCTCAGGAGGCAG"	"T-cell"
"CCTCCTCCAACAGCCC"	"Mast-cell"
"CCTCCTCCAGCTCATA"	"Cyst.IM-CD"
"CCTCCTCGTTCTTAGG"	"Cyst.PT_2"
"CCTCCTCGTTGTGTAC"	"Cyst.CD"
"CCTCCTCTCACTGGGC"	"PEC"
"CCTCCTCTCATCAGTG"	"Mast-cell"
"CCTCCTCTCGCGGACT"	"Cyst.IC-A_1"
"CCTCTAGAGATAACGT"	"Cyst.cTAL"
"CCTCTAGAGATGCTAA"	"Cyst.IC-A_2"
"CCTCTAGAGCAGCAGT"	"Cyst.IM-CD"
"CCTCTAGAGGTTTGAA"	"Cyst.PC-CD"
"CCTCTAGCAAATGATG"	"Cyst.PC-CD"
"CCTCTAGCAATCAGCT"	"Cyst.PC-CD"
"CCTCTAGCAGTTCACA"	"Cyst.PC-CD"
"CCTCTAGGTCACGTGC"	"Mac/DC"
"CCTCTCCAGAGTCACG"	"Podocytes"
"CCTCTCCAGTAGGGTC"	"Cyst.PC-CD"
"CCTCTCCCAAAGGGCT"	"Cyst.cTAL"
"CCTCTCCCAATCTAGC"	"PEC"
"CCTCTCCCATTCTCTA"	"Cyst.cTAL"
"CCTCTCCGTCGTGTTA"	"B-cell_2"
"CCTCTCCTCCGAAATC"	"PEC"
"CCTGCATGTGATTGGG"	"PEC"
"CCTGCATTCAGCGCAC"	"Cyst.IM-CD"
"CCTGCATTCCACAAGT"	"PEC"
"CCTGCATTCTGTAAGC"	"Podocytes"
"CCTGTTGAGACCTGGA"	"Podocytes"
"CCTGTTGAGACGGAAA"	"Cyst.IC-A_2"
"CCTGTTGCAGCTTCGG"	"VSMC"
"CCTGTTGGTCGCGGTT"	"Cyst.PC-CD"
"CCTGTTGGTGATTGGG"	"VSMC"
"CCTGTTGGTGTATACC"	"PEC"
"CCTGTTGGTTCTGAGT"	"Cyst.IC-A_1"
"CCTGTTGTCGATTTCT"	"Podocytes"
"CCTTCAGAGGGCATGT"	"Cyst.IC-A_1"
"CCTTCAGAGTCCTGCG"	"Cyst.PC-CD"
"CCTTCAGAGTTCCTGA"	"Cyst.IM-CD"
"CCTTCAGAGTTGTAAG"	"Cyst.IM-CD"
"CCTTCAGCAACGAGGT"	"Cyst.IC-A_2"
"CCTTCAGCATAATGCC"	"Cyst.PC-CD"
"CCTTCAGGTAACTAAG"	"Cyst.PC-CD"
"CCTTCAGGTGCAGTGA"	"Cyst.PC-CD"
"CCTTCAGTCACAACCA"	"Cyst.IM-CD"
"CCTTCAGTCACCTCTG"	"Cyst.PC-CD"
"CCTTGTGCACGCGTGT"	"Podocytes"
"CCTTGTGCATACCACA"	"B-cell_1"
"CCTTGTGGTAGCCAGA"	"Cyst.PT_1"
"CCTTGTGGTCGATTTG"	"Cyst.PC-CD"
"CCTTGTGGTCGCGTCA"	"Cyst.IC-A_2"
"CCTTGTGTCACCTTGC"	"Cyst.IC-A_1"
"CCTTGTGTCATGCTAG"	"Cyst.IC-A_2"
"CCTTGTGTCCGGTTCT"	"Cyst.PC-CD"
"CCTTGTGTCGCAGTTA"	"Cyst.PC-CD"
"CCTTGTGTCTGAGGTT"	"Cyst.PT_2"
"CCTTTGGCAATATCCG"	"Cyst.IM-CD"
"CCTTTGGCAGAAGTGC"	"EC"
"CGAAGGAAGAATTGCA"	"Podocytes"
"CGAAGGACAGCGTGAA"	"VSMC"
"CGAAGGACAGGTGAGT"	"PEC"
"CGAAGGAGTACGACTT"	"Cyst.PC-CD"
"CGAAGGAGTGTCGCTG"	"Cyst.PC-CD"
"CGAAGGATCGACGCTG"	"Cyst.PC-CD"
"CGAAGGATCGCGTCGA"	"VSMC"
"CGAAGTTCAGTTTCAG"	"Cyst.PC-CD"
"CGAAGTTGTACGGTTT"	"Cyst.cTAL"
"CGAAGTTGTAGAGACC"	"Cyst.PC-CD"
"CGAAGTTTCTAGTGTG"	"Cyst.IC-A_1"
"CGAAGTTTCTTACGTT"	"Cyst.IM-CD"
"CGAATTGAGTGTTCCA"	"Cyst.IC-A_2"
"CGAATTGGTCGTATGT"	"PEC"
"CGAATTGTCCCGTAAA"	"Cyst.PC-CD"
"CGACAGCAGCCGAACA"	"Cyst.IC-A_2"
"CGACAGCAGGCACTAG"	"T-cell"
"CGACAGCAGTACCGGA"	"Cyst.IM-CD"
"CGACAGCAGTCACACT"	"Cyst.cTAL"
"CGACAGCCAACAGCCC"	"VSMC"
"CGACAGCCAAGCGAGT"	"VSMC"
"CGACAGCGTACAATAG"	"PEC"
"CGACAGCGTAGAAACT"	"Cyst.PC-CD"
"CGACAGCGTCTGTAAC"	"T-cell"
"CGACAGCGTGCCGTTG"	"VSMC"
"CGACAGCGTTCCAAAC"	"VSMC"
"CGACAGCGTTGTTGTG"	"EC"
"CGACAGCTCGGTAACT"	"Cyst.IM-CD"
"CGACAGCTCGTGTGGC"	"PEC"
"CGAGAAGCATGGGTCC"	"Cyst.IC-A_1"
"CGAGAAGTCAAACGTC"	"Cyst.IC-A_1"
"CGAGAAGTCATTGCGA"	"Cyst.PC-CD"
"CGAGAAGTCCGATGTA"	"EC"
"CGAGGAAGTCAATCTG"	"Cyst.IC-A_1"
"CGAGGAATCCATACAG"	"Cyst.PC-CD"
"CGAGGAATCCCAAGTA"	"Cyst.PC-CD"
"CGAGGAATCCCGGTAG"	"Cyst.PC-CD"
"CGAGGAATCCTCTAGC"	"Podocytes"
"CGAGGAATCGTGCATA"	"Podocytes"
"CGAGGAATCTAGCAAC"	"Cyst.IC-A_1"
"CGAGGAATCTCCTGAC"	"Cyst.PC-CD"
"CGAGGCTAGAAGCCTG"	"Cyst.PC-CD"
"CGAGGCTAGACTTCCA"	"Cyst.IM-CD"
"CGAGGCTAGCAGCGAT"	"Cyst.cTAL"
"CGAGGCTCAACCAACT"	"Podocytes"
"CGAGGCTGTGTACATC"	"Podocytes"
"CGAGGCTTCTGGCCAG"	"Cyst.CD"
"CGAGTGCAGGGTGAAA"	"Cyst.IM-CD"
"CGAGTGCGTAGAGTTA"	"Cyst.PC-CD"
"CGAGTGCGTCAGTCCG"	"Cyst.IM-CD"
"CGAGTGCGTTGCTAGT"	"PEC"
"CGAGTGCTCGAGAGAC"	"Cyst.IM-CD"
"CGAGTGCTCTCCCAAC"	"Cyst.PC-CD"
"CGAGTTACACATTCGA"	"Cyst.IC-A_1"
"CGAGTTACATCCGGCA"	"EC"
"CGAGTTACATGAAAGT"	"PEC"
"CGAGTTACATGTACGT"	"Podocytes"
"CGAGTTAGTAGACGTG"	"Cyst.PC-CD"
"CGAGTTAGTAGAGCTG"	"Cyst.PC-CD"
"CGAGTTAGTGTATTCG"	"Cyst.IM-CD"
"CGAGTTAGTTCCTTGC"	"Cyst.CD"
"CGAGTTATCACTACGA"	"Cyst.PC-CD"
"CGAGTTATCGACGTCG"	"Cyst.IC-A_1"
"CGATCGGAGAGTCGAC"	"Cyst.cTAL"
"CGATCGGAGCTAGATA"	"PEC"
"CGATCGGAGTGGACGT"	"Cyst.PC-CD"
"CGATCGGCATTCAGCA"	"Cyst.IM-CD"
"CGATCGGGTCACGCTG"	"Cyst.IC-A_2"
"CGATCGGGTCGCATCG"	"Cyst.PC-CD"
"CGATCGGGTGGCCTCA"	"Cyst.PC-CD"
"CGATCGGGTTGTGCCG"	"B-cell_1"
"CGATCGGTCACATCAG"	"Cyst.PC-CD"
"CGATGCGAGCCAGAGT"	"Cyst.PC-CD"
"CGATGCGAGGCAGGTT"	"Mast-cell"
"CGATGCGAGGTAATCA"	"Cyst.PC-CD"
"CGATGCGCAACATACC"	"Cyst.cTAL"
"CGATGCGCAATCTCTT"	"PEC"
"CGATGCGGTCGGTGAA"	"Cyst.IM-CD"
"CGATGCGGTTAAGACA"	"Podocytes"
"CGATGCGTCTTGAACG"	"Cyst.IM-CD"
"CGATGGCAGAGCATAT"	"Cyst.IM-CD"
"CGATGGCAGGGTCAAC"	"Cyst.CD"
"CGATGGCCAAACCATC"	"Cyst.IM-CD"
"CGATGGCCACTATCCC"	"Mac/DC"
"CGATGGCGTAGACGTG"	"PEC"
"CGATGGCGTGGTAATA"	"Cyst.IC-A_1"
"CGCAGGTCAAATAAGC"	"Cyst.PT_1"
"CGCAGGTCACTGAATC"	"Cyst.PC-CD"
"CGCAGGTGTGGCACTC"	"Cyst.CD"
"CGCAGGTGTTAGGAGC"	"PEC"
"CGCAGGTTCATGTCAG"	"Cyst.IM-CD"
"CGCATAAAGGATGAGA"	"Cyst.PC-CD"
"CGCATAAAGGTACAAT"	"Cyst.IC-A_2"
"CGCATAACAACCGTAT"	"Cyst.IM-CD"
"CGCATAAGTCGGCACT"	"Cyst.PC-CD"
"CGCATAAGTGCGGTAA"	"Cyst.IM-CD"
"CGCATAATCAGCGCAC"	"Cyst.PT_1"
"CGCATGGGTCTTGCGG"	"Cyst.PC-CD"
"CGCATGGGTTCGAGCC"	"Cyst.IC-A_2"
"CGCATGGTCAAGCGTT"	"Podocytes"
"CGCCAGAAGACGCATG"	"PEC"
"CGCCAGAAGATACATG"	"B-cell_1"
"CGCCAGAAGCTAGTTC"	"Cyst.PC-CD"
"CGCCAGACAAACACCT"	"Cyst.PC-CD"
"CGCCAGACAAGAGTGC"	"Cyst.PC-CD"
"CGCCAGACAGGACTTT"	"Cyst.IM-CD"
"CGCCAGAGTACTGCGC"	"Cyst.PC-CD"
"CGCCAGAGTAGGACTG"	"Cyst.cTAL"
"CGCCAGAGTATCTTCT"	"PEC"
"CGCCAGAGTTGCATAC"	"Cyst.IM-CD"
"CGCCAGAGTTTGTGGT"	"Mac/DC"
"CGCCATTAGATGTTCC"	"Cyst.PC-CD"
"CGCCATTAGCTGCCAC"	"Podocytes"
"CGCCATTAGTCTTCGA"	"VSMC"
"CGCCATTCATAGACTC"	"EC"
"CGCCATTGTGTTCCTC"	"Cyst.PT_1"
"CGCCATTTCATGCATG"	"Cyst.PC-CD"
"CGCCATTTCCACATAG"	"Cyst.IM-CD"
"CGCCATTTCCTTATAC"	"Cyst.PC-CD"
"CGCGTGAGTTATTCCT"	"PEC"
"CGCGTGATCAAGCCGC"	"Cyst.IC-A_2"
"CGCGTGATCCCATTTA"	"Cyst.IC-A_1"
"CGCGTGATCCGTTGAA"	"Cyst.PC-CD"
"CGCGTGATCGTTCAGA"	"Cyst.IM-CD"
"CGCGTGATCTGTACAG"	"Cyst.IC-A_1"
"CGGAACCAGGCTTAGG"	"PEC"
"CGGAACCGTTGCGGAA"	"PEC"
"CGGAACCTCGAGAACG"	"Cyst.PC-CD"
"CGGAATTAGCCTCGTG"	"Cyst.CD"
"CGGAATTAGTCATCCA"	"Podocytes"
"CGGAATTCAGTGCGCT"	"Cyst.IC-A_1"
"CGGAATTGTACTAGCT"	"PEC"
"CGGAATTGTCGGTGAA"	"Cyst.PC-CD"
"CGGAATTTCGCAGTTA"	"Cyst.PC-CD"
"CGGAATTTCTAATTCC"	"Mast-cell"
"CGGACACAGCGCCCAT"	"VSMC"
"CGGACACAGTCCTGTA"	"Cyst.PC-CD"
"CGGACACCAAGACAAT"	"Cyst.PT_2"
"CGGAGAAAGAATTCAG"	"Cyst.cTAL"
"CGGAGAAAGCAGCCTC"	"Cyst.cTAL"
"CGGAGAAAGTGATAAC"	"Podocytes"
"CGGAGAAGTATGAGAT"	"Cyst.IC-A_1"
"CGGAGAAGTCCTGTTC"	"Cyst.PC-CD"
"CGGAGAAGTTGCTCAA"	"Cyst.PC-CD"
"CGGCAGTAGAATTGCA"	"Cyst.IC-A_1"
"CGGCAGTAGCTGTACT"	"Mast-cell"
"CGGCAGTAGGATACCG"	"Cyst.IC-A_2"
"CGGCAGTAGGCTAAAT"	"Cyst.IM-CD"
"CGGCAGTAGTAGTCTC"	"Cyst.cTAL"
"CGGCAGTCAGTAACCT"	"Cyst.IM-CD"
"CGGCAGTGTGATGTAA"	"Mast-cell"
"CGGCAGTGTGCTAGCC"	"Cyst.PC-CD"
"CGGGACTCACCAGTTA"	"PEC"
"CGGGACTGTATCACGT"	"Cyst.PC-CD"
"CGGGACTGTGTGACCC"	"Cyst.PT_1"
"CGGGACTGTTTCGTGA"	"Cyst.IM-CD"
"CGGGACTTCCCACAGG"	"EC"
"CGGGCATCATCACGGC"	"Cyst.PC-CD"
"CGGGCATGTCTACAAC"	"Cyst.CD"
"CGGGCATGTGAATTGA"	"Cyst.PC-CD"
"CGGGCATTCATTGCGA"	"Cyst.cTAL"
"CGGGCATTCTAGACCA"	"Cyst.PC-CD"
"CGGGTCAAGCCGGATA"	"Podocytes"
"CGGGTCACACCGTCTT"	"PEC"
"CGGGTCACATCAGCTA"	"PEC"
"CGGGTCATCGAGAAAT"	"Cyst.PC-CD"
"CGGGTGTAGATCCTAC"	"Cyst.IC-A_2"
"CGGGTGTCAAGGCTTT"	"Cyst.IM-CD"
"CGGGTGTCACGAAGAC"	"Cyst.PC-CD"
"CGGGTGTGTATGGAAT"	"Mac/DC"
"CGGGTGTTCATAGACC"	"PEC"
"CGGGTGTTCGCTGACG"	"Cyst.PC-CD"
"CGGGTGTTCGTGGGAA"	"Cyst.IC-A_1"
"CGGTCAGAGACCATAA"	"Mac/DC"
"CGGTCAGCACAAAGCG"	"Cyst.PC-CD"
"CGGTCAGCACAATGTC"	"Cyst.PC-CD"
"CGGTCAGCAGGCGATA"	"EC"
"CGGTCAGCATGGAAGC"	"Cyst.IC-A_1"
"CGGTCAGGTTCCGGTG"	"Cyst.PC-CD"
"CGGTCAGTCCTCACTG"	"Cyst.PT_1"
"CGTAAGTAGCGTGTTT"	"Cyst.PC-CD"
"CGTAAGTCACAAATCC"	"Cyst.IM-CD"
"CGTAAGTTCCCAACTC"	"Cyst.PC-CD"
"CGTAAGTTCTAGGAAA"	"Cyst.PC-CD"
"CGTAAGTTCTTAGCCC"	"EC"
"CGTAATGAGGTCGCCT"	"Podocytes"
"CGTAATGCAACGACTT"	"Cyst.IM-CD"
"CGTAATGCAAGAGATT"	"Cyst.IC-A_1"
"CGTAATGCATCGTCCT"	"Cyst.CD"
"CGTAATGGTCAACCTA"	"PEC"
"CGTAATGTCACAAGAA"	"Cyst.PC-CD"
"CGTAATGTCAGTGTCA"	"B-cell_1"
"CGTAGTAAGGCCACTC"	"Cyst.IM-CD"
"CGTAGTAGTCGAGTGA"	"Cyst.IM-CD"
"CGTAGTAGTTTGGAGG"	"Mac/DC"
"CGTCAAAAGAAGAACG"	"Cyst.IM-CD"
"CGTCAAAAGCACCAGA"	"Cyst.PC-CD"
"CGTCAAACATAGGAGC"	"Cyst.IC-A_2"
"CGTCAAAGTAATGATG"	"B-cell_1"
"CGTCAAATCGGTAGGA"	"Cyst.IM-CD"
"CGTCCATAGAACTGAT"	"Mac/DC"
"CGTCCATAGACTCTAC"	"Cyst.cTAL"
"CGTCCATCACTGTGTA"	"Cyst.IC-A_1"
"CGTCCATCAGTTGTTG"	"T-cell"
"CGTCCATGTCGCGTCA"	"PEC"
"CGTCCATGTTCTAACG"	"Cyst.IM-CD"
"CGTCCATTCGTTGCCT"	"VSMC"
"CGTGAATAGAATTCAG"	"Cyst.cTAL"
"CGTGAATAGGCTCTCG"	"Cyst.PC-CD"
"CGTGAATCAACGGCTC"	"Cyst.IM-CD"
"CGTGAATGTGAGGATC"	"Podocytes"
"CGTGAATTCATAAGGA"	"Cyst.IC-A_2"
"CGTGAATTCATCCTAT"	"Cyst.IC-A_1"
"CGTGAATTCGTGACTA"	"PEC"
"CGTGATACAACATCGT"	"Podocytes"
"CGTGATACACTTGTGA"	"Cyst.PC-CD"
"CGTGATACATTATGCG"	"Cyst.PT_1"
"CGTGATAGTAAGATTG"	"T-cell"
"CGTGATAGTATCCCAA"	"Cyst.PC-CD"
"CGTGATAGTCAATCTG"	"Mac/DC"
"CGTGATATCCTAGCTC"	"Cyst.IC-A_2"
"CGTGATATCGCTTTAT"	"Cyst.IM-CD"
"CGTGATATCTGGGATT"	"B-cell_1"
"CGTGCTTAGATGATTG"	"Cyst.IM-CD"
"CGTGCTTAGCCTGTGC"	"Cyst.CD"
"CGTGCTTCACCTGTCT"	"Cyst.IC-A_2"
"CGTGCTTTCACCCATC"	"Cyst.PC-CD"
"CGTGCTTTCCAATCCC"	"Cyst.PC-CD"
"CGTGTCTAGCAGTACG"	"Cyst.PC-CD"
"CGTGTCTAGCTGGAGT"	"Podocytes"
"CGTGTCTAGGATTTCC"	"Cyst.IC-A_1"
"CGTGTCTAGTATTCCG"	"Podocytes"
"CGTGTCTCAATCGCGC"	"Cyst.PC-CD"
"CGTGTCTCACGTTGGC"	"Cyst.IC-A_2"
"CGTGTCTGTACAAGCG"	"Cyst.IM-CD"
"CGTGTCTGTATGAGAT"	"Cyst.IC-A_1"
"CGTGTCTGTTAAGGAT"	"PEC"
"CGTGTCTTCCAGTACA"	"Cyst.PT_2"
"CGTTAGAAGATACCAA"	"Cyst.PC-CD"
"CGTTAGAAGCACTCGC"	"Cyst.PC-CD"
"CGTTAGAAGCTGACTT"	"Podocytes"
"CGTTAGAAGTGATTCC"	"EC"
"CGTTAGAAGTGTCATC"	"Cyst.PC-CD"
"CGTTAGACAAATGGAT"	"Cyst.cTAL"
"CGTTAGACACATCCCT"	"Cyst.PC-CD"
"CGTTAGAGTAGAATGT"	"Cyst.cTAL"
"CGTTAGAGTCCAAATC"	"B-cell_2"
"CGTTAGATCTGATGGT"	"PEC"
"CGTTCTGAGAGCCGTA"	"Cyst.IC-A_1"
"CGTTCTGAGGAATTAC"	"PEC"
"CGTTCTGCAGTTGGTT"	"Cyst.IM-CD"
"CGTTCTGCATACAGGG"	"Mast-cell"
"CGTTCTGCATGTCAGT"	"Cyst.PC-CD"
"CGTTCTGGTACCGGCT"	"B-cell_2"
"CGTTCTGGTATCCCAA"	"Cyst.IC-A_1"
"CGTTCTGGTGCAACAG"	"PEC"
"CGTTCTGGTTCTCACC"	"Cyst.IC-A_2"
"CGTTCTGTCCATCTCG"	"Cyst.PC-CD"
"CGTTGGGCACATTCTT"	"Cyst.IM-CD"
"CGTTGGGGTAAGATCA"	"Cyst.IM-CD"
"CGTTGGGGTCACTAGT"	"Cyst.PC-CD"
"CGTTGGGGTCAGTCTA"	"EC"
"CGTTGGGGTCGATGCC"	"Cyst.cTAL"
"CGTTGGGTCAACTGAC"	"VSMC"
"CGTTGGGTCCGCGGAT"	"Cyst.cTAL"
"CGTTGGGTCGAAATCC"	"PEC"
"CGTTGGGTCTATCGTT"	"Cyst.IC-A_2"
"CGTTGGGTCTGCCTGT"	"Cyst.PC-CD"
"CTAACCCAGTTGCCTA"	"Mac/DC"
"CTAACCCCACCCTATC"	"PEC"
"CTAACCCCATCCAACA"	"Cyst.IM-CD"
"CTAACCCGTAACGTTC"	"Podocytes"
"CTAACCCGTCACCGAC"	"Cyst.cTAL"
"CTAACCCTCCCAACTC"	"Cyst.IM-CD"
"CTAACTTAGCGTGCCT"	"Cyst.PT_2"
"CTAACTTAGGTAGACC"	"Cyst.IM-CD"
"CTAACTTAGGTAGATT"	"Cyst.cTAL"
"CTAACTTCAGTAGAAT"	"PEC"
"CTAACTTGTAACAGTA"	"PEC"
"CTAACTTGTAAGTTAG"	"Cyst.IM-CD"
"CTAACTTGTGGACCTC"	"Podocytes"
"CTAACTTGTTGATGTC"	"Cyst.PC-CD"
"CTAACTTTCATCGCTC"	"Cyst.PC-CD"
"CTAACTTTCCCTTCCC"	"Cyst.PT_1"
"CTAACTTTCGACCAAT"	"T-cell"
"CTAACTTTCTCAACGA"	"Cyst.PC-CD"
"CTAAGTGAGCTCGTGC"	"Cyst.IC-A_1"
"CTAAGTGAGGTCCAGA"	"Cyst.cTAL"
"CTAAGTGAGTCATGAA"	"Cyst.PC-CD"
"CTAAGTGCATCATCTT"	"Cyst.PC-CD"
"CTAAGTGCATGACAAA"	"Cyst.PC-CD"
"CTAAGTGGTCCGGTGT"	"Cyst.PT_1"
"CTAAGTGTCGCGGACT"	"Cyst.PC-CD"
"CTACAGAAGCCAGTAG"	"Podocytes"
"CTACAGAAGGCTGGAT"	"Cyst.cTAL"
"CTACAGAAGGGAACAA"	"Cyst.PC-CD"
"CTACAGAAGGTGCAGT"	"T-cell"
"CTACAGAAGTATGAGT"	"Cyst.IM-CD"
"CTACAGACAAGCAATA"	"Cyst.PC-CD"
"CTACAGACAGGTCCCA"	"Cyst.CD"
"CTACAGAGTCTCTCAC"	"Cyst.PC-CD"
"CTACATTCAAATGAGT"	"VSMC"
"CTACATTCACCTTCCA"	"Cyst.IM-CD"
"CTACATTGTAGACGTG"	"T-cell"
"CTACATTTCGCCAACG"	"Cyst.IM-CD"
"CTACATTTCTGGCCGA"	"Podocytes"
"CTACCCAGTCAGTCTA"	"Cyst.PC-CD"
"CTACCCAGTCTTGAAC"	"Cyst.PC-CD"
"CTACCCAGTTTGTTCT"	"Cyst.PC-CD"
"CTACCCATCACTGTCC"	"Cyst.cTAL"
"CTACCCATCATGGCCG"	"Cyst.cTAL"
"CTACCCATCGCGCTGA"	"EC"
"CTACCTGCAAGTGGTG"	"Cyst.PC-CD"
"CTACCTGCAGCTATTG"	"Cyst.IC-A_1"
"CTACCTGGTAGGACCA"	"Cyst.PC-CD"
"CTACCTGGTTACAGCT"	"T-cell"
"CTACCTGTCACCCTTG"	"EC"
"CTACCTGTCTAAGGAA"	"Cyst.IC-A_1"
"CTACGGGAGACCATTC"	"EC"
"CTACGGGAGTAATACG"	"Cyst.PC-CD"
"CTACGGGAGTTGCTGT"	"Podocytes"
"CTACGGGGTACGCGTC"	"Cyst.IC-A_2"
"CTACGGGGTGACCGTC"	"Cyst.PC-CD"
"CTACGGGTCAGTGGGA"	"Cyst.IM-CD"
"CTACGGGTCCCTCTAG"	"Cyst.PC-CD"
"CTACTATCAACGGCCT"	"Cyst.IC-A_1"
"CTACTATTCATTGTTC"	"Cyst.IM-CD"
"CTACTATTCCTCTAAT"	"Cyst.PT_2"
"CTAGACAAGCACTCAT"	"Mast-cell"
"CTAGACAAGCTAATGA"	"B-cell_2"
"CTAGACAAGTTGTAAG"	"Cyst.IM-CD"
"CTAGACACACGTTGGC"	"Cyst.PC-CD"
"CTAGACAGTAGGTAGC"	"T-cell"
"CTAGACAGTTATGTCG"	"Cyst.IC-A_2"
"CTAGACATCCACACAA"	"T-cell"
"CTAGACATCCTACCGT"	"Cyst.IC-A_2"
"CTAGACATCGCGGTAC"	"Cyst.cTAL"
"CTAGGTACATAACAGA"	"T-cell"
"CTAGGTAGTAAGCAAT"	"Cyst.IM-CD"
"CTAGGTAGTGCCTACG"	"Cyst.IC-A_1"
"CTAGGTAGTGTACAGG"	"Cyst.CD"
"CTAGGTAGTGTTCGAT"	"PEC"
"CTAGGTAGTTGTTTGG"	"VSMC"
"CTAGGTATCAACTACG"	"Cyst.PC-CD"
"CTAGGTATCAGCTGTA"	"B-cell_1"
"CTAGGTATCTAAGGAA"	"Cyst.CD"
"CTAGGTATCTGAGAGG"	"Cyst.PC-CD"
"CTATAGGCAAGCTGTT"	"Cyst.PC-CD"
"CTATAGGCATGACAGG"	"Cyst.IC-A_2"
"CTATAGGGTAGCTGCC"	"PEC"
"CTATAGGGTTCCGCAG"	"Cyst.CD"
"CTATAGGTCACAGAGG"	"Cyst.PC-CD"
"CTATCCGCAAACACGG"	"Cyst.cTAL"
"CTATCCGCACAGCCTG"	"Cyst.PC-CD"
"CTATCCGGTCGAGCTC"	"Podocytes"
"CTATCCGGTTGCTTGA"	"Podocytes"
"CTATCCGTCCTACCGT"	"EC"
"CTATCCGTCGGCATCG"	"PEC"
"CTATCTACACTGAGTT"	"Cyst.PC-CD"
"CTATCTACATGCGGTC"	"Cyst.PC-CD"
"CTATCTATCCATACTT"	"T-cell"
"CTCAACCAGCACCCAC"	"PEC"
"CTCAACCAGGTACCTT"	"Cyst.IM-CD"
"CTCAACCCACACACTA"	"Cyst.PC-CD"
"CTCAACCGTACAGCGA"	"Cyst.IM-CD"
"CTCAACCGTGGGTATG"	"VSMC"
"CTCAACCTCTGAATGC"	"Cyst.PC-CD"
"CTCAAGACAAATAGCA"	"PEC"
"CTCAAGATCTCTATAC"	"VSMC"
"CTCAATTCACAAACGG"	"PEC"
"CTCAATTCAGGAGGTT"	"Cyst.PC-CD"
"CTCAATTCATTCGATG"	"Cyst.PC-CD"
"CTCAATTGTGCCGGTT"	"Mast-cell"
"CTCACTGAGATAGCAT"	"EC"
"CTCACTGAGTAAACTG"	"Cyst.PC-CD"
"CTCACTGCATGCAGCC"	"PEC"
"CTCACTGCATGTACGT"	"Cyst.PC-CD"
"CTCACTGGTGGACTAG"	"Podocytes"
"CTCAGAAAGATGTTAG"	"PEC"
"CTCAGAAAGCACCGTC"	"Cyst.PC-CD"
"CTCAGAAAGGGACAGG"	"Cyst.PC-CD"
"CTCAGAAAGTAAACGT"	"Cyst.PC-CD"
"CTCAGAAAGTGTTCAC"	"VSMC"
"CTCAGAACAGTTAGGG"	"T-cell"
"CTCAGAAGTCAGGAGT"	"Cyst.PC-CD"
"CTCAGAAGTGACATCT"	"VSMC"
"CTCAGAAGTGAGACCA"	"VSMC"
"CTCAGAATCCGCTAGG"	"Cyst.IM-CD"
"CTCAGAATCCGGCAAC"	"Cyst.PC-CD"
"CTCAGAATCGGTTAGT"	"Cyst.IM-CD"
"CTCAGAATCGTGGCTG"	"Cyst.PC-CD"
"CTCAGGGAGAAGTATC"	"Cyst.IM-CD"
"CTCAGGGCACTTCCTG"	"Cyst.PC-CD"
"CTCAGGGCATGTAACC"	"Podocytes"
"CTCAGGGGTGCTATTG"	"Cyst.cTAL"
"CTCAGGGGTGGCACTC"	"Cyst.IC-A_1"
"CTCAGGGTCTAGTACG"	"Cyst.IC-A_2"
"CTCAGTCAGTAGACCG"	"Cyst.PT_1"
"CTCAGTCCAATTCTTC"	"Cyst.PC-CD"
"CTCAGTCCAGGGACTA"	"T-cell"
"CTCAGTCCATGCACTA"	"PEC"
"CTCAGTCGTACGTACT"	"PEC"
"CTCAGTCGTCGCTTAA"	"Cyst.PC-CD"
"CTCAGTCGTTAGGCTT"	"Cyst.IM-CD"
"CTCAGTCGTTCACGAT"	"T-cell"
"CTCAGTCGTTTCCATT"	"Cyst.IM-CD"
"CTCATCGAGAAGTCTA"	"Podocytes"
"CTCATCGGTCCAGCGT"	"Cyst.PC-CD"
"CTCATCGGTCGCAACC"	"Cyst.PC-CD"
"CTCATCGGTCTACAGT"	"Cyst.IC-A_2"
"CTCATCGGTGGCTTAT"	"Cyst.IC-A_1"
"CTCATCGTCCAGCACG"	"Cyst.PC-CD"
"CTCATCGTCTAACGGT"	"Podocytes"
"CTCATCGTCTCCCTAG"	"Cyst.IC-A_2"
"CTCATGCAGTCTAGCT"	"Cyst.PC-CD"
"CTCATGCCATGGCCCA"	"Cyst.IM-CD"
"CTCATGCGTGGGCTTC"	"Cyst.cTAL"
"CTCATGCTCAAGAGTA"	"Cyst.PC-CD"
"CTCATGCTCCCAATAG"	"PEC"
"CTCATGCTCGGTCTAA"	"Cyst.PC-CD"
"CTCATGCTCTACCACC"	"PEC"
"CTCATTAAGTGGAATT"	"Cyst.IC-A_1"
"CTCATTAAGTGGCCTC"	"Cyst.PC-CD"
"CTCATTACACAACCGC"	"Cyst.PT_2"
"CTCATTACAGGACTAG"	"Podocytes"
"CTCATTATCCCAGTGG"	"T-cell"
"CTCATTATCTGTAACG"	"Cyst.IC-A_2"
"CTCCAACAGCACTGGA"	"Cyst.IC-A_2"
"CTCCAACAGTCAACAA"	"Cyst.PC-CD"
"CTCCAACCAAAGCTCT"	"Cyst.IC-A_1"
"CTCCACAAGCCGCTTG"	"Cyst.IM-CD"
"CTCCACAAGGTTGGTG"	"Cyst.cTAL"
"CTCCACACACCAGTTA"	"Cyst.PC-CD"
"CTCCACACAGCTGTCG"	"Mast-cell"
"CTCCACAGTAGCTTGT"	"PEC"
"CTCCACATCAGTCTTT"	"Cyst.PC-CD"
"CTCCACATCCACGTAA"	"Cyst.PC-CD"
"CTCCATGAGCCTTTGA"	"Cyst.cTAL"
"CTCCATGCACCTTCGT"	"PEC"
"CTCCATGCAGAATGTA"	"Cyst.cTAL"
"CTCCATGGTCGTACAT"	"Cyst.PC-CD"
"CTCCATGGTGGGATTG"	"Cyst.PC-CD"
"CTCCATGTCCGTTTCG"	"PEC"
"CTCCATGTCGCCCAGA"	"Mast-cell"
"CTCCCAAAGTTTCGAC"	"Cyst.PC-CD"
"CTCCCAACAATAACGA"	"Cyst.PC-CD"
"CTCCCAAGTAGGCAGT"	"Cyst.cTAL"
"CTCCCAAGTCGACTTA"	"EC"
"CTCCCAAGTGTATACC"	"PEC"
"CTCCCAATCATCGCCT"	"EC"
"CTCCCAATCCAAGGGA"	"Cyst.PT_2"
"CTCCCAATCCAGTGCG"	"Cyst.PC-CD"
"CTCCCAATCCATCACC"	"B-cell_1"
"CTCCCAATCCCGAGAC"	"PEC"
"CTCCCAATCCGGACGT"	"Cyst.IM-CD"
"CTCCCAATCGCTAGCG"	"Mac/DC"
"CTCCCTCCAAGAATAC"	"Cyst.IM-CD"
"CTCCCTCCAGCAGGAT"	"PEC"
"CTCCCTCCATACGCAT"	"Cyst.PC-CD"
"CTCCCTCGTGAGTTGG"	"Cyst.IC-A_1"
"CTCCCTCTCGAACTCA"	"Cyst.IM-CD"
"CTCCCTCTCGCGGTAC"	"Cyst.IC-A_2"
"CTCCCTCTCGTCACCT"	"Cyst.IC-A_1"
"CTCCCTCTCTCAGTCC"	"Cyst.PT_1"
"CTCCGATCAAGCACCC"	"Cyst.IC-A_1"
"CTCCGATCATAGATGA"	"Cyst.PC-CD"
"CTCCGATTCTATGCCC"	"Cyst.IM-CD"
"CTCCGATTCTCGCCTA"	"Cyst.cTAL"
"CTCCGATTCTTGTTAC"	"Cyst.IC-A_1"
"CTCCTCCAGCTAGAAT"	"Cyst.cTAL"
"CTCCTCCAGCTGGTGA"	"Cyst.PC-CD"
"CTCCTCCAGGGCAGAG"	"Cyst.CD"
"CTCCTCCCACAATGCT"	"T-cell"
"CTCCTCCCACTAACGT"	"VSMC"
"CTCCTCCCAGTCAACT"	"Cyst.cTAL"
"CTCCTCCGTCTCCCTA"	"Cyst.PC-CD"
"CTCCTCCTCACGAGGA"	"PEC"
"CTCCTCCTCCGTCACT"	"T-cell"
"CTCCTCCTCGACCATA"	"Cyst.cTAL"
"CTCCTCCTCGGTCATA"	"Cyst.IM-CD"
"CTCCTTTAGCGTATGG"	"Mast-cell"
"CTCCTTTAGGTGCATG"	"Cyst.cTAL"
"CTCCTTTAGTGACACG"	"PEC"
"CTCCTTTCAGAGATTA"	"Cyst.PC-CD"
"CTCCTTTGTCGAATTC"	"Cyst.cTAL"
"CTCCTTTGTGGATACG"	"Cyst.IC-A_2"
"CTCCTTTGTGTACGCC"	"Cyst.PC-CD"
"CTCCTTTTCATCACTT"	"VSMC"
"CTCGAGGCAGGAGGAG"	"PEC"
"CTCGAGGGTACCTATG"	"VSMC"
"CTCGAGGGTGAGGATC"	"Cyst.IM-CD"
"CTCGAGGGTTATGACC"	"Cyst.PC-CD"
"CTCGAGGTCATTACCT"	"Cyst.IC-A_2"
"CTCTCAGAGCCAACCC"	"Cyst.IM-CD"
"CTCTCAGAGTCGCCCA"	"Cyst.IC-A_1"
"CTCTCAGAGTGTACCT"	"Cyst.PC-CD"
"CTCTCAGCACGACGAA"	"Cyst.IM-CD"
"CTCTCAGCACGGAAGT"	"Cyst.IM-CD"
"CTCTCAGCAGTGCGCT"	"Cyst.IC-A_2"
"CTCTCAGCAGTTCCAA"	"Cyst.IC-A_2"
"CTCTCAGCATACCAGT"	"Podocytes"
"CTCTCAGGTCCTGGTG"	"Cyst.cTAL"
"CTCTCAGGTGTATCCA"	"Cyst.IM-CD"
"CTCTCAGGTTCTCAGA"	"Cyst.PT_1"
"CTCTCAGTCAACTCTT"	"Cyst.CD"
"CTCTCAGTCATTGCGA"	"Cyst.PC-CD"
"CTCTCGACATAGGCGA"	"Cyst.PC-CD"
"CTCTCGAGTCCGGCAT"	"Podocytes"
"CTCTCGAGTTAAGACA"	"PEC"
"CTCTCGATCACCTCAC"	"Cyst.PC-CD"
"CTCTCGATCAGCCTTC"	"Cyst.IC-A_1"
"CTCTCGATCATTGCGA"	"Cyst.PC-CD"
"CTCTCGATCCGTTGAA"	"Cyst.IC-A_2"
"CTCTCGATCTGTAAGC"	"Cyst.PC-CD"
"CTCTGGTGTCGAGCTC"	"Mast-cell"
"CTGAATGAGCACCGAA"	"Cyst.IM-CD"
"CTGAATGGTTGATGTC"	"Cyst.IC-A_2"
"CTGAGCGAGCGGTATG"	"EC"
"CTGAGGCAGGTCCCTG"	"Cyst.PT_1"
"CTGAGGCCAACACGTT"	"Cyst.IC-A_2"
"CTGAGGCCAGCACACC"	"Cyst.PC-CD"
"CTGAGGCGTATGAAGT"	"Cyst.PC-CD"
"CTGAGGCTCTGCCCTA"	"Cyst.PC-CD"
"CTGATCCAGACCGTTT"	"Cyst.IM-CD"
"CTGATCCAGATGTTGA"	"Cyst.IM-CD"
"CTGATCCAGGGTTAAT"	"Podocytes"
"CTGATCCCATCTGCGG"	"B-cell_1"
"CTGATCCGTGCATCTA"	"EC"
"CTGATCCTCCAACCAA"	"Cyst.IC-A_1"
"CTGATCCTCCACGGGT"	"Cyst.PT_1"
"CTGCAGGAGTAGGGTC"	"PEC"
"CTGCAGGAGTCGGCCT"	"Cyst.IM-CD"
"CTGCAGGCAGAAGCGT"	"Cyst.PC-CD"
"CTGCAGGGTCGTCATA"	"Podocytes"
"CTGCAGGTCAAGAGGC"	"Cyst.PC-CD"
"CTGCAGGTCGCCTAGG"	"Cyst.CD"
"CTGCAGGTCTAGAACC"	"Cyst.IC-A_2"
"CTGCATCAGAGTGTTA"	"Cyst.PC-CD"
"CTGCATCCAAGAGTTA"	"PEC"
"CTGCATCGTTTCGATG"	"Cyst.PC-CD"
"CTGCCATAGAATGTTG"	"Cyst.PC-CD"
"CTGCCATAGAGAGCGG"	"B-cell_1"
"CTGCCATAGGAACGAA"	"Cyst.IM-CD"
"CTGCCATAGGAGCAAA"	"Cyst.PT_2"
"CTGCCATCATACATCG"	"Cyst.IM-CD"
"CTGCCATGTGTTTACG"	"Cyst.PC-CD"
"CTGCCATTCCTTATCA"	"PEC"
"CTGCCATTCGGTGTTA"	"Podocytes"
"CTGCCATTCTATACTC"	"Mac/DC"
"CTGCCATTCTGTACAG"	"PEC"
"CTGCGAGAGTGCCAGA"	"T-cell"
"CTGCGAGCAGTGTATC"	"Podocytes"
"CTGCGAGGTGTGTCCG"	"Cyst.PC-CD"
"CTGCGAGGTGTTATCG"	"Podocytes"
"CTGCGAGTCTTGGAAC"	"Cyst.IM-CD"
"CTGCTCAGTAACATAG"	"Cyst.PC-CD"
"CTGCTCAGTATAGGGC"	"PEC"
"CTGCTCATCACCCTTG"	"PEC"
"CTGCTCATCTCCTGAC"	"PEC"
"CTGCTCATCTGGCTGG"	"Podocytes"
"CTGGACGAGAGTCTTC"	"Cyst.PC-CD"
"CTGGACGAGATGTTGA"	"Podocytes"
"CTGGACGAGGTGCAGT"	"PEC"
"CTGGACGAGTCCTGTA"	"PEC"
"CTGGACGCAAGTGGGT"	"Cyst.PC-CD"
"CTGGACGCAGAAATTG"	"Podocytes"
"CTGGACGCATCTAGAC"	"Cyst.cTAL"
"CTGGACGGTAAGCGGT"	"Cyst.PC-CD"
"CTGGACGGTATGGTAA"	"Cyst.cTAL"
"CTGGACGGTTCCGCTT"	"Cyst.IC-A_1"
"CTGGACGTCAGTCACA"	"PEC"
"CTGGACGTCTACTCAT"	"Cyst.PC-CD"
"CTGGCAGCACAATGTC"	"Cyst.IC-A_2"
"CTGGCAGCACCCAAGC"	"Cyst.IM-CD"
"CTGGCAGCAGAGAAAG"	"EC"
"CTGGCAGTCACAATGC"	"Cyst.IC-A_2"
"CTGGTCTAGGAAAGGT"	"Cyst.IC-A_1"
"CTGGTCTAGTACAGAT"	"PEC"
"CTGGTCTCATATGCGT"	"Cyst.PC-CD"
"CTGGTCTGTAAGTTGA"	"Cyst.PC-CD"
"CTGGTCTGTGCAACAG"	"B-cell_2"
"CTGGTCTGTTCCACGG"	"Cyst.IM-CD"
"CTGGTCTTCAAATGCC"	"Cyst.PC-CD"
"CTGTACCAGAACTGAT"	"Cyst.PC-CD"
"CTGTACCAGCATGAAT"	"Podocytes"
"CTGTACCAGGTGCGAT"	"Cyst.PC-CD"
"CTGTACCAGTATGAGT"	"Mac/DC"
"CTGTACCCACACTTAG"	"Cyst.PC-CD"
"CTGTACCGTCCACGCA"	"Cyst.cTAL"
"CTGTACCGTTATAGCC"	"Cyst.PC-CD"
"CTGTACCTCCGAGTGC"	"Cyst.PT_1"
"CTGTACCTCTTGCGCT"	"Cyst.cTAL"
"CTGTAGAAGTCAGCGA"	"PEC"
"CTGTAGACAAGTTGGG"	"Cyst.IM-CD"
"CTGTAGACACCAAATC"	"Cyst.CD"
"CTGTAGACATGCCGCA"	"Cyst.IC-A_2"
"CTGTAGATCTAGTTCT"	"Cyst.IC-A_2"
"CTGTATTAGGGCGAAG"	"VSMC"
"CTGTATTCACGCTGTG"	"Cyst.IC-A_1"
"CTGTATTGTAGAATGT"	"PEC"
"CTGTATTTCCTTCGAC"	"Cyst.PC-CD"
"CTGTCGTAGGCATCTT"	"Cyst.IC-A_1"
"CTGTCGTAGGCTATCT"	"Cyst.IC-A_1"
"CTGTCGTAGTCACAGG"	"Podocytes"
"CTGTCGTCATTGCTTT"	"Cyst.cTAL"
"CTGTCGTTCGGATAAA"	"Cyst.IC-A_2"
"CTGTCGTTCGTCGATA"	"Podocytes"
"CTGTGAAAGAGACAAG"	"T-cell"
"CTGTGAAAGTAGTCTC"	"Mac/DC"
"CTGTGAAGTAACATGA"	"Cyst.IC-A_2"
"CTGTGAATCTAAGAAG"	"PEC"
"CTGTGAATCTGATGGT"	"PEC"
"CTGTGAATCTTCTGGC"	"Cyst.CD"
"CTGTGGGGTACAACGG"	"Mast-cell"
"CTGTGGGGTTCTCAGA"	"PEC"
"CTGTGGGTCCGCTTAC"	"Cyst.IM-CD"
"CTGTGGGTCTTACACT"	"VSMC"
"CTTACCGAGACTCGAG"	"Podocytes"
"CTTACCGAGATGCAGC"	"Cyst.IC-A_2"
"CTTACCGAGCTAGAGC"	"Cyst.CD"
"CTTACCGCATAGGAGC"	"PEC"
"CTTACCGCATCAGCGC"	"VSMC"
"CTTACCGTCAAAGGTA"	"Cyst.cTAL"
"CTTAGGAGTCAAGCCC"	"Mac/DC"
"CTTAGGAGTCAGGTGA"	"Cyst.CD"
"CTTAGGAGTCGGCACT"	"B-cell_2"
"CTTCAATAGATGCTTC"	"Cyst.IC-A_1"
"CTTCAATAGCGTCAGA"	"VSMC"
"CTTCAATAGTACCATC"	"Cyst.cTAL"
"CTTCAATGTATGCTTG"	"Cyst.PT_2"
"CTTCAATGTGCTGATT"	"Cyst.PC-CD"
"CTTCAATTCATAGGCT"	"Cyst.PC-CD"
"CTTCAATTCGGCCAAC"	"Cyst.IM-CD"
"CTTCAATTCTTCTGGC"	"Cyst.IM-CD"
"CTTCCGAAGAAACTCA"	"Cyst.PC-CD"
"CTTCCGAAGCGCGTTC"	"Cyst.IM-CD"
"CTTCCGACACCGTGCA"	"Cyst.PC-CD"
"CTTCCGATCAACTTTC"	"Cyst.PC-CD"
"CTTCCGATCTCATTAC"	"Cyst.IC-A_1"
"CTTCCTTAGATGCTGG"	"EC"
"CTTCCTTCAAATCAAG"	"Cyst.PC-CD"
"CTTCCTTCACCAAATC"	"Cyst.PC-CD"
"CTTCCTTCATAATCCG"	"Cyst.IM-CD"
"CTTCCTTCATCCGGCA"	"Cyst.CD"
"CTTCCTTCATCTAACG"	"Mast-cell"
"CTTCCTTTCGACACCG"	"Podocytes"
"CTTCCTTTCTTTCCGG"	"Cyst.IC-A_2"
"CTTCGGTAGTTCGGTT"	"T-cell"
"CTTCGGTCACAGCGCT"	"Cyst.IM-CD"
"CTTCGGTCATGTGTCA"	"Cyst.IM-CD"
"CTTCGGTGTAAGTTAG"	"PEC"
"CTTCGGTGTTGGGCCT"	"Podocytes"
"CTTCGGTGTTTACTTC"	"Podocytes"
"CTTCGGTTCCATCCGT"	"Mac/DC"
"CTTCGGTTCGTTCATT"	"Mast-cell"
"CTTCGGTTCTTAGTTC"	"Podocytes"
"CTTCGGTTCTTCCGTG"	"B-cell_2"
"CTTCTAAAGTGGCAGT"	"Cyst.IC-A_2"
"CTTCTAAAGTTCTACG"	"EC"
"CTTCTAAAGTTGCCTA"	"Cyst.PC-CD"
"CTTCTAACAAACGTGG"	"Mast-cell"
"CTTCTAACAACCGGAA"	"EC"
"CTTCTAACAGATCCTA"	"Cyst.CD"
"CTTCTAACAGCGTACC"	"Cyst.PC-CD"
"CTTCTAACATATGCGT"	"Cyst.IC-A_2"
"CTTCTCTAGTTGTAGA"	"Cyst.IM-CD"
"CTTCTCTCAAATAGCA"	"Cyst.IC-A_2"
"CTTCTCTCAAGTTCGT"	"Cyst.PC-CD"
"CTTCTCTCAGCAGTCC"	"Cyst.IC-A_1"
"CTTCTCTCAGTAACCT"	"B-cell_2"
"CTTCTCTGTAATTGGA"	"Cyst.IM-CD"
"CTTCTCTGTTGTAAAG"	"Cyst.PC-CD"
"CTTCTCTTCGCGCTGA"	"Cyst.PC-CD"
"CTTCTCTTCGCTGATA"	"Cyst.PC-CD"
"CTTCTCTTCTGCTTAT"	"PEC"
"CTTGAGAAGCCATATC"	"Cyst.PC-CD"
"CTTGAGAAGCCTGTGC"	"Cyst.PC-CD"
"CTTGAGAGTCGCATTA"	"Cyst.IC-A_1"
"CTTGAGATCATACGGT"	"Podocytes"
"CTTGAGATCGTGACTA"	"Cyst.PC-CD"
"CTTGAGATCTTCGATT"	"Cyst.IM-CD"
"CTTGATTAGGATAATC"	"Cyst.PC-CD"
"CTTGATTCATTCTTCA"	"Podocytes"
"CTTGATTGTACGAAAT"	"T-cell"
"CTTGATTGTCCAGAAG"	"Cyst.PC-CD"
"CTTGATTGTTGCGAAG"	"PEC"
"CTTGATTTCCCAGCGA"	"VSMC"
"CTTGATTTCCGATCGG"	"Cyst.IM-CD"
"CTTTCAACAATCGTCA"	"Cyst.cTAL"
"CTTTCAACAGGTGTGA"	"PEC"
"CTTTCAAGTTACCCTC"	"Cyst.IC-A_1"
"CTTTCAATCTGGCCGA"	"Cyst.PC-CD"
"CTTTCGGAGAATCGTA"	"PEC"
"CTTTCGGAGGAGACCT"	"Cyst.PC-CD"
"CTTTCGGAGGCGCTCT"	"EC"
"CTTTCGGAGGGATCTG"	"Cyst.PC-CD"
"CTTTCGGCAGACAAAT"	"Cyst.IC-A_1"
"CTTTCGGCATGGTGGA"	"Cyst.PC-CD"
"CTTTCGGGTGCCCGTA"	"Cyst.IC-A_1"
"CTTTCGGTCCCATTCG"	"Cyst.PC-CD"
"CTTTCGGTCCGAAATC"	"Mast-cell"
"CTTTCGGTCGCTTGCT"	"Cyst.PC-CD"
"CTTTCGGTCTCGTCGT"	"Cyst.PC-CD"
"CTTTCGGTCTGTTGGA"	"Cyst.IM-CD"
"CTTTCGGTCTTAGCCC"	"Cyst.PC-CD"
"GAAACCTAGATTGTGA"	"Mast-cell"
"GAAACCTCAACCCGCA"	"Cyst.IC-A_1"
"GAAACCTCATCGTGGC"	"Podocytes"
"GAAACCTGTTACGTAC"	"Cyst.IM-CD"
"GAAACCTTCGTCGACG"	"Cyst.IM-CD"
"GAAACCTTCTCACTCG"	"Cyst.IM-CD"
"GAAATGAAGGGATCTG"	"Cyst.IM-CD"
"GAAATGAAGTCATTGC"	"Cyst.PC-CD"
"GAAATGACAATTCGTG"	"Cyst.IC-A_1"
"GAAATGACACAGCTGC"	"Cyst.IC-A_1"
"GAAATGACACTATCGA"	"Cyst.IM-CD"
"GAAATGAGTCCAGTTA"	"Cyst.IM-CD"
"GAAATGAGTCTAACTG"	"VSMC"
"GAAATGAGTGCTTCAA"	"Mast-cell"
"GAAATGAGTTATCCAG"	"Cyst.IC-A_1"
"GAAATGAGTTGGCTAT"	"Mac/DC"
"GAAATGATCTACCACC"	"Cyst.IC-A_1"
"GAAATGATCTGGGAGA"	"VSMC"
"GAAATGATCTTGAGCA"	"EC"
"GAACACTAGTTGAAGT"	"PEC"
"GAACACTCAAATAGCA"	"Mac/DC"
"GAACACTGTAACACGG"	"Cyst.IM-CD"
"GAACACTGTACGTTCA"	"Cyst.PC-CD"
"GAACACTGTGGTCTTA"	"PEC"
"GAACACTGTTAGTCGT"	"Cyst.IC-A_1"
"GAACACTTCCAGTGCG"	"Cyst.PC-CD"
"GAACACTTCGACCTAA"	"Cyst.PT_1"
"GAACACTTCGGTATGT"	"Cyst.PT_2"
"GAACACTTCTCCGAAA"	"Cyst.PC-CD"
"GAACGTTAGAGAGCAA"	"Cyst.IM-CD"
"GAACGTTAGAGATCGC"	"Cyst.IM-CD"
"GAACGTTAGCACGGAT"	"Cyst.PC-CD"
"GAACGTTCAACGTTAC"	"Cyst.PC-CD"
"GAACGTTCACGCGCAT"	"Cyst.PC-CD"
"GAACGTTCACGCGCTA"	"Cyst.IC-A_1"
"GAACGTTGTCGACTGC"	"PEC"
"GAACGTTGTGCATTTG"	"Cyst.PC-CD"
"GAACGTTGTGTACATC"	"Cyst.IM-CD"
"GAACGTTTCCACGGGT"	"Cyst.PC-CD"
"GAACTGTAGCATGGGT"	"Cyst.PC-CD"
"GAACTGTAGCGTCGAA"	"Cyst.IM-CD"
"GAACTGTCAGGCGTTC"	"Cyst.PC-CD"
"GAACTGTTCATCGTAG"	"Cyst.cTAL"
"GAACTGTTCCCATAGA"	"Cyst.PC-CD"
"GAACTGTTCTCAACCC"	"Podocytes"
"GAACTGTTCTCCATAT"	"Cyst.IM-CD"
"GAAGAATCAACAAGAT"	"Cyst.IM-CD"
"GAAGAATCAATCCTTT"	"B-cell_1"
"GAAGAATGTTTACCTT"	"Cyst.IM-CD"
"GAAGAATTCAAGAAAC"	"Cyst.PC-CD"
"GAAGAATTCAAGTTGC"	"Cyst.IC-A_1"
"GAAGCCCAGAAACACT"	"Cyst.cTAL"
"GAAGCCCAGGTCGACA"	"Podocytes"
"GAAGCCCAGTGATGGC"	"PEC"
"GAAGCCCCATTGCTGA"	"T-cell"
"GAAGCCCGTAGCTCGC"	"Mast-cell"
"GAAGCCCTCATGCGGC"	"T-cell"
"GAAGCCCTCTCCTGCA"	"Mac/DC"
"GAAGCGAGTATAGGAT"	"Cyst.PT_2"
"GAAGCGATCCGTGACG"	"Cyst.IM-CD"
"GAAGGACAGGTACAAT"	"Podocytes"
"GAAGGACCAATACAGA"	"VSMC"
"GAAGGACCATTGTAGC"	"Podocytes"
"GAAGGACTCAGTGTCA"	"Cyst.PC-CD"
"GAAGGACTCGATAACC"	"Cyst.IM-CD"
"GAAGGACTCTCCAAGA"	"Cyst.PC-CD"
"GAAGGGTCAAATCAGA"	"B-cell_2"
"GAAGGGTCAAGTCCCG"	"Cyst.PC-CD"
"GAAGGGTGTAGGTACG"	"Cyst.PC-CD"
"GAAGGGTGTGCTCCGA"	"Cyst.PT_1"
"GAAGGGTTCTTCGATT"	"PEC"
"GAAGTAAAGACATACA"	"Cyst.cTAL"
"GAAGTAACAATCCTTT"	"Podocytes"
"GAAGTAACATAACGGG"	"Cyst.cTAL"
"GAAGTAACATCGTCCT"	"Cyst.IC-A_1"
"GAAGTAAGTAACAGTA"	"PEC"
"GAAGTAAGTAATACCC"	"PEC"
"GAAGTAAGTGAATAAC"	"Cyst.PC-CD"
"GAAGTAAGTGAGTTTC"	"Cyst.PC-CD"
"GAAGTAATCATTGAGC"	"Cyst.PC-CD"
"GAAGTAATCGCCGAGT"	"T-cell"
"GAAGTAATCGTGCATA"	"Cyst.IC-A_2"
"GAAGTAATCGTTCTGC"	"Cyst.IC-A_2"
"GAATAGAAGCTGGAGT"	"Cyst.IM-CD"
"GAATAGACATTGCCGG"	"Mac/DC"
"GAATAGAGTACCGGAA"	"Cyst.cTAL"
"GAATAGAGTCGACGCT"	"Cyst.PC-CD"
"GAATAGAGTCGTCTCT"	"Cyst.IC-A_1"
"GAATAGAGTGTCCTAA"	"Cyst.IM-CD"
"GAATAGATCGGTAGAG"	"Mac/DC"
"GAATAGATCTAGGCCG"	"B-cell_1"
"GAATAGATCTGCTTAT"	"Cyst.IM-CD"
"GAATCACAGAAACCAT"	"Cyst.cTAL"
"GAATCACAGTACCGGA"	"VSMC"
"GAATCACCAAGAGATT"	"EC"
"GAATCACGTCCGGATC"	"PEC"
"GAATCACGTGGATCAG"	"Cyst.PT_2"
"GAATCACTCCCAAGTA"	"Cyst.CD"
"GAATCACTCGACATTG"	"Podocytes"
"GAATCGTCAAGTGGGT"	"T-cell"
"GAATCGTCATCTCAAG"	"Cyst.IM-CD"
"GAATCGTGTCGATTAC"	"T-cell"
"GAATCGTGTCGCTTAA"	"Cyst.PT_1"
"GAATCGTTCACCCTGT"	"T-cell"
"GAATCGTTCAGACAAA"	"Cyst.PC-CD"
"GAATCGTTCGTGGGAA"	"Cyst.PC-CD"
"GAATCGTTCTGTAACG"	"Cyst.PC-CD"
"GAATCGTTCTTGGGCG"	"Cyst.IM-CD"
"GACACGCAGGGCAGTT"	"Cyst.cTAL"
"GACACGCAGTCGGGAT"	"Cyst.cTAL"
"GACACGCAGTCTAACC"	"Cyst.IC-A_1"
"GACACGCCAACTGCTA"	"EC"
"GACACGCGTCAAAGTA"	"PEC"
"GACACGCGTCATACCA"	"EC"
"GACACGCGTTGCAACT"	"Cyst.IC-A_1"
"GACACGCTCATCTCTA"	"Cyst.PC-CD"
"GACACGCTCCGAGAAG"	"Cyst.IM-CD"
"GACACGCTCGCAGATT"	"Cyst.PC-CD"
"GACAGCCAGACCCGCT"	"EC"
"GACAGCCCAAGTGGGT"	"Cyst.IC-A_2"
"GACAGCCCATGAAAGT"	"Cyst.IM-CD"
"GACAGCCTCTGTACAG"	"Cyst.IC-A_2"
"GACATCAAGAGTCTTC"	"Cyst.PC-CD"
"GACATCAAGGAAGAAC"	"Cyst.PC-CD"
"GACATCAAGGTCGCCT"	"Cyst.IM-CD"
"GACATCAAGTGGTTGG"	"Cyst.CD"
"GACATCAGTTCGGGTC"	"PEC"
"GACATCATCAACTCTT"	"Cyst.cTAL"
"GACATCATCACTGAAC"	"Cyst.IC-A_2"
"GACATCATCGAACGGA"	"Cyst.IM-CD"
"GACATCATCGGCTGAC"	"Cyst.PC-CD"
"GACCAATAGGTGGTTG"	"Cyst.cTAL"
"GACCAATAGTCACAGG"	"VSMC"
"GACCAATGTATCCCTC"	"Cyst.PC-CD"
"GACCAATGTCCCGCAA"	"Cyst.CD"
"GACCAATTCCAAGCTA"	"Cyst.PC-CD"
"GACCAATTCGAAGCCC"	"Cyst.PC-CD"
"GACCAATTCTGTTGGA"	"Mast-cell"
"GACCCAGAGAACAGGA"	"Cyst.PC-CD"
"GACCCAGAGCGTTACT"	"EC"
"GACCCAGCAAGTGACG"	"Mast-cell"
"GACCCAGGTCTTACTT"	"Podocytes"
"GACCCAGGTTATTCTC"	"Podocytes"
"GACCCAGGTTTCTATC"	"Cyst.PC-CD"
"GACCCAGTCACTGAAC"	"PEC"
"GACCCTTCATACTGTG"	"Cyst.IM-CD"
"GACCCTTGTCGCCTAG"	"Cyst.PC-CD"
"GACCCTTGTGGGCTTC"	"Cyst.PC-CD"
"GACCGTGAGATTAGCA"	"Cyst.IC-A_2"
"GACCGTGGTATCAAGA"	"PEC"
"GACCGTGGTCTTCAAG"	"PEC"
"GACCGTGTCAACTCTT"	"Cyst.PC-CD"
"GACCGTGTCTGTGCTC"	"PEC"
"GACCTTCAGCGTCTGC"	"Cyst.PC-CD"
"GACCTTCAGGAGAATG"	"Cyst.IM-CD"
"GACCTTCCACCCTCTA"	"Cyst.cTAL"
"GACCTTCCAGACGGAT"	"Cyst.IM-CD"
"GACCTTCCAGGTGTTT"	"Cyst.PC-CD"
"GACCTTCGTGAATGAT"	"Cyst.IC-A_1"
"GACCTTCGTGTTCCTC"	"Cyst.cTAL"
"GACCTTCTCGACGCTG"	"Cyst.IM-CD"
"GACGCTGAGGTTGACG"	"Podocytes"
"GACGCTGAGTTCCAGT"	"Podocytes"
"GACGCTGGTAGGAGGG"	"Cyst.PC-CD"
"GACGCTGTCCACATAG"	"Cyst.PC-CD"
"GACGCTGTCCTGTAAG"	"Cyst.PC-CD"
"GACGCTGTCGCACGAC"	"Cyst.IC-A_1"
"GACGCTGTCGCCGAAC"	"PEC"
"GACGCTGTCTGGTTGA"	"Mast-cell"
"GACGTTAAGTGTTCAC"	"PEC"
"GACGTTAGTGTTCCTC"	"Cyst.PC-CD"
"GACGTTATCACCTACC"	"Cyst.PT_1"
"GACTATGAGTATGACA"	"Cyst.IC-A_1"
"GACTATGAGTCCCGGT"	"Cyst.PC-CD"
"GACTATGGTCACTACA"	"Cyst.PC-CD"
"GACTATGGTCTGGTTA"	"EC"
"GACTATGGTCTGTGTA"	"Cyst.IC-A_2"
"GACTATGGTTATAGCC"	"Cyst.PC-CD"
"GACTATGGTTGGACTT"	"Cyst.IM-CD"
"GACTATGTCCCTGTTG"	"Cyst.IC-A_2"
"GACTATGTCTAATTCC"	"PEC"
"GACTCAACACCTCGTT"	"Cyst.IM-CD"
"GACTCAACATAGGCGA"	"Mac/DC"
"GACTCAACATCAGCTA"	"Cyst.PC-CD"
"GACTCAACATCATTTC"	"B-cell_2"
"GACTCAAGTATTGCCA"	"Cyst.PT_1"
"GACTCAATCGCGGACT"	"Cyst.IC-A_1"
"GACTCTCAGGTTGGTG"	"EC"
"GACTCTCGTGAGTCAG"	"PEC"
"GACTCTCTCAAGCCCG"	"Cyst.IM-CD"
"GACTCTCTCCTCTCTT"	"PEC"
"GACTCTCTCGAACCTA"	"T-cell"
"GACTCTCTCTTCGTGC"	"Mast-cell"
"GACTCTCTCTTCTTCC"	"Cyst.PC-CD"
"GACTGATAGGACTGGT"	"Cyst.IM-CD"
"GACTGATAGGATTACA"	"Cyst.PC-CD"
"GACTGATAGGCCATAG"	"Cyst.PC-CD"
"GACTGATAGTCCCGAC"	"VSMC"
"GACTGATAGTTCCATG"	"Cyst.cTAL"
"GACTGATCAACCCGCA"	"Cyst.IC-A_1"
"GACTGATGTACACGCC"	"Cyst.PC-CD"
"GACTGATGTCTGATAC"	"Cyst.PC-CD"
"GACTGATGTGCAGTGA"	"Cyst.IC-A_1"
"GACTGATTCATCTATC"	"Cyst.IM-CD"
"GACTTCCAGCGATGGT"	"Cyst.cTAL"
"GACTTCCAGGGAGGCA"	"Cyst.cTAL"
"GACTTCCAGTTGTAAG"	"Cyst.PC-CD"
"GACTTCCCACATACGT"	"Cyst.IM-CD"
"GACTTCCTCGAGCCTG"	"Cyst.IM-CD"
"GACTTCCTCGGCATAT"	"Cyst.IM-CD"
"GAGAAATAGGCAGGGA"	"Cyst.PC-CD"
"GAGAAATCAACCTAAC"	"Podocytes"
"GAGAAATCAAGTATCC"	"Cyst.PC-CD"
"GAGAAATCACACCGAC"	"VSMC"
"GAGAAATCACACCTTC"	"Cyst.IC-A_2"
"GAGAAATCAGAGGACT"	"Mac/DC"
"GAGAAATCATTCTCTA"	"Cyst.PC-CD"
"GAGAAATCATTGCTGA"	"Cyst.cTAL"
"GAGAAATGTACCGTGC"	"Cyst.IM-CD"
"GAGAAATGTGAGACCA"	"Cyst.PC-CD"
"GAGAAATGTTATAGCC"	"Cyst.IM-CD"
"GAGAAATTCTAACACG"	"Cyst.IC-A_1"
"GAGACCCAGCCAAGCA"	"Cyst.PC-CD"
"GAGACCCCAATAGGAT"	"Cyst.PC-CD"
"GAGACCCCAATGGCAG"	"Cyst.IM-CD"
"GAGACCCCACGTACAT"	"Cyst.PC-CD"
"GAGACCCGTCAATCTG"	"Cyst.PC-CD"
"GAGACTTAGTCTGGTT"	"Cyst.IM-CD"
"GAGACTTGTCGGTGAA"	"T-cell"
"GAGACTTGTGGCTACC"	"Cyst.PC-CD"
"GAGACTTGTGTAGCAG"	"Cyst.IM-CD"
"GAGACTTTCGTTATCT"	"EC"
"GAGAGGTAGAGCAGAA"	"Cyst.IC-A_1"
"GAGAGGTGTTACGTAC"	"Podocytes"
"GAGATGGAGGTGGGTT"	"Cyst.IM-CD"
"GAGATGGCAGCGTACC"	"PEC"
"GAGATGGCATCACGGC"	"Cyst.PC-CD"
"GAGATGGGTGCAGGAT"	"Cyst.IM-CD"
"GAGATGGGTTATTCCT"	"Mac/DC"
"GAGATGGTCCCGAGAC"	"Podocytes"
"GAGATGGTCCGATGCG"	"Cyst.IC-A_2"
"GAGATGGTCCTACCGT"	"Podocytes"
"GAGCCTGAGCGAACTG"	"Cyst.IM-CD"
"GAGCCTGCAGCCGGTT"	"Cyst.PC-CD"
"GAGCCTGCATGACAAA"	"PEC"
"GAGCCTGGTCTAACGT"	"Podocytes"
"GAGCCTGGTCTTGAGT"	"T-cell"
"GAGCTGCCACGTTGGC"	"Cyst.cTAL"
"GAGCTGCGTTGAGGAC"	"Cyst.IM-CD"
"GAGCTGCTCAGCGTCG"	"Cyst.IC-A_1"
"GAGCTGCTCGGTCGGT"	"T-cell"
"GAGCTGCTCTAGTCAG"	"Podocytes"
"GAGCTGCTCTCAAAGC"	"Cyst.PC-CD"
"GAGGCAAAGGAGGTTC"	"PEC"
"GAGGCAACACTGGACC"	"EC"
"GAGGCAAGTAACCAGG"	"Mast-cell"
"GAGGCAAGTGCCCAGT"	"PEC"
"GAGGCAATCGTAGGGA"	"Podocytes"
"GAGGCCTAGCTGTCCG"	"Cyst.PC-CD"
"GAGGCCTAGTCTAGCT"	"Cyst.PC-CD"
"GAGGCCTCACGTAGAG"	"Cyst.IC-A_2"
"GAGGCCTGTCGAAACG"	"Cyst.cTAL"
"GAGGCCTTCGAGAAGC"	"Cyst.IC-A_2"
"GAGGGATCAATCACGT"	"EC"
"GAGGGATCATCAGCTA"	"Mast-cell"
"GAGGGATCATCAGTCA"	"Cyst.IC-A_1"
"GAGGGATGTCTTTCAT"	"Cyst.PC-CD"
"GAGGGATTCAATCCGA"	"Cyst.IM-CD"
"GAGGGATTCGTTCAGA"	"T-cell"
"GAGGGATTCTCCGAAA"	"Cyst.CD"
"GAGGGATTCTGGGTCG"	"Cyst.PC-CD"
"GAGGGTACATACTTTC"	"Cyst.PC-CD"
"GAGGGTAGTAAGGAGA"	"Cyst.IC-A_1"
"GAGGGTAGTATCAAGA"	"Cyst.PC-CD"
"GAGGGTATCGGACAAG"	"PEC"
"GAGTCATAGCATCTTG"	"Cyst.PC-CD"
"GAGTCATGTCCGGTCA"	"Cyst.IC-A_2"
"GAGTCATTCTATGCCC"	"PEC"
"GAGTCATTCTCCCTAG"	"Mac/DC"
"GAGTCATTCTGTACAG"	"Cyst.IM-CD"
"GAGTCTAAGGGTCTTT"	"T-cell"
"GAGTCTACACAGTGTT"	"Cyst.IC-A_2"
"GAGTCTACACGTACTA"	"Cyst.IM-CD"
"GAGTCTAGTTACAGCT"	"Cyst.PC-CD"
"GAGTGAGAGCGCCCAT"	"EC"
"GAGTGAGAGGCTCCCA"	"B-cell_1"
"GAGTGAGCATGGGTTT"	"PEC"
"GAGTGAGGTACTAGCT"	"PEC"
"GAGTGAGGTCGCTGCA"	"EC"
"GAGTGAGGTGAGTGAC"	"Cyst.IM-CD"
"GAGTGAGTCGACCCAG"	"PEC"
"GAGTGAGTCGGCATTA"	"Podocytes"
"GAGTGAGTCTCTATGT"	"Cyst.PC-CD"
"GAGTGTTAGTCCTGCG"	"Cyst.IC-A_2"
"GAGTGTTCACCAGCCA"	"Cyst.IM-CD"
"GAGTGTTGTAAGACCG"	"Cyst.PC-CD"
"GAGTGTTGTGATTAGA"	"Cyst.IM-CD"
"GAGTGTTGTTGCGGAA"	"Cyst.IM-CD"
"GAGTGTTTCGAGAGAC"	"Cyst.PC-CD"
"GAGTTACAGCGGTAGT"	"Cyst.PC-CD"
"GAGTTACAGGTGCTGA"	"VSMC"
"GAGTTACAGTGGCAGT"	"PEC"
"GAGTTACCAAGAATGT"	"Cyst.cTAL"
"GAGTTACTCTGCATGA"	"Cyst.IM-CD"
"GAGTTGTAGGCAGGGA"	"T-cell"
"GAGTTGTCAAGTAGTA"	"Cyst.PC-CD"
"GAGTTGTCAGTCGCAC"	"Cyst.IC-A_1"
"GAGTTGTGTGGTCCGT"	"Cyst.PT_2"
"GAGTTGTGTTTGTTCT"	"Cyst.IM-CD"
"GAGTTGTTCAACGAGG"	"PEC"
"GAGTTGTTCGCCTTTG"	"PEC"
"GAGTTTGAGGACAACC"	"Cyst.PC-CD"
"GAGTTTGCAAGAGTAT"	"Cyst.IM-CD"
"GAGTTTGGTAGGTTTC"	"Cyst.PC-CD"
"GAGTTTGGTTAACCTG"	"Cyst.IM-CD"
"GAGTTTGGTTAAGCAA"	"Cyst.PC-CD"
"GAGTTTGTCACCGCTT"	"Cyst.IM-CD"
"GAGTTTGTCGCTTAAG"	"Cyst.IM-CD"
"GATAGAACAACAGCCC"	"Cyst.IM-CD"
"GATAGAAGTCAACCTA"	"Cyst.PT_1"
"GATAGAAGTTATGTGC"	"Cyst.PC-CD"
"GATAGAATCACCTCTG"	"VSMC"
"GATAGAATCACTCTTA"	"Cyst.IC-A_2"
"GATAGAATCCGGTTCT"	"Cyst.PC-CD"
"GATAGAATCGAGCCTG"	"PEC"
"GATAGCTAGCCAGAGT"	"Cyst.cTAL"
"GATAGCTAGTGATTCC"	"Cyst.CD"
"GATAGCTCAACGATTC"	"Cyst.CD"
"GATAGCTCAAGTACCT"	"Cyst.PC-CD"
"GATAGCTCACGATAGG"	"Cyst.IC-A_1"
"GATAGCTGTCTCTCTG"	"Mast-cell"
"GATAGCTGTGGTCTGC"	"PEC"
"GATAGCTTCCCGTTCA"	"VSMC"
"GATCACAAGGCGACAT"	"Cyst.IM-CD"
"GATCACACACGGAAGT"	"Cyst.PT_2"
"GATCACAGTCTGTGTA"	"Cyst.PC-CD"
"GATCACAGTGAGTTTC"	"VSMC"
"GATCACAGTTTACTGG"	"EC"
"GATCACATCCAATCCC"	"Cyst.PC-CD"
"GATCACATCGTGTTCC"	"B-cell_1"
"GATCACATCTCAAAGC"	"T-cell"
"GATCAGTGTCGGTACC"	"Mac/DC"
"GATCAGTGTCTGTCCT"	"Cyst.CD"
"GATCAGTTCCTTCTGG"	"Cyst.PC-CD"
"GATCATGAGAGGACTC"	"Cyst.IC-A_1"
"GATCATGAGGTTCCAT"	"Cyst.PC-CD"
"GATCATGCAGCTACAT"	"PEC"
"GATCATGGTACTTGTG"	"Cyst.PC-CD"
"GATCATGGTATTGGCT"	"Cyst.cTAL"
"GATCATGGTGTAGTGG"	"Mast-cell"
"GATCATGTCTAGGCAT"	"Cyst.cTAL"
"GATCCCTAGGATTTGA"	"Cyst.IC-A_2"
"GATCCCTAGGCGCTCT"	"Cyst.IM-CD"
"GATCCCTAGGTCATCT"	"PEC"
"GATCCCTGTACACGCC"	"Cyst.cTAL"
"GATCCCTTCAAGCGTT"	"Cyst.IM-CD"
"GATCCCTTCCTCACTG"	"Mast-cell"
"GATCGTAAGACGAAGA"	"Cyst.IM-CD"
"GATCGTAAGTGTTCCA"	"Mac/DC"
"GATCGTACAGTCGAGA"	"EC"
"GATCGTACATCTTCGC"	"T-cell"
"GATCGTAGTATCGAAA"	"EC"
"GATCGTAGTTTACACG"	"PEC"
"GATCGTATCTCACGAA"	"Cyst.PC-CD"
"GATGACTAGGGTCACA"	"Cyst.cTAL"
"GATGACTAGTGAACAT"	"EC"
"GATGACTCAGTGTGCC"	"Cyst.IC-A_2"
"GATGACTCAGTTCTAG"	"Cyst.IC-A_2"
"GATGACTGTGGAGGTT"	"PEC"
"GATGACTGTTAGTCGT"	"Cyst.PC-CD"
"GATGACTGTTGTGGCC"	"Cyst.IC-A_1"
"GATGACTTCGATACGT"	"VSMC"
"GATGAGGAGGAATTAC"	"Cyst.CD"
"GATGAGGAGTGGAATT"	"Cyst.PC-CD"
"GATGAGGCACAAGCAG"	"Cyst.CD"
"GATGAGGCATCATTTC"	"PEC"
"GATGAGGCATCGGCCA"	"Cyst.PC-CD"
"GATGAGGTCTCGCCTA"	"Cyst.PC-CD"
"GATGATCCATCCTTCG"	"VSMC"
"GATGATCGTACGTGAG"	"B-cell_2"
"GATGATCGTCGATTAC"	"Cyst.IM-CD"
"GATGATCGTGCCGAAA"	"Cyst.PC-CD"
"GATGATCTCATATGGC"	"Cyst.IC-A_1"
"GATGCTACACGTCTCT"	"Mast-cell"
"GATGCTACAGCGTGCT"	"Cyst.IC-A_2"
"GATGCTACAGTCGAGA"	"Cyst.PC-CD"
"GATGCTACATCTGTTT"	"Cyst.IC-A_1"
"GATGCTATCTTAGCAG"	"Cyst.PC-CD"
"GATGGAGAGAAGTCTA"	"Cyst.cTAL"
"GATGGAGCAAGTAGTA"	"Cyst.IC-A_1"
"GATGGAGCACAGTACT"	"PEC"
"GATGGAGGTCCTTGTC"	"Podocytes"
"GATGGAGGTGCGGTAA"	"Cyst.IC-A_1"
"GATGGAGGTGTCTTCC"	"Podocytes"
"GATGGAGGTTAAGAAC"	"Cyst.IM-CD"
"GATGGAGGTTTCGTAG"	"Cyst.cTAL"
"GATGGAGTCTTGATTC"	"Cyst.PC-CD"
"GATGTTGAGGATACCG"	"Cyst.IM-CD"
"GATGTTGAGGGCAAGG"	"PEC"
"GATGTTGAGGTCACAG"	"Cyst.cTAL"
"GATGTTGAGTCACAGG"	"Cyst.cTAL"
"GATGTTGGTCCAAGAG"	"Podocytes"
"GATGTTGGTGGTTTAC"	"Cyst.IM-CD"
"GATGTTGGTTCTATCT"	"Cyst.PC-CD"
"GATGTTGTCACCATAG"	"Cyst.PC-CD"
"GATGTTGTCCTTATAC"	"Cyst.PC-CD"
"GATGTTGTCGTTAGAC"	"EC"
"GATTCGAAGATCACCT"	"Cyst.IM-CD"
"GATTCGAAGCGAGTCA"	"Cyst.cTAL"
"GATTCGAAGCGGACAT"	"EC"
"GATTCGAAGGCTTAGG"	"Cyst.PC-CD"
"GATTCGAAGGTCCCGT"	"Cyst.cTAL"
"GATTCGAAGTCGCTAT"	"Cyst.PC-CD"
"GATTCGACAAGCGAAC"	"Cyst.cTAL"
"GATTCGACACGTCGGT"	"Cyst.PC-CD"
"GATTCGAGTCCGCAGT"	"Cyst.IC-A_1"
"GATTCGATCGCCTTGT"	"Mast-cell"
"GATTCGATCTCGGGAC"	"Cyst.IC-A_2"
"GATTCTTAGACTTCCA"	"Cyst.PC-CD"
"GATTCTTAGGGCTGAT"	"PEC"
"GATTCTTCAGAGGTAC"	"Cyst.PC-CD"
"GATTCTTCAGTGCGCT"	"Cyst.CD"
"GATTCTTGTGGTCTCG"	"Cyst.PC-CD"
"GATTCTTTCAAGTTGC"	"Cyst.IM-CD"
"GATTGGTAGCCTCTCT"	"B-cell_1"
"GATTGGTAGTATGAAC"	"Cyst.PC-CD"
"GATTGGTAGTGAGGCT"	"Cyst.PC-CD"
"GATTGGTCAGGAGGAG"	"EC"
"GATTGGTGTCAAAGTA"	"Cyst.PC-CD"
"GATTGGTGTGTACATC"	"Cyst.IM-CD"
"GATTGGTTCTTCTCAA"	"Cyst.IM-CD"
"GATTTCTAGCAAATGT"	"EC"
"GATTTCTAGGAAAGGT"	"VSMC"
"GATTTCTAGGCATTTC"	"Cyst.IM-CD"
"GATTTCTAGGGCAGTT"	"PEC"
"GATTTCTCAATGTGGG"	"Mac/DC"
"GATTTCTGTGACACGA"	"Mac/DC"
"GATTTCTGTGTGTACT"	"PEC"
"GCAACATAGAAGCGGG"	"EC"
"GCAACATAGGGAGGGT"	"Cyst.PC-CD"
"GCAACATAGGTCGACA"	"Cyst.PC-CD"
"GCAACATAGTTGCCCG"	"Cyst.PC-CD"
"GCAACATAGTTGTCGT"	"Cyst.IC-A_1"
"GCAACATCAACCTATG"	"Cyst.IC-A_2"
"GCAACATCACATATCG"	"T-cell"
"GCAACATCACCAGCTG"	"Cyst.PC-CD"
"GCAACATCAGAGTTGG"	"PEC"
"GCAACATTCCGCTAGG"	"Cyst.PT_2"
"GCAACATTCGCCGAAC"	"Podocytes"
"GCAACATTCTGCTCTG"	"Cyst.PC-CD"
"GCAACCGAGCCTATTG"	"Cyst.PC-CD"
"GCAACCGAGGGTTAGC"	"VSMC"
"GCAACCGCAGCTGGTC"	"Cyst.IM-CD"
"GCAACCGGTAGCTTGT"	"VSMC"
"GCAACCGGTCATAAAG"	"Podocytes"
"GCAACCGTCAGACAAA"	"Cyst.PC-CD"
"GCAACCGTCCGATGTA"	"PEC"
"GCAACCGTCGTAGCTA"	"Cyst.PC-CD"
"GCACATAAGGTACAGC"	"Cyst.IM-CD"
"GCACATAAGTATAACG"	"Cyst.PC-CD"
"GCACATACAATAAGGT"	"Cyst.PC-CD"
"GCACATACATGCCATA"	"Cyst.PC-CD"
"GCACATAGTAGTGGCA"	"Cyst.PC-CD"
"GCACATAGTGAGCTCC"	"Cyst.PC-CD"
"GCACATAGTGTATTCG"	"Cyst.PC-CD"
"GCACATATCGAACCAT"	"Cyst.PC-CD"
"GCACATATCTGCTCTG"	"PEC"
"GCACGGTAGACGGAAA"	"Cyst.cTAL"
"GCACGGTAGAGAAGGT"	"Cyst.IC-A_2"
"GCACGGTAGTAGTCCT"	"Cyst.PC-CD"
"GCACGGTAGTCGGCAA"	"Cyst.cTAL"
"GCACGGTCATGCACTA"	"Cyst.IM-CD"
"GCACGGTGTCAGGAGT"	"Cyst.PC-CD"
"GCACGGTGTGGTATGG"	"PEC"
"GCACGGTGTTCATCGA"	"PEC"
"GCACGGTGTTCGTAAC"	"Cyst.PC-CD"
"GCACGGTGTTGCCTAA"	"PEC"
"GCACGGTTCCTTCTAA"	"Cyst.PC-CD"
"GCACGTGAGAAGCGGG"	"VSMC"
"GCACGTGAGCTTTGTG"	"Mac/DC"
"GCACGTGCACTGGAAG"	"Cyst.PT_2"
"GCACGTGCAGATGCGA"	"Cyst.PC-CD"
"GCACGTGCAGGTGAGT"	"Podocytes"
"GCACGTGCATGCGTGC"	"Cyst.CD"
"GCACGTGGTAGTCTGT"	"Cyst.CD"
"GCACGTGTCTCTCGCA"	"Cyst.IM-CD"
"GCACTAAAGACTCATC"	"Cyst.IM-CD"
"GCACTAAAGAGAATCT"	"Cyst.IM-CD"
"GCACTAAAGAGGTTAT"	"B-cell_1"
"GCACTAAAGCACTGGA"	"Cyst.IC-A_1"
"GCACTAAAGCTAGCCC"	"Cyst.PC-CD"
"GCACTAAAGGTGAGCT"	"Cyst.PC-CD"
"GCACTAATCGTTGTAG"	"Mast-cell"
"GCAGCCAAGCAGTCTT"	"Cyst.PC-CD"
"GCAGCCACAGGTGTGA"	"Cyst.PC-CD"
"GCAGCCACAGGTTCGC"	"Cyst.cTAL"
"GCAGCCAGTAGTGATA"	"Cyst.IC-A_2"
"GCAGCCATCAACCTCC"	"Cyst.PC-CD"
"GCAGCCATCCATTGCC"	"Cyst.IM-CD"
"GCAGCTGCACGCACCA"	"Cyst.IC-A_2"
"GCAGCTGCAGATCACT"	"Cyst.PC-CD"
"GCAGCTGTCTCGTTTA"	"Cyst.PC-CD"
"GCAGGCTAGGTCACTT"	"Cyst.PC-CD"
"GCAGGCTCAGGGTTGA"	"Cyst.IM-CD"
"GCAGGCTCAGTGGTGA"	"Cyst.cTAL"
"GCAGGCTGTCGAGCAA"	"Cyst.IM-CD"
"GCAGTTAAGACGGTTG"	"EC"
"GCAGTTAAGGATGCGT"	"Cyst.cTAL"
"GCAGTTAAGGTGCCTC"	"Mast-cell"
"GCAGTTACAGCTATAC"	"Cyst.IM-CD"
"GCAGTTACAGCTATTG"	"Cyst.PC-CD"
"GCAGTTACAGGAATAT"	"Cyst.IC-A_1"
"GCAGTTAGTAATGCGG"	"Cyst.PC-CD"
"GCAGTTAGTCTGTGAT"	"Cyst.IM-CD"
"GCAGTTATCCTCACGT"	"Cyst.cTAL"
"GCATCGGAGATACTGA"	"Cyst.PC-CD"
"GCATCGGGTTGGTAGG"	"Cyst.IC-A_1"
"GCATCGGTCCGAAGGA"	"Mac/DC"
"GCATCTCAGGAAACGA"	"Mast-cell"
"GCATCTCCACCATTCC"	"Cyst.PC-CD"
"GCATCTCCATGTGGCC"	"Cyst.IM-CD"
"GCATCTCGTCTCCTGT"	"Cyst.cTAL"
"GCATCTCGTTACGGAG"	"Podocytes"
"GCATCTCTCACTGGTA"	"Cyst.PT_1"
"GCATCTCTCGATTTCT"	"Podocytes"
"GCATGATAGCCGAACA"	"Cyst.IM-CD"
"GCATGATAGGTCGCCT"	"Cyst.IM-CD"
"GCATGATCAAATCAGA"	"Cyst.PC-CD"
"GCATGATCAATTGCCA"	"Cyst.PC-CD"
"GCATGATCATAAGCGG"	"Cyst.IC-A_1"
"GCATGATTCATTGCCC"	"Cyst.PC-CD"
"GCATTAGAGAACCCGA"	"Cyst.PC-CD"
"GCATTAGAGGTATCTC"	"Cyst.cTAL"
"GCATTAGAGTTCTACG"	"PEC"
"GCATTAGGTCTAGTGT"	"Cyst.IM-CD"
"GCATTAGGTTCGGTTA"	"Cyst.IM-CD"
"GCATTAGTCGCTGTCT"	"Cyst.IC-A_1"
"GCATTAGTCTTTGCGC"	"Cyst.IC-A_1"
"GCCAACGAGAATAGTC"	"B-cell_1"
"GCCAACGCACTCGATA"	"Cyst.IM-CD"
"GCCAACGGTGCAGGAT"	"VSMC"
"GCCAACGTCAAGCCAT"	"Mast-cell"
"GCCAACGTCGGCTCTT"	"PEC"
"GCCAACGTCTTGGGCG"	"Cyst.IM-CD"
"GCCAGCAAGACTGAGC"	"Cyst.IM-CD"
"GCCAGCAAGGAGTCTG"	"B-cell_1"
"GCCAGCACATTGACAC"	"T-cell"
"GCCAGCAGTAGTCACT"	"Cyst.IM-CD"
"GCCAGCATCGTCTAAG"	"Cyst.PC-CD"
"GCCAGGTCACAGTGAG"	"Cyst.PT_2"
"GCCAGGTCACCCTAGG"	"Cyst.PC-CD"
"GCCAGGTCAGCTTTCC"	"VSMC"
"GCCAGGTTCGCATGAT"	"VSMC"
"GCCAGGTTCGCCTATC"	"Cyst.IC-A_2"
"GCCAGTGCATTAGGCT"	"EC"
"GCCAGTGCATTGAGGG"	"PEC"
"GCCAGTGGTACAAACA"	"Mac/DC"
"GCCAGTGGTCGCATCG"	"Cyst.PC-CD"
"GCCAGTGGTGCAGATG"	"PEC"
"GCCAGTGGTTCGATTG"	"PEC"
"GCCAGTGTCGCTCATC"	"Cyst.IC-A_2"
"GCCAGTGTCTGTAACG"	"Cyst.cTAL"
"GCCATGGAGCAGCCTC"	"Cyst.IM-CD"
"GCCATGGGTCGCATCG"	"Cyst.IM-CD"
"GCCATGGGTCTGCATA"	"Cyst.PC-CD"
"GCCATGGGTTCTATCT"	"Cyst.PT_2"
"GCCATGGTCACGTAGT"	"PEC"
"GCCATGGTCTGTGTGA"	"PEC"
"GCCATTCAGAGCGACT"	"VSMC"
"GCCATTCAGTGAATAC"	"Cyst.cTAL"
"GCCATTCCAATACAGA"	"T-cell"
"GCCATTCCATAGCTGT"	"Cyst.PC-CD"
"GCCATTCGTGCCCAGT"	"VSMC"
"GCCCAGAAGCAATAAC"	"Cyst.PC-CD"
"GCCCAGACACGTAGTT"	"Cyst.CD"
"GCCCAGAGTCGTCTCT"	"B-cell_2"
"GCCCAGAGTGGTCTTA"	"Mast-cell"
"GCCCAGATCATTTGCT"	"Cyst.PC-CD"
"GCCCAGATCTGCGAGC"	"Podocytes"
"GCCCGAACATCCGGTG"	"Cyst.IM-CD"
"GCCCGAAGTAGACTGG"	"PEC"
"GCCCGAAGTCAGGTAG"	"Cyst.IC-A_1"
"GCCCGAATCCACTGAA"	"Cyst.PC-CD"
"GCCCGAATCCTCAGAA"	"Cyst.IC-A_1"
"GCCGATGAGGCTCAAG"	"Podocytes"
"GCCGATGCATCGCCTT"	"Cyst.PC-CD"
"GCCGATGGTCGCCTAG"	"Cyst.IC-A_2"
"GCCGATGGTGTCCGGT"	"Cyst.IC-A_2"
"GCCGATGGTGTCTTCC"	"EC"
"GCCGATGTCGCCACTT"	"PEC"
"GCCGTGAAGCAGGCTA"	"Cyst.IM-CD"
"GCCGTGACAAAGACTA"	"Podocytes"
"GCCGTGAGTTAGGCCC"	"Cyst.IC-A_1"
"GCCTGTTAGAGTCAAT"	"Cyst.cTAL"
"GCCTGTTAGGATATAC"	"Podocytes"
"GCCTGTTAGTAGGATT"	"T-cell"
"GCCTGTTCACGGCTAC"	"Cyst.PC-CD"
"GCCTGTTGTAATACCC"	"Cyst.PC-CD"
"GCCTGTTGTACAAAGT"	"Cyst.PC-CD"
"GCCTGTTTCAGCCCAG"	"EC"
"GCCTGTTTCATCCCGT"	"EC"
"GCGAGAAAGTAACAGT"	"B-cell_2"
"GCGAGAAAGTTGGAGC"	"Cyst.IM-CD"
"GCGAGAAGTCCACACG"	"Cyst.PT_2"
"GCGAGAAGTGGGCTCT"	"Cyst.cTAL"
"GCGAGAAGTTAAACCC"	"Cyst.CD"
"GCGAGAATCACTGGTA"	"B-cell_1"
"GCGAGAATCATGAAAG"	"PEC"
"GCGAGAATCCCAGTGG"	"PEC"
"GCGATCGAGAATCTAG"	"EC"
"GCGATCGAGCGACTTT"	"Cyst.PC-CD"
"GCGATCGAGTCACGAG"	"T-cell"
"GCGATCGCAAATGAGT"	"Mac/DC"
"GCGATCGCAAGAGTAT"	"PEC"
"GCGATCGCAGTTCTAG"	"Cyst.IM-CD"
"GCGATCGCATATCTGG"	"Cyst.IC-A_1"
"GCGATCGCATGGCGCT"	"Cyst.PC-CD"
"GCGATCGGTAATTGGA"	"Cyst.IC-A_1"
"GCGATCGGTAGCCCTG"	"PEC"
"GCGATCGGTAGGACCA"	"Cyst.PC-CD"
"GCGATCGGTCTCTCTG"	"Cyst.PC-CD"
"GCGATCGGTGGCTAGA"	"Cyst.PC-CD"
"GCGATCGTCAGCTGTA"	"Cyst.PC-CD"
"GCGGAAAAGGACTATA"	"T-cell"
"GCGGAAAAGGTCATAA"	"Cyst.IM-CD"
"GCGGAAACACCGTGAC"	"PEC"
"GCGGAAACATATCTCT"	"Mac/DC"
"GCGGAAAGTACAAAGT"	"Cyst.PC-CD"
"GCGGAAAGTATAGGGC"	"Cyst.PC-CD"
"GCGGATCCAAACCGGA"	"Cyst.PC-CD"
"GCGGATCCATTCTCTA"	"Cyst.IM-CD"
"GCGGATCGTCTCGGAC"	"VSMC"
"GCGGATCTCTGTACAG"	"VSMC"
"GCGTGCAAGTACCCTA"	"Cyst.CD"
"GCGTGCACAAAGTGTA"	"Cyst.IM-CD"
"GCGTGCACATCTGTTT"	"Cyst.IC-A_2"
"GCGTGCAGTACAGAAT"	"Cyst.PC-CD"
"GCGTGCAGTTCGTTCC"	"Cyst.IC-A_2"
"GCGTTTCCAAGACAAT"	"VSMC"
"GCGTTTCCACAAACGG"	"PEC"
"GCGTTTCTCTCCAAGA"	"Cyst.cTAL"
"GCTACAAAGTAACGAT"	"Podocytes"
"GCTACAACAAGTAGTA"	"Cyst.IM-CD"
"GCTACAACAGGCTTGC"	"PEC"
"GCTACAACATGACCCG"	"PEC"
"GCTACAAGTCCATCTC"	"Cyst.PC-CD"
"GCTACAATCCTCTCTT"	"Cyst.IC-A_1"
"GCTACAATCTTGATTC"	"Cyst.PC-CD"
"GCTACCTCAAGAAATC"	"Cyst.cTAL"
"GCTACCTCAGCACAGA"	"Cyst.CD"
"GCTACCTGTCATAAAG"	"Cyst.PT_1"
"GCTACCTTCTCCCTAG"	"VSMC"
"GCTCAAAAGCATTTGC"	"Cyst.PC-CD"
"GCTCAAACAACAGCTT"	"Mast-cell"
"GCTGAATAGATTACCC"	"PEC"
"GCTGAATAGGTTCTTG"	"EC"
"GCTGAATCAAATTGCC"	"Cyst.IM-CD"
"GCTGAATCAACCAACT"	"Cyst.PC-CD"
"GCTGAATCACTTGACA"	"Cyst.PC-CD"
"GCTGAATCAGAAACCG"	"Cyst.PC-CD"
"GCTGAATGTCATCGGC"	"Cyst.PC-CD"
"GCTGAATGTTCGAAGG"	"Cyst.IM-CD"
"GCTGAATGTTTGCAGT"	"Podocytes"
"GCTGAATTCACAGAGG"	"Cyst.IM-CD"
"GCTGAATTCCACTAGA"	"Cyst.PC-CD"
"GCTGAATTCTGTCAGA"	"Cyst.PT_2"
"GCTGCAGAGCCAAGCA"	"Mast-cell"
"GCTGCAGCATGAGATA"	"PEC"
"GCTGGGTCACACCTGG"	"Cyst.PC-CD"
"GCTGGGTCAGGCACTC"	"Cyst.PC-CD"
"GCTGGGTCAGTGTGGA"	"Cyst.PC-CD"
"GCTGGGTCATGGACAG"	"Cyst.cTAL"
"GCTGGGTGTATAGCTC"	"Cyst.CD"
"GCTGGGTGTCTGTAGT"	"Cyst.IM-CD"
"GCTGGGTTCTATACGG"	"Cyst.IC-A_1"
"GCTTCACAGTTCCGTA"	"Cyst.IC-A_1"
"GCTTCACGTAATCAAG"	"VSMC"
"GCTTCACGTGGTACAG"	"Cyst.PC-CD"
"GCTTCACGTGTTCCTC"	"Cyst.IC-A_1"
"GCTTCACTCATACGAC"	"VSMC"
"GCTTCACTCGGATACT"	"Cyst.IC-A_1"
"GCTTCACTCTCTCTAA"	"Cyst.IM-CD"
"GCTTGGGCATGACTAC"	"Cyst.PC-CD"
"GCTTGGGGTCGTAATC"	"Cyst.IC-A_2"
"GCTTGGGGTGGCTTAT"	"Cyst.IM-CD"
"GCTTTCGAGATGCTGG"	"Cyst.cTAL"
"GCTTTCGTCACTCGAA"	"Cyst.IM-CD"
"GCTTTCGTCGAGCACC"	"Cyst.PC-CD"
"GGAACCCAGAGGGTGG"	"Cyst.PC-CD"
"GGAACCCCAAGCAGGT"	"Podocytes"
"GGAACCCCACCCAACG"	"Cyst.PC-CD"
"GGAACCCGTATCGTTG"	"Cyst.cTAL"
"GGAACCCGTGGCTGAA"	"Cyst.IM-CD"
"GGAACCCGTGGTCTGC"	"Cyst.PC-CD"
"GGAACCCTCTCCCTAG"	"Cyst.IC-A_2"
"GGAACCCTCTGCCTCA"	"Cyst.PT_1"
"GGAAGTGAGAATACAC"	"Cyst.PC-CD"
"GGAAGTGGTATAGGAT"	"Cyst.IM-CD"
"GGAAGTGGTGGATCAG"	"Cyst.PC-CD"
"GGAAGTGGTTCGAAGG"	"Cyst.IC-A_2"
"GGAAGTGTCATCTGTT"	"PEC"
"GGAAGTGTCCCGTTCA"	"T-cell"
"GGAATCTAGTCACGCC"	"Cyst.cTAL"
"GGAATCTCAATCAGCT"	"Cyst.IC-A_1"
"GGAATCTGTCAAGTTC"	"Podocytes"
"GGAATCTGTGAATAAC"	"Cyst.PC-CD"
"GGAATCTGTGATAGAT"	"Cyst.PC-CD"
"GGAATCTTCGTGGACC"	"Cyst.IC-A_2"
"GGAATCTTCTGCGGGT"	"Cyst.PC-CD"
"GGAATGGAGATCACCT"	"Cyst.IM-CD"
"GGAATGGAGTCTCGTA"	"Cyst.cTAL"
"GGAATGGCAATTTCGG"	"T-cell"
"GGAATGGCAGATACTC"	"Cyst.IM-CD"
"GGAATGGGTCTAGTGT"	"PEC"
"GGAATGGGTGGCTGCT"	"EC"
"GGAATGGTCGACGCTG"	"Cyst.PC-CD"
"GGACGTCCACCAGCTG"	"Cyst.IM-CD"
"GGACGTCCAGGTCAGA"	"T-cell"
"GGACGTCCATATCTGG"	"Cyst.PC-CD"
"GGACGTCGTCACCACG"	"Cyst.IC-A_1"
"GGACGTCTCTGAGTCA"	"Cyst.IM-CD"
"GGAGAACAGCAAGTGC"	"Cyst.PC-CD"
"GGAGAACTCAAGCCAT"	"Cyst.PC-CD"
"GGAGAACTCCATCAGA"	"Podocytes"
"GGAGAACTCTCTATAC"	"Cyst.PC-CD"
"GGAGATGAGAAGCTGC"	"Cyst.PT_1"
"GGAGATGAGAAGTATC"	"Cyst.PC-CD"
"GGAGATGAGTAGACAT"	"Cyst.PC-CD"
"GGAGATGCAAATCGTC"	"Cyst.CD"
"GGAGATGCACGTCTCT"	"Cyst.IC-A_2"
"GGAGATGGTACCTAGT"	"Cyst.IM-CD"
"GGAGATGGTCGTTGCG"	"EC"
"GGAGATGGTCTCAGAT"	"Cyst.PC-CD"
"GGAGATGTCCGCCTAT"	"Cyst.PC-CD"
"GGAGATGTCGATGGAG"	"Cyst.PC-CD"
"GGAGATGTCGTCGCTT"	"Cyst.PC-CD"
"GGAGATGTCTCATGCC"	"Cyst.IM-CD"
"GGAGCAACAACTGATC"	"Cyst.PC-CD"
"GGAGCAACAATGTCTG"	"Cyst.PC-CD"
"GGAGCAAGTATGTCCA"	"VSMC"
"GGAGCAAGTCGATTCA"	"PEC"
"GGAGCAATCAATGTCG"	"PEC"
"GGAGCAATCCCGTTGT"	"T-cell"
"GGAGGATCACACCTTC"	"VSMC"
"GGAGGATGTGGATGAC"	"Mac/DC"
"GGAGGATGTTCACGAT"	"PEC"
"GGAGGATTCTCTCTAA"	"Cyst.IC-A_1"
"GGAGGTAAGTTACGTC"	"Cyst.IM-CD"
"GGAGGTACACCTGAAT"	"Cyst.IM-CD"
"GGAGGTACAGGCGATA"	"Cyst.IM-CD"
"GGAGGTACAGTCCGTG"	"Cyst.cTAL"
"GGAGGTAGTCTACGTA"	"PEC"
"GGAGGTAGTGAATATG"	"Podocytes"
"GGAGGTAGTGCCCACA"	"Cyst.IC-A_1"
"GGAGGTAGTGCTGCAC"	"T-cell"
"GGATCTAAGAGGATGA"	"PEC"
"GGATCTACAATCGTCA"	"VSMC"
"GGATCTACAGGTAGTG"	"EC"
"GGATCTACATCAGTCA"	"Cyst.IC-A_1"
"GGATCTAGTGACTAAA"	"Mast-cell"
"GGATCTAGTGTAAACA"	"Cyst.PT_1"
"GGATGTTAGAATACAC"	"Cyst.IC-A_2"
"GGATGTTGTTGGACTT"	"PEC"
"GGATGTTGTTTGAACC"	"Mac/DC"
"GGATGTTTCCACAGGC"	"Mac/DC"
"GGCACGTAGACTTCCA"	"Cyst.IM-CD"
"GGCAGTCCACGTAGAG"	"Cyst.PC-CD"
"GGCAGTCCAGGCGATA"	"Cyst.IM-CD"
"GGCAGTCGTACGCTAT"	"Cyst.PC-CD"
"GGCAGTCGTGGGTATG"	"Cyst.IM-CD"
"GGCAGTCGTGGTCCGT"	"Cyst.IM-CD"
"GGCGTCAAGAGCCGAT"	"Cyst.cTAL"
"GGCGTCAAGCATGCAG"	"Cyst.IM-CD"
"GGCGTCAAGCGCCCAT"	"VSMC"
"GGCGTCAAGTCTGCGC"	"Cyst.PC-CD"
"GGCGTCACAACAGCCC"	"Mac/DC"
"GGCGTCATCCCGAGGT"	"Cyst.cTAL"
"GGCGTCATCGACCCAG"	"VSMC"
"GGCTGTGAGGTAGTCG"	"Cyst.PC-CD"
"GGCTGTGCAAGGTCAG"	"Cyst.CD"
"GGCTGTGCACTGTCGG"	"Cyst.IC-A_2"
"GGCTGTGGTAAGTTAG"	"Cyst.PC-CD"
"GGCTGTGGTGACAGGT"	"Cyst.PC-CD"
"GGCTGTGTCATCGGGC"	"Cyst.PC-CD"
"GGCTGTGTCCAATCCC"	"Cyst.cTAL"
"GGCTTGGGTCACCACG"	"Cyst.IC-A_1"
"GGCTTGGGTCCGGTGT"	"Cyst.IM-CD"
"GGCTTGGTCGGCTTGG"	"Cyst.PC-CD"
"GGCTTTCAGTCACTCA"	"Cyst.IC-A_1"
"GGCTTTCCAATAGTCC"	"Cyst.IC-A_1"
"GGCTTTCCATTCGATG"	"Cyst.PC-CD"
"GGCTTTCGTTGGGCCT"	"Podocytes"
"GGCTTTCTCAGCTTCC"	"Cyst.PC-CD"
"GGGAAGTAGAGCATAT"	"Cyst.IC-A_2"
"GGGAAGTAGAGTGAAG"	"Cyst.PC-CD"
"GGGAAGTCAACACGAG"	"Cyst.PC-CD"
"GGGAAGTCAAGAATGT"	"Cyst.PT_2"
"GGGAAGTCATAACAGA"	"Cyst.IC-A_2"
"GGGAAGTGTGTGCTTA"	"Podocytes"
"GGGACAAAGCGACTAG"	"Cyst.IM-CD"
"GGGACAAAGGTATAGT"	"Cyst.PC-CD"
"GGGACAACACAAAGTA"	"EC"
"GGGACAACAGGTCTCG"	"Cyst.IM-CD"
"GGGACAAGTAATTGGA"	"Mast-cell"
"GGGACAAGTGAGAACC"	"Cyst.IC-A_2"
"GGGACAAGTGCCTACG"	"Cyst.cTAL"
"GGGACAAGTTACACAC"	"EC"
"GGGACAATCACCTGGG"	"Cyst.PC-CD"
"GGGACAATCGTGGAAG"	"Podocytes"
"GGGACCTAGCTCCATA"	"Mast-cell"
"GGGACCTCAAACTAGA"	"Cyst.cTAL"
"GGGACCTCAGACGGAT"	"Cyst.PC-CD"
"GGGACCTCATTATGCG"	"Cyst.IM-CD"
"GGGACCTCATTGCAAC"	"Cyst.PC-CD"
"GGGACCTGTCTTGAAC"	"Cyst.PC-CD"
"GGGACCTGTGTTATCG"	"Cyst.PC-CD"
"GGGACCTGTTGGGAAC"	"Cyst.PC-CD"
"GGGACCTTCATCACTT"	"PEC"
"GGGACCTTCCACAGCG"	"Mast-cell"
"GGGACCTTCGTAGGGA"	"Cyst.IC-A_1"
"GGGACTCAGAGCTGCA"	"Cyst.IC-A_1"
"GGGACTCCAGGTCCGT"	"Cyst.IC-A_1"
"GGGACTCCATAATGCC"	"Cyst.PC-CD"
"GGGAGATAGACAGTCG"	"PEC"
"GGGAGATAGGTTCCAT"	"Cyst.IC-A_1"
"GGGAGATTCCACAAGT"	"Mast-cell"
"GGGAGATTCGCTGTTC"	"Cyst.IC-A_1"
"GGGAGATTCTCCGAAA"	"Cyst.cTAL"
"GGGAGTAAGATACAGT"	"EC"
"GGGAGTACACTGGATT"	"Cyst.PC-CD"
"GGGAGTAGTGCCTTCT"	"Cyst.IM-CD"
"GGGAGTATCGTCCTCA"	"EC"
"GGGATCCAGCATTGTC"	"Cyst.IM-CD"
"GGGATCCTCTTGGGCG"	"Cyst.PC-CD"
"GGGATGAAGTTAACAG"	"Cyst.PC-CD"
"GGGATGACAGCGTGCT"	"Cyst.cTAL"
"GGGATGACATCGGCCA"	"PEC"
"GGGATGAGTACCAGAG"	"Cyst.PC-CD"
"GGGATGAGTCGAACGA"	"Cyst.PC-CD"
"GGGATGAGTGTAGTGG"	"PEC"
"GGGATGAGTTGTTGCA"	"Mast-cell"
"GGGATGATCATTGAGC"	"VSMC"
"GGGATGATCCTGGGTG"	"Cyst.PC-CD"
"GGGCCATCAATTCGTG"	"Cyst.IM-CD"
"GGGCCATGTCACAGAG"	"VSMC"
"GGGCCATGTGATCATC"	"T-cell"
"GGGCCATGTGATGGCA"	"Cyst.PC-CD"
"GGGCCATGTGTGTTTG"	"Cyst.IM-CD"
"GGGCCATGTTCCGGTG"	"Cyst.cTAL"
"GGGCCATGTTGAGTCT"	"Cyst.PT_1"
"GGGCCATTCAGCATTG"	"Cyst.PC-CD"
"GGGCCATTCCCTTGGT"	"Cyst.PT_1"
"GGGCGTTAGTATGCAA"	"Cyst.IC-A_1"
"GGGCGTTCAACACTAC"	"VSMC"
"GGGCGTTTCGATTCCC"	"VSMC"
"GGGCTACAGACGTCCC"	"EC"
"GGGCTACCAAGTGCAG"	"Cyst.PC-CD"
"GGGCTACCAGCCATTA"	"Cyst.IM-CD"
"GGGCTACCATATCTGG"	"Cyst.IM-CD"
"GGGCTACGTCCAAGAG"	"Cyst.PC-CD"
"GGGCTACTCGTTCAGA"	"Cyst.PC-CD"
"GGGCTACTCTACGCGG"	"Cyst.IC-A_2"
"GGGCTCAAGCCACTCG"	"Cyst.CD"
"GGGCTCACAAAGGGCT"	"Cyst.PC-CD"
"GGGCTCACAATCGAAA"	"Cyst.PC-CD"
"GGGCTCACAATGCTCA"	"Cyst.PC-CD"
"GGGCTCACACTCTAGA"	"Cyst.PC-CD"
"GGGCTCAGTATCCTTT"	"T-cell"
"GGGTAGAAGATACCAA"	"Cyst.PC-CD"
"GGGTAGAAGTTCCGGC"	"Cyst.PC-CD"
"GGGTAGACACAGCGCT"	"Cyst.IM-CD"
"GGGTAGACAGACCCGT"	"VSMC"
"GGGTAGACAGTCTACA"	"Cyst.IM-CD"
"GGGTAGAGTGACACGA"	"EC"
"GGGTAGAGTGAGGCAT"	"EC"
"GGGTAGAGTGCCAAGA"	"Cyst.IM-CD"
"GGGTAGAGTTACACTG"	"Cyst.IC-A_2"
"GGGTAGAGTTTGGGTT"	"Cyst.PC-CD"
"GGGTATTAGATTGCGG"	"Cyst.IC-A_1"
"GGGTATTAGGTTACCT"	"Cyst.PC-CD"
"GGGTATTCATAACGGG"	"Cyst.IC-A_2"
"GGGTATTGTCTATGAC"	"Cyst.PC-CD"
"GGGTATTTCACCTCTG"	"EC"
"GGGTATTTCCATACTT"	"Cyst.cTAL"
"GGGTCACCAAGTTCCA"	"Podocytes"
"GGGTCACCAGGGCTTC"	"Cyst.PC-CD"
"GGGTCACGTCCTTGTC"	"Cyst.PC-CD"
"GGGTCTGCATGCCGGT"	"Cyst.PC-CD"
"GGGTCTGGTAGTCACT"	"Cyst.PT_1"
"GGGTCTGGTGAGTCAG"	"Cyst.PC-CD"
"GGGTCTGTCCACCCTA"	"Cyst.PC-CD"
"GGGTGAAAGCGTGAAC"	"Cyst.IC-A_2"
"GGGTGAAAGTTGGCTT"	"Cyst.cTAL"
"GGGTGAACAGATACCT"	"T-cell"
"GGGTGAACAGTTCACA"	"Cyst.IM-CD"
"GGGTGAAGTAGGCAGT"	"Cyst.cTAL"
"GGGTGAAGTGTATTCG"	"PEC"
"GGGTGTCGTCTGTTAG"	"Cyst.IM-CD"
"GGGTGTCTCGAACTCA"	"PEC"
"GGGTGTCTCGATTGGT"	"VSMC"
"GGGTGTCTCTAGTTCT"	"Cyst.PC-CD"
"GGGTGTCTCTTAAGGC"	"Podocytes"
"GGGTTATAGAGGTTTA"	"Podocytes"
"GGGTTATAGAGTCTTC"	"Mac/DC"
"GGGTTATCAGCAGAAC"	"Podocytes"
"GGGTTATCATTAAGCC"	"Cyst.PT_1"
"GGGTTATGTCAAGGCA"	"VSMC"
"GGGTTATTCAGTGATC"	"PEC"
"GGGTTATTCGGTAGGA"	"Mac/DC"
"GGGTTATTCTGATTCT"	"Mast-cell"
"GGGTTTACAACTCCAA"	"Cyst.PC-CD"
"GGGTTTAGTAGTTCCA"	"Podocytes"
"GGGTTTATCAAGTGGG"	"Cyst.PC-CD"
"GGGTTTATCCCGAGTG"	"Cyst.PC-CD"
"GGGTTTATCGAGCACC"	"Cyst.IC-A_2"
"GGGTTTATCGCCGTGA"	"Cyst.PC-CD"
"GGTAACTAGTCACGAG"	"Cyst.IC-A_2"
"GGTAACTAGTCATCCA"	"Podocytes"
"GGTAACTAGTCGGCAA"	"Mac/DC"
"GGTAACTCAAGAGTGC"	"PEC"
"GGTAACTCACGTGAGA"	"Cyst.PC-CD"
"GGTAACTGTCTTCAAG"	"PEC"
"GGTAACTTCTGAATCG"	"Cyst.cTAL"
"GGTAACTTCTTGTTAC"	"Cyst.IC-A_2"
"GGTAATCAGGCATTTC"	"B-cell_2"
"GGTAATCCAACTTCTT"	"PEC"
"GGTAATCCACCGTACG"	"Cyst.IM-CD"
"GGTAATCCACGACCTG"	"Cyst.IC-A_1"
"GGTAATCCAGAGTTCT"	"Cyst.IC-A_2"
"GGTAATCTCGGTAGAG"	"Cyst.IM-CD"
"GGTAGAGAGATGAAGG"	"Cyst.PC-CD"
"GGTAGAGAGTGGTGGT"	"Cyst.CD"
"GGTAGAGCACTGCACG"	"Podocytes"
"GGTAGAGTCACGAGGA"	"Mast-cell"
"GGTAGAGTCCTAGCGG"	"Cyst.PC-CD"
"GGTCACGCAACAAAGT"	"Cyst.PC-CD"
"GGTCACGCACAGAGAC"	"Cyst.IM-CD"
"GGTCACGCAGATACTC"	"Cyst.IM-CD"
"GGTCACGGTCAATCTG"	"Cyst.IM-CD"
"GGTCACGTCACTCACC"	"Cyst.IM-CD"
"GGTCACGTCATTGGTG"	"Cyst.IC-A_2"
"GGTCACGTCCGAGCTG"	"PEC"
"GGTCACGTCTCCGATC"	"Cyst.PC-CD"
"GGTCTGGAGTCCCGAC"	"Cyst.PC-CD"
"GGTCTGGCACAATGCT"	"Cyst.PC-CD"
"GGTCTGGCATGGGTCC"	"VSMC"
"GGTCTGGGTCAACCTA"	"Cyst.IM-CD"
"GGTCTGGGTCGGTGTC"	"Cyst.IM-CD"
"GGTCTGGTCGTAATGC"	"Podocytes"
"GGTGAAGCAACCAACT"	"Cyst.PC-CD"
"GGTGAAGCACGAGAAC"	"EC"
"GGTGAAGCACTTGAGT"	"PEC"
"GGTGAAGTCCGTGGTG"	"Cyst.IM-CD"
"GGTGATTTCGTGGACC"	"Cyst.IC-A_2"
"GGTGGCTCAAGCGGAT"	"PEC"
"GGTGGCTGTGATCGTT"	"Cyst.IM-CD"
"GGTGGCTGTTGAAGTA"	"Cyst.IC-A_2"
"GGTGGCTGTTGTACGT"	"Mac/DC"
"GGTGGCTTCACCGGGT"	"Cyst.CD"
"GGTGGCTTCCATTTGT"	"PEC"
"GGTGGCTTCCGACAGC"	"VSMC"
"GGTGGCTTCTGTCCCA"	"Cyst.PC-CD"
"GGTGTCGCACGCTGAC"	"PEC"
"GGTGTCGGTCACTCTC"	"Podocytes"
"GGTGTCGTCTTGCGCT"	"VSMC"
"GGTGTTAAGAGTCAAT"	"Cyst.PC-CD"
"GGTGTTAAGCCAGTAG"	"PEC"
"GGTGTTAAGCGTTCCG"	"PEC"
"GGTGTTAGTTAAACCC"	"Cyst.PC-CD"
"GGTGTTAGTTTACCAG"	"Podocytes"
"GGTGTTATCCGTGGGT"	"Cyst.PC-CD"
"GGTGTTATCGCGGACT"	"PEC"
"GGTTAACAGGTCGTAG"	"Mac/DC"
"GGTTAACAGGTTGAGC"	"Cyst.CD"
"GGTTAACCAGCGCGTT"	"Cyst.IM-CD"
"GGTTAACGTCTTGTCC"	"PEC"
"GGTTAACGTGCTCTCT"	"Cyst.PC-CD"
"GGTTAACTCACGGTCG"	"Cyst.PC-CD"
"GGTTAACTCCTTCTGG"	"B-cell_1"
"GGTTAACTCGCGTCGA"	"Cyst.IC-A_1"
"GGTTAACTCTGCTGAA"	"Cyst.IM-CD"
"GGTTCTCAGGAGCTGT"	"Cyst.IM-CD"
"GGTTCTCCAACCGACC"	"Cyst.cTAL"
"GGTTCTCCATCCGTTC"	"Cyst.PC-CD"
"GGTTCTCCATTGAAGA"	"PEC"
"GGTTCTCGTACCACGC"	"Podocytes"
"GGTTCTCGTGCTTATG"	"T-cell"
"GGTTCTCGTTTCGTAG"	"PEC"
"GGTTGTAAGTGGTTCT"	"Podocytes"
"GGTTGTACAAGTGCAG"	"Cyst.PT_1"
"GGTTGTATCCGACATA"	"Cyst.IC-A_1"
"GTAACACAGATGGTAT"	"VSMC"
"GTAACACAGCAAATCA"	"Mast-cell"
"GTAACACAGGCAGTCA"	"Cyst.PC-CD"
"GTAACACTCTGAATGC"	"Podocytes"
"GTAACACTCTTGTGCC"	"Cyst.PC-CD"
"GTAACCAAGACGACTG"	"Cyst.IM-CD"
"GTAACCACAAGCTGCC"	"EC"
"GTAACCACATCAGCGC"	"Podocytes"
"GTAACCACATTGAGCT"	"Cyst.cTAL"
"GTAACCATCTCACGAA"	"Cyst.PC-CD"
"GTAAGTCAGCGTTACT"	"Cyst.PC-CD"
"GTAAGTCCAATACCCA"	"Cyst.CD"
"GTAAGTCCAGACCAGA"	"Podocytes"
"GTAAGTCGTAGATCGG"	"Cyst.PC-CD"
"GTAAGTCGTCGCACAC"	"Cyst.PC-CD"
"GTAAGTCGTGGCATCC"	"PEC"
"GTAAGTCGTGGTCTCG"	"Cyst.IC-A_2"
"GTAAGTCGTTGCCAAT"	"Podocytes"
"GTAAGTCTCTGTGCAA"	"Cyst.IC-A_1"
"GTAATCGAGTAAGCAT"	"Podocytes"
"GTAATCGGTCAACATC"	"Cyst.PC-CD"
"GTAATCGGTTCGTTCC"	"Cyst.IC-A_2"
"GTAATCGTCCGTTGGG"	"Cyst.IC-A_1"
"GTAATCGTCTGGTCAA"	"PEC"
"GTAATCGTCTGTGCAA"	"Cyst.CD"
"GTAATGCAGAATCCCT"	"Cyst.PT_1"
"GTAATGCAGTCCGTCG"	"Cyst.IC-A_2"
"GTAATGCAGTCTGCAT"	"Cyst.CD"
"GTAATGCCATTGACAC"	"Cyst.PC-CD"
"GTAATGCCATTGACCA"	"Cyst.CD"
"GTAATGCGTCCACACG"	"B-cell_1"
"GTAATGCGTCCTCCAT"	"Cyst.PC-CD"
"GTAATGCTCCATACAG"	"Cyst.PC-CD"
"GTAATGCTCGAACCTA"	"PEC"
"GTAATGCTCTCTCGAC"	"Cyst.PC-CD"
"GTAATGCTCTTCCCGA"	"Cyst.IC-A_2"
"GTACAACAGCAGTAAT"	"Mac/DC"
"GTACAACCATTCATCT"	"Cyst.PC-CD"
"GTACAACGTGCATGAG"	"Cyst.PC-CD"
"GTACAACGTGGATCAG"	"Cyst.cTAL"
"GTACAACTCCTTGGAA"	"Cyst.PC-CD"
"GTACAGTCAAATGAAC"	"Cyst.PC-CD"
"GTACAGTCAAGTCCAT"	"PEC"
"GTACAGTCAATTGGTC"	"EC"
"GTACAGTCACGCGCAT"	"Cyst.IM-CD"
"GTACAGTGTACTCGTA"	"B-cell_2"
"GTACAGTGTAGCACAG"	"PEC"
"GTACAGTGTTTACTTC"	"Cyst.IM-CD"
"GTACAGTTCGCTATTT"	"Cyst.PC-CD"
"GTAGAAACAGAAACCG"	"Cyst.IC-A_1"
"GTAGAAAGTAGTCACT"	"Cyst.cTAL"
"GTAGAAAGTGAGTCAG"	"Cyst.PC-CD"
"GTAGAAAGTGGATACG"	"Cyst.PC-CD"
"GTAGAAATCCATTGGA"	"PEC"
"GTAGAAATCGATCCAA"	"T-cell"
"GTAGAAATCGGTCTGG"	"Mast-cell"
"GTAGAGGCACCAACAT"	"Cyst.PC-CD"
"GTAGAGGCACCAGACC"	"Cyst.PC-CD"
"GTAGAGGGTCAAGGCA"	"PEC"
"GTAGAGGGTGTTACTG"	"Podocytes"
"GTAGATCAGAGATCGC"	"Cyst.PC-CD"
"GTAGATCAGAGTGAAG"	"PEC"
"GTAGATCAGCCTCTTC"	"Cyst.IM-CD"
"GTAGATCAGGAACTAT"	"Cyst.CD"
"GTAGATCAGTCGTTAC"	"Cyst.PC-CD"
"GTAGATCCAATTGCTG"	"Cyst.PC-CD"
"GTAGATCGTCTGGTTA"	"VSMC"
"GTAGATCGTGCTCTTC"	"PEC"
"GTAGATCTCCGTGCGA"	"Cyst.PT_1"
"GTAGCTAAGGAAGTCC"	"Cyst.IC-A_1"
"GTAGCTAGTATATGGA"	"Podocytes"
"GTAGCTAGTCGAACAG"	"Cyst.PC-CD"
"GTAGCTAGTGGAGAAA"	"VSMC"
"GTAGCTAGTTTCGACA"	"T-cell"
"GTAGCTATCCGCTAGG"	"Mac/DC"
"GTAGGAGAGAGCCCAA"	"Cyst.IC-A_1"
"GTAGGAGAGTTGCGCC"	"Cyst.IC-A_2"
"GTAGGAGCAGCAGTGA"	"Cyst.PC-CD"
"GTAGGAGCATTGACCA"	"Podocytes"
"GTAGGAGGTACGCGTC"	"Mast-cell"
"GTAGGAGGTCGATTAC"	"Cyst.PC-CD"
"GTAGGAGTCCGTAGGC"	"Cyst.PC-CD"
"GTAGGAGTCGACGACC"	"Cyst.PC-CD"
"GTAGGAGTCTGGCCTT"	"Cyst.IC-A_2"
"GTAGGTTAGCGTCTCG"	"VSMC"
"GTAGGTTAGGTCGTAG"	"Cyst.PC-CD"
"GTAGGTTCAAGTCATC"	"Cyst.PC-CD"
"GTAGGTTCAGAGGTTG"	"Mast-cell"
"GTAGGTTGTCAGCTTA"	"Podocytes"
"GTAGGTTGTCCCTCAT"	"PEC"
"GTAGGTTGTGGGAGAG"	"Cyst.IC-A_2"
"GTAGGTTTCGAAGCCC"	"Cyst.PC-CD"
"GTAGTACAGTTCCTGA"	"Cyst.IM-CD"
"GTAGTACCACGACGCT"	"Cyst.IM-CD"
"GTAGTACGTACCTGTA"	"Cyst.IC-A_2"
"GTAGTACGTGCAGTGA"	"Cyst.PC-CD"
"GTAGTACGTGCATTTG"	"Cyst.IC-A_2"
"GTAGTACTCACAACCA"	"Cyst.cTAL"
"GTATTGGAGCAGCCCT"	"PEC"
"GTATTGGCAACGCCCA"	"Cyst.IC-A_2"
"GTATTGGCACTTTATC"	"Cyst.IM-CD"
"GTATTGGTCAAACCTG"	"Podocytes"
"GTATTGGTCCATCTAT"	"Cyst.IM-CD"
"GTATTGGTCGAATGCT"	"Cyst.IM-CD"
"GTATTTCAGTGGATTA"	"Cyst.PC-CD"
"GTATTTCCAAGGCGTA"	"Cyst.IC-A_1"
"GTATTTCCATGATGCT"	"Cyst.IC-A_2"
"GTATTTCGTCACGACC"	"T-cell"
"GTATTTCGTTCGAAGG"	"Cyst.PC-CD"
"GTATTTCGTTCTCACC"	"Cyst.IM-CD"
"GTATTTCTCAGGAGAC"	"Cyst.IM-CD"
"GTATTTCTCCGTACGG"	"Cyst.PC-CD"
"GTATTTCTCGCCGAAC"	"Cyst.IC-A_1"
"GTATTTCTCTCACTCG"	"Cyst.PC-CD"
"GTATTTCTCTCCTACG"	"Cyst.PC-CD"
"GTCAAACAGACGGTTG"	"Mast-cell"
"GTCAAACCACGATTCA"	"Podocytes"
"GTCAAACCAGTCTGGC"	"Podocytes"
"GTCAAACGTATTTCCT"	"Cyst.cTAL"
"GTCAAACGTTGCGGAA"	"Cyst.IM-CD"
"GTCAAACTCCATCTCG"	"PEC"
"GTCAAACTCGATACAC"	"Cyst.IC-A_2"
"GTCAAGTAGCTACTGT"	"Cyst.IM-CD"
"GTCAAGTAGCTTTGTG"	"Cyst.CD"
"GTCAAGTTCATTCACT"	"PEC"
"GTCAAGTTCTTTCTAG"	"Mast-cell"
"GTCACGGAGCACCTGC"	"Cyst.PT_2"
"GTCACGGAGTCATAGA"	"Cyst.IC-A_1"
"GTCACGGCATCGCCTT"	"Cyst.PC-CD"
"GTCACGGGTAGCTTTG"	"Cyst.PC-CD"
"GTCACGGGTAGGCTGA"	"Cyst.cTAL"
"GTCACGGGTTCCTTGC"	"Cyst.PC-CD"
"GTCACGGTCACCCTGT"	"Cyst.PC-CD"
"GTCACGGTCGGACGTC"	"Cyst.IM-CD"
"GTCACTCAGGACACTG"	"PEC"
"GTCACTCAGGCATTTC"	"Cyst.IC-A_2"
"GTCACTCTCCGACAGC"	"Cyst.PC-CD"
"GTCACTCTCGAACCTA"	"Mac/DC"
"GTCAGCGAGAAACCAT"	"Cyst.IM-CD"
"GTCAGCGAGAGTTCGG"	"Cyst.cTAL"
"GTCAGCGCAACTCATG"	"PEC"
"GTCAGCGGTAACTAAG"	"Cyst.IM-CD"
"GTCAGCGTCAGAACCT"	"Cyst.CD"
"GTCATCCCACGTCGGT"	"Cyst.IM-CD"
"GTCATCCGTGAGTGAC"	"Cyst.PC-CD"
"GTCATCCGTTTGATCG"	"Podocytes"
"GTCATCCTCCATTGCC"	"T-cell"
"GTCATGAAGTCATGCT"	"PEC"
"GTCATGACACAAGGTG"	"Podocytes"
"GTCATGACAGAGGGTT"	"T-cell"
"GTCATGACAGCACACC"	"Cyst.cTAL"
"GTCATGAGTAACAGGC"	"Mast-cell"
"GTCATGAGTCGCCACA"	"Cyst.IC-A_2"
"GTCATGAGTGATTAGA"	"Podocytes"
"GTCATGAGTGCCTAAT"	"PEC"
"GTCATGATCCATCTCG"	"Cyst.CD"
"GTCATGATCCTCTTTC"	"Cyst.cTAL"
"GTCATTTAGAGACAAG"	"Cyst.PC-CD"
"GTCATTTGTATCCCAA"	"B-cell_1"
"GTCATTTGTCTTCAAG"	"Cyst.IC-A_1"
"GTCATTTTCAGGGATG"	"Cyst.PT_2"
"GTCATTTTCCGCACTT"	"Cyst.IC-A_1"
"GTCATTTTCCTACAAG"	"Cyst.cTAL"
"GTCCACTAGCACTCGC"	"Cyst.IM-CD"
"GTCCACTCAATTGAAG"	"B-cell_1"
"GTCCACTCACGAGAAC"	"Podocytes"
"GTCCACTCAGGCATGA"	"Cyst.IC-A_2"
"GTCCACTGTGGCACTC"	"PEC"
"GTCCACTGTTGCGGCT"	"PEC"
"GTCCACTTCGACATAC"	"Cyst.PC-CD"
"GTCCCATAGGACACTG"	"EC"
"GTCCCATCAATCCTAG"	"Cyst.IC-A_2"
"GTCCCATCAATTCTTC"	"Cyst.PC-CD"
"GTCCCATCACGGCCAT"	"Cyst.PC-CD"
"GTCCCATTCTCACGAA"	"Cyst.PC-CD"
"GTCCTCAAGGTACCTT"	"Cyst.PC-CD"
"GTCCTCACAACCTAAC"	"Cyst.PC-CD"
"GTCCTCACATGGGTTT"	"Cyst.IC-A_1"
"GTCCTCACATTCATCT"	"EC"
"GTCGAATAGATAACAC"	"Cyst.IC-A_1"
"GTCGAATAGCCTCAGC"	"Cyst.PC-CD"
"GTCGAATCATATTCGG"	"Cyst.IM-CD"
"GTCGAATGTATGAAGT"	"Podocytes"
"GTCGAATGTCACCCTT"	"PEC"
"GTCGAATGTGATTAGA"	"Cyst.cTAL"
"GTCGAATGTTGTTGCA"	"Cyst.PC-CD"
"GTCGAATTCCTGATAG"	"Cyst.IM-CD"
"GTCGCGAAGCCGCTTG"	"VSMC"
"GTCGCGAAGTAATACG"	"Cyst.PC-CD"
"GTCGCGACAACCAGAG"	"T-cell"
"GTCGCGAGTCAGACTT"	"PEC"
"GTCGCGAGTTCAAACC"	"B-cell_2"
"GTCGCGATCGAACTCA"	"PEC"
"GTCGCGATCGCAACAT"	"Cyst.PC-CD"
"GTCGCGATCGCACGGT"	"VSMC"
"GTCGCGATCGCGCTGA"	"Cyst.PC-CD"
"GTCGTAAAGGGCGAGA"	"EC"
"GTCGTAAAGTGTAGTA"	"Cyst.IC-A_1"
"GTCGTAACATAAGCGG"	"EC"
"GTCGTAACATATGCGT"	"PEC"
"GTCGTAAGTATGCGTT"	"Cyst.PC-CD"
"GTCGTAAGTCACAATC"	"PEC"
"GTCGTAAGTCTAGGTT"	"VSMC"
"GTCGTAAGTGTTTGCA"	"T-cell"
"GTCGTAAGTTCGGCCA"	"T-cell"
"GTCGTTCAGACCAACG"	"Cyst.IC-A_1"
"GTCGTTCGTGCTGCAC"	"Cyst.PC-CD"
"GTCGTTCTCCGAAGGA"	"PEC"
"GTCGTTCTCGTGGAAG"	"Cyst.PC-CD"
"GTCGTTCTCTTCCAGC"	"Cyst.PC-CD"
"GTCTACCAGCATGATA"	"Cyst.IC-A_1"
"GTCTACCCATCTGTTT"	"Cyst.CD"
"GTCTACCGTACCTAGT"	"Cyst.cTAL"
"GTCTACCTCAGGAAAT"	"Mac/DC"
"GTCTACCTCCAGGACC"	"Mast-cell"
"GTCTAGAAGACTGAGC"	"PEC"
"GTCTAGACATGATAGA"	"EC"
"GTCTAGAGTAAGTCAA"	"Cyst.IM-CD"
"GTCTAGAGTTGTACGT"	"Cyst.PC-CD"
"GTCTAGATCACTTGGA"	"Podocytes"
"GTCTAGATCTCCGTGT"	"EC"
"GTCTCACCAAGGTACG"	"Cyst.IM-CD"
"GTCTCACCAGCAAGAC"	"Mast-cell"
"GTCTCACGTAGAGATT"	"EC"
"GTCTCACGTTCGGTCG"	"Podocytes"
"GTCTCACTCAATCTCT"	"Cyst.IM-CD"
"GTCTCACTCGTAATGC"	"Cyst.PC-CD"
"GTCTCACTCTTCTAAC"	"Cyst.PC-CD"
"GTCTGTCAGGTTTACC"	"Cyst.PC-CD"
"GTCTGTCAGTCCTACA"	"Cyst.IC-A_2"
"GTCTGTCAGTGCCGAA"	"PEC"
"GTCTGTCCACCGCTAG"	"Cyst.IC-A_1"
"GTCTGTCGTACTCAAC"	"Cyst.PC-CD"
"GTCTGTCTCTGAGTCA"	"PEC"
"GTCTTTAAGGGAGAAT"	"Cyst.PC-CD"
"GTCTTTACACAGTCGC"	"Podocytes"
"GTCTTTACATCTAACG"	"Cyst.PC-CD"
"GTCTTTAGTCCTTAAG"	"Cyst.IC-A_2"
"GTCTTTATCGCTTAAG"	"Cyst.IC-A_1"
"GTCTTTATCGTCTCAC"	"Podocytes"
"GTGACGCCATCTTAGG"	"Cyst.PT_2"
"GTGACGCTCCCATTTA"	"Cyst.IC-A_2"
"GTGACGCTCGGTGCAC"	"EC"
"GTGAGCCGTCATGCAT"	"Cyst.IM-CD"
"GTGAGCCTCACCTCAC"	"Cyst.cTAL"
"GTGAGCCTCTTCGTAT"	"VSMC"
"GTGAGGAAGAAATCCA"	"Podocytes"
"GTGAGGACAAACTAAG"	"Cyst.PC-CD"
"GTGAGGACAAGTGTCT"	"PEC"
"GTGAGGAGTACGTGTT"	"Cyst.IM-CD"
"GTGAGGAGTCCCTCAT"	"Cyst.PC-CD"
"GTGAGGAGTCTGTGCG"	"Cyst.PT_2"
"GTGAGGATCATCACCC"	"Cyst.cTAL"
"GTGAGTTCAACGCCCA"	"Cyst.IM-CD"
"GTGAGTTTCGCATGAT"	"VSMC"
"GTGAGTTTCGTAGGGA"	"Cyst.PC-CD"
"GTGAGTTTCGTCACCT"	"PEC"
"GTGAGTTTCTACGGGC"	"Podocytes"
"GTGATGTAGTGGCGAT"	"Cyst.PT_1"
"GTGATGTCAACTGCTA"	"Cyst.IM-CD"
"GTGATGTGTATAGGGC"	"Podocytes"
"GTGATGTGTGATTCTG"	"Cyst.IC-A_1"
"GTGATGTTCAGATTGC"	"VSMC"
"GTGATGTTCATCGTAG"	"Podocytes"
"GTGATGTTCCTGTTGC"	"PEC"
"GTGATGTTCTACGGGC"	"Cyst.IC-A_1"
"GTGATGTTCTATACGG"	"Cyst.IC-A_1"
"GTGATGTTCTTAGCCC"	"PEC"
"GTGCACGAGTCGAGGT"	"VSMC"
"GTGCACGCAGGACGAT"	"Cyst.CD"
"GTGCACGGTCCCGCAA"	"Cyst.IC-A_2"
"GTGCACGGTGAATAAC"	"VSMC"
"GTGCAGCAGACTCCGC"	"Cyst.IM-CD"
"GTGCAGCGTAACACCT"	"Podocytes"
"GTGCAGCGTCAGACGA"	"Mac/DC"
"GTGCAGCGTCGGTACC"	"Cyst.PC-CD"
"GTGCAGCTCCTCGATC"	"PEC"
"GTGCAGCTCGACCCAG"	"Cyst.PC-CD"
"GTGCGTGAGCCGAATG"	"PEC"
"GTGCGTGCAATACCCA"	"PEC"
"GTGCGTGCATCCTCAC"	"Cyst.IC-A_2"
"GTGCGTGGTATATGGA"	"Cyst.PT_2"
"GTGCGTGGTGGATCAG"	"Cyst.PC-CD"
"GTGCGTGGTTCGTTCC"	"Cyst.IM-CD"
"GTGCGTGTCAAAGACA"	"Cyst.IM-CD"
"GTGCGTGTCGTGGGAA"	"B-cell_2"
"GTGCGTGTCGTGTGAT"	"PEC"
"GTGCTGGAGGATAATC"	"VSMC"
"GTGCTGGAGGCTATCT"	"Cyst.IM-CD"
"GTGCTGGCAGAGAGGG"	"Cyst.IC-A_1"
"GTGCTGGGTAGTTACC"	"Podocytes"
"GTGCTGGGTGGGCTTC"	"Cyst.IM-CD"
"GTGCTGGGTGTCCCTT"	"EC"
"GTGCTGGGTGTTAACC"	"Podocytes"
"GTGCTTCAGCACAAAT"	"Cyst.IM-CD"
"GTGCTTCAGCTAGATA"	"Mast-cell"
"GTGCTTCAGCTTAGTC"	"EC"
"GTGCTTCAGTGCCGAA"	"PEC"
"GTGCTTCCAAAGCTAA"	"Mac/DC"
"GTGCTTCCAATTCGTG"	"Cyst.IC-A_1"
"GTGCTTCCACGCAAAG"	"Cyst.PT_1"
"GTGCTTCGTCATACCA"	"Cyst.cTAL"
"GTGCTTCTCAAACCTG"	"Cyst.IM-CD"
"GTGCTTCTCCGTATAG"	"Cyst.PC-CD"
"GTGGAAGAGAAATCCA"	"Cyst.IC-A_2"
"GTGGAAGCAAATCAGA"	"Cyst.cTAL"
"GTGGAAGCAGAGAGGG"	"Cyst.IM-CD"
"GTGGAAGTCTCAAAGC"	"Cyst.IC-A_1"
"GTGGAGAAGGGCAAGG"	"VSMC"
"GTGGAGACAAGCACCC"	"Cyst.PC-CD"
"GTGGAGACATCGCTAA"	"Cyst.IC-A_1"
"GTGGAGACATGGGATG"	"Cyst.IM-CD"
"GTGGAGAGTAGTGTGG"	"EC"
"GTGGAGAGTTCCGTTC"	"Cyst.PC-CD"
"GTGGAGATCCGCAACG"	"Cyst.PC-CD"
"GTGGAGATCTGCATGA"	"Cyst.cTAL"
"GTGGCGTAGTCATTGC"	"Cyst.IM-CD"
"GTGGCGTCATAAGCGG"	"EC"
"GTGGCGTGTCGCGTCA"	"Cyst.IM-CD"
"GTGGCGTTCCAAGCCG"	"Cyst.IC-A_2"
"GTGGGAAAGGCACTAG"	"Cyst.IM-CD"
"GTGGGAAAGGGCTGAT"	"T-cell"
"GTGGGAAAGTTGAATG"	"Cyst.PC-CD"
"GTGGGAACAACGATCT"	"Cyst.PC-CD"
"GTGGGAACACCCAATA"	"Cyst.IM-CD"
"GTGGGAACACGGCCAT"	"Cyst.cTAL"
"GTGGGAAGTCCACTTC"	"Podocytes"
"GTGGGAAGTCGTCAGC"	"Cyst.cTAL"
"GTGGGAATCAAGCCCG"	"Cyst.IM-CD"
"GTGGGAATCTGGGCGT"	"Cyst.PC-CD"
"GTGGTTACAATAGTCC"	"EC"
"GTGGTTAGTGATTAGA"	"Cyst.PC-CD"
"GTGGTTAGTGGTCCCA"	"T-cell"
"GTGGTTATCATTTCCA"	"Cyst.PC-CD"
"GTGGTTATCCTCTAAT"	"Cyst.CD"
"GTGGTTATCGCATGAT"	"Cyst.PC-CD"
"GTGTAACAGCCATGCC"	"Mac/DC"
"GTGTAACAGGTAGGCT"	"Cyst.cTAL"
"GTGTAACAGTCAAGCG"	"PEC"
"GTGTAACAGTCATAGA"	"Cyst.cTAL"
"GTGTAACCAACAAGTA"	"Cyst.IM-CD"
"GTGTAACCAATTGTGC"	"PEC"
"GTGTAACCATGGTACT"	"Cyst.PC-CD"
"GTGTAACCATGTCTAG"	"Cyst.IM-CD"
"GTGTAACGTGTTATCG"	"Cyst.IC-A_1"
"GTGTCCTAGACTCAAA"	"Cyst.IC-A_1"
"GTGTCCTAGATGGGCT"	"B-cell_2"
"GTGTCCTAGCCTCCAG"	"VSMC"
"GTGTCCTGTGCGTTTA"	"Cyst.PC-CD"
"GTGTGATAGCGATGAC"	"Cyst.PC-CD"
"GTGTGATAGTTAGTAG"	"Cyst.cTAL"
"GTGTGATCAATAGTAG"	"Cyst.cTAL"
"GTGTGATGTTGCGAAG"	"Cyst.PC-CD"
"GTGTGATTCCATGCAA"	"Cyst.IC-A_1"
"GTGTGGCAGCCTCTTC"	"Cyst.cTAL"
"GTGTGGCCAACCGTAT"	"Cyst.PC-CD"
"GTGTGGCCAGTTGTCA"	"Mast-cell"
"GTGTGGCCATGAGTAA"	"Cyst.IC-A_1"
"GTGTGGCGTACTGCCG"	"Cyst.IC-A_1"
"GTGTGGCGTCGCTCGA"	"Podocytes"
"GTGTGGCGTCTGCGCA"	"Podocytes"
"GTGTGGCTCTCGAACA"	"Cyst.PC-CD"
"GTGTTAGCAATCGTCA"	"PEC"
"GTGTTAGCATGACGTT"	"T-cell"
"GTGTTAGGTATCCTTT"	"Cyst.IM-CD"
"GTGTTAGGTGGAATGC"	"Mac/DC"
"GTGTTAGTCGACATTG"	"Cyst.PC-CD"
"GTGTTAGTCGCTGATA"	"Cyst.IM-CD"
"GTGTTCCAGAGTTGCG"	"Cyst.PC-CD"
"GTGTTCCAGTAGTCTC"	"Podocytes"
"GTGTTCCGTATACCCA"	"Cyst.PC-CD"
"GTGTTCCTCCACTAGA"	"VSMC"
"GTGTTCCTCCTTCAGC"	"Cyst.IC-A_2"
"GTGTTCCTCGCTAGCG"	"PEC"
"GTTACAGAGCAAATGT"	"T-cell"
"GTTACAGCAATCGAAA"	"Cyst.IC-A_1"
"GTTACAGCATACAGGG"	"Cyst.PC-CD"
"GTTACCCAGAGCCGAT"	"Cyst.IC-A_2"
"GTTACCCAGTTGGCGA"	"Cyst.IM-CD"
"GTTACCCCACTATCCC"	"Cyst.PC-CD"
"GTTACCCCAGTCAGCC"	"VSMC"
"GTTACCCCATCCAACA"	"PEC"
"GTTACCCGTAGGATAT"	"Cyst.CD"
"GTTACCCGTAGTTAGA"	"Cyst.CD"
"GTTACCCGTATCTCGA"	"Mac/DC"
"GTTACCCTCGTGGCTG"	"PEC"
"GTTACGAAGATGCTGG"	"Cyst.PC-CD"
"GTTACGAAGCTCGCAC"	"VSMC"
"GTTACGAAGTTTCGGT"	"Podocytes"
"GTTACGACAGGTGACA"	"Podocytes"
"GTTACGACATACAGCT"	"PEC"
"GTTACGATCACCATAG"	"Cyst.PC-CD"
"GTTACGATCCAGCACG"	"Cyst.IM-CD"
"GTTAGACAGAGCCGTA"	"PEC"
"GTTAGACAGCTGGTGA"	"Cyst.IM-CD"
"GTTAGACAGGTCACAG"	"Cyst.PC-CD"
"GTTAGACAGGTTATAG"	"VSMC"
"GTTAGACCAGTAGGAC"	"T-cell"
"GTTAGACGTAAGGTCG"	"VSMC"
"GTTAGACTCACTTGTT"	"Cyst.IM-CD"
"GTTAGACTCCTTGAAG"	"PEC"
"GTTAGTGCAGGGAATC"	"Cyst.PC-CD"
"GTTAGTGGTCGTGTTA"	"PEC"
"GTTAGTGGTGGCTTGC"	"Cyst.IM-CD"
"GTTAGTGGTTAAACCC"	"Mast-cell"
"GTTAGTGTCCAGTGCG"	"VSMC"
"GTTAGTGTCCGACAGC"	"Cyst.IC-A_1"
"GTTATGGAGACAACAT"	"Cyst.IC-A_2"
"GTTATGGAGGACGCTA"	"Cyst.PC-CD"
"GTTATGGAGGTACTGG"	"VSMC"
"GTTATGGCACGGATCC"	"Cyst.PC-CD"
"GTTATGGCACGTAGTT"	"Cyst.IC-A_2"
"GTTATGGCAGACCATT"	"Cyst.IC-A_1"
"GTTATGGCAGCAGACA"	"Cyst.PC-CD"
"GTTATGGCAGGAACCA"	"Cyst.IM-CD"
"GTTATGGCATATCGGT"	"T-cell"
"GTTATGGGTAGACAAT"	"Cyst.cTAL"
"GTTATGGTCTCATAGG"	"PEC"
"GTTCATTCAAGAGTTA"	"Cyst.PC-CD"
"GTTCATTCAGAGTTCT"	"Cyst.IM-CD"
"GTTCATTCAGGTTCCG"	"Cyst.cTAL"
"GTTCATTGTAATGCGG"	"Mac/DC"
"GTTCATTGTATGAAGT"	"Cyst.IM-CD"
"GTTCATTTCCGTTGGG"	"Cyst.CD"
"GTTCCGTAGCCGGAAT"	"PEC"
"GTTCCGTCACTTCATT"	"Cyst.IM-CD"
"GTTCCGTGTAATGATG"	"Cyst.cTAL"
"GTTCCGTGTCGAGCAA"	"EC"
"GTTCCGTTCCAGCTCT"	"Cyst.IM-CD"
"GTTCCGTTCGCTTACC"	"Cyst.IM-CD"
"GTTCGCTAGCTATCCA"	"Cyst.PC-CD"
"GTTCGCTAGTGAGGCT"	"PEC"
"GTTCGCTCACAAGCAG"	"Cyst.IC-A_1"
"GTTCGCTCAGACACCC"	"Cyst.PC-CD"
"GTTCGCTCAGCTTTCC"	"Podocytes"
"GTTCGCTCAGTTAGGG"	"PEC"
"GTTCGCTGTCACTCGG"	"Cyst.PC-CD"
"GTTCGCTGTTCAGTAC"	"Cyst.IM-CD"
"GTTCTATAGCTCGTGC"	"Cyst.IC-A_2"
"GTTCTATAGGCCCACT"	"Cyst.IM-CD"
"GTTCTATCACAACCGC"	"Cyst.IC-A_1"
"GTTCTATCATCCGAGC"	"Podocytes"
"GTTCTATTCCTATTGT"	"Cyst.IC-A_1"
"GTTCTATTCTGACCCT"	"Mast-cell"
"GTTGAACAGGTTTACC"	"Podocytes"
"GTTGAACCAACCCGCA"	"PEC"
"GTTGAACCACAGTACT"	"PEC"
"GTTGAACTCAGAGCGA"	"Cyst.CD"
"GTTGAACTCCGTGACG"	"Cyst.PC-CD"
"GTTGAACTCCTTCAGC"	"Cyst.IC-A_1"
"GTTGCGGAGCTAAATG"	"Cyst.IC-A_1"
"GTTGCGGAGGGAGTTC"	"PEC"
"GTTGCGGAGGGTGGGA"	"Cyst.cTAL"
"GTTGCGGCACTGAATC"	"Podocytes"
"GTTGCGGGTATGAGCG"	"Cyst.PC-CD"
"GTTGCGGGTTTCCAAG"	"Cyst.IC-A_2"
"GTTGCGGTCTACACAG"	"EC"
"GTTGCGGTCTCGACGG"	"Mast-cell"
"GTTGCTCAGGTAGCAC"	"Cyst.PC-CD"
"GTTGCTCCAAGGATGC"	"Cyst.IM-CD"
"GTTGCTCCAGCGTAGA"	"Mast-cell"
"GTTGCTCCAGGCTATT"	"Cyst.PT_1"
"GTTGTAGAGGCTCCCA"	"Cyst.IM-CD"
"GTTGTAGAGTACGAGC"	"VSMC"
"GTTGTAGAGTGATTCC"	"VSMC"
"GTTGTAGCACGCAGTC"	"PEC"
"GTTGTAGGTATGGTTC"	"Cyst.cTAL"
"GTTGTAGGTGTCACAT"	"Podocytes"
"GTTGTAGTCATTTCGT"	"Cyst.PC-CD"
"GTTGTCCAGCATCTTG"	"PEC"
"GTTGTCCCAGTCTTCC"	"Cyst.IC-A_1"
"GTTGTCCGTTTCGCTC"	"Cyst.cTAL"
"GTTGTGAAGGGACCAT"	"Cyst.PC-CD"
"GTTGTGAAGTATGAAC"	"Podocytes"
"GTTGTGACACCAAATC"	"Cyst.PT_2"
"GTTGTGAGTCCTGTCT"	"Mac/DC"
"GTTGTGATCACTGAAC"	"Cyst.PC-CD"
"GTTGTGATCATTGCTT"	"Cyst.CD"
"GTTTACTAGGTAGCCA"	"Cyst.PC-CD"
"GTTTACTCAAAGGATT"	"Cyst.PC-CD"
"GTTTACTCACCGTACG"	"Cyst.IC-A_2"
"GTTTACTCATTCTCTA"	"Cyst.IM-CD"
"GTTTACTGTGGCAACA"	"Podocytes"
"GTTTACTTCAGGAACG"	"Cyst.PC-CD"
"GTTTACTTCATTTGGG"	"Cyst.IC-A_2"
"GTTTACTTCCTGTTGC"	"Cyst.PC-CD"
"GTTTACTTCGAACACT"	"Cyst.PC-CD"
"GTTTACTTCGCCCAGA"	"VSMC"
"GTTTACTTCGTCAGAT"	"Podocytes"
"GTTTGGAAGAAACTAC"	"Cyst.PC-CD"
"GTTTGGAAGCTAAGTA"	"Cyst.PC-CD"
"GTTTGGAAGGATTTGA"	"Mac/DC"
"GTTTGGACAAACGGCA"	"Cyst.IM-CD"
"GTTTGGACACACAGAG"	"Mast-cell"
"GTTTGGACACTTACAG"	"Cyst.IM-CD"
"GTTTGGACAGAAGTTA"	"Cyst.PC-CD"
"GTTTGGAGTACCCGCA"	"EC"
"GTTTGGATCCACTAGA"	"Cyst.PT_1"
"TAACACGAGACTCCGC"	"T-cell"
"TAACACGAGAGTGACC"	"PEC"
"TAACACGAGGGTTGCA"	"Cyst.IM-CD"
"TAACACGCAGAAATCA"	"Cyst.IC-A_2"
"TAACACGGTGCAGGAT"	"Cyst.IM-CD"
"TAACACGGTTCTCTAT"	"Cyst.IM-CD"
"TAACACGTCGTCAAAC"	"Podocytes"
"TAACCAGAGAAGGGAT"	"PEC"
"TAACCAGAGAGTATAC"	"PEC"
"TAACCAGAGGAGATAG"	"Cyst.cTAL"
"TAACCAGCAAGCGATG"	"Cyst.PC-CD"
"TAACCAGGTACATACC"	"Cyst.PC-CD"
"TAACCAGGTACCTAGT"	"EC"
"TAACCAGTCGCGCCAA"	"PEC"
"TAACGACAGCGTCGAA"	"PEC"
"TAACGACAGTGATAGT"	"Cyst.IM-CD"
"TAACGACCACAAGCCC"	"Cyst.cTAL"
"TAACGACCACCATAAC"	"PEC"
"TAACGACCACGACGTC"	"Cyst.IM-CD"
"TAACGACCACTGGCCA"	"Cyst.IC-A_2"
"TAACGACGTGTGTTTG"	"Podocytes"
"TAACGACTCTTCCACG"	"PEC"
"TAACTTCAGATCCGAG"	"Cyst.IM-CD"
"TAACTTCAGGCGATAC"	"PEC"
"TAACTTCCAACCGTGC"	"B-cell_2"
"TAACTTCTCTAGTTCT"	"Cyst.cTAL"
"TAAGCACAGGATGGCT"	"Cyst.PT_1"
"TAAGCACAGGCCCACT"	"Podocytes"
"TAAGCACAGGTGCGAT"	"PEC"
"TAAGCACGTTCGAAGG"	"Mast-cell"
"TAAGCACTCAAGCCCG"	"Cyst.PC-CD"
"TAAGCACTCAGATTGC"	"Cyst.cTAL"
"TAAGCCAAGGAGCAAA"	"Cyst.PC-CD"
"TAAGCCAAGGGACTGT"	"Cyst.PC-CD"
"TAAGCCAAGTCGCCCA"	"PEC"
"TAAGCCAGTACGACTT"	"Cyst.PC-CD"
"TAAGCCAGTCGTTTCC"	"PEC"
"TAAGCGTAGAGTATAC"	"Cyst.IC-A_1"
"TAAGCGTAGATGATTG"	"EC"
"TAAGCGTAGCAGAAAG"	"Mac/DC"
"TAAGCGTAGCGCGTTC"	"Cyst.PC-CD"
"TAAGCGTAGCTGGCTC"	"Cyst.PC-CD"
"TAAGCGTAGGACTGGT"	"Cyst.PC-CD"
"TAAGCGTCATCACAGT"	"Cyst.IM-CD"
"TAAGCGTGTGCCCACA"	"VSMC"
"TAAGCGTGTGCCGTAC"	"Podocytes"
"TAAGCGTGTGTCTTAG"	"Cyst.CD"
"TAAGTCGAGCTCCGAC"	"Cyst.cTAL"
"TAAGTCGAGGTAAACT"	"Cyst.PC-CD"
"TAAGTCGAGTCCCGAC"	"Cyst.PC-CD"
"TAAGTCGCAAATGAAC"	"Cyst.IM-CD"
"TAAGTCGCAGCTATTG"	"EC"
"TAAGTCGGTGTTGATC"	"Mast-cell"
"TAAGTCGGTTCAAAGA"	"Cyst.PC-CD"
"TAATCTCAGTCCTGTA"	"Mac/DC"
"TAATCTCCAAAGAACT"	"EC"
"TAATCTCCATACAGCT"	"Cyst.PC-CD"
"TAATCTCCATCCGTTC"	"VSMC"
"TAATTCCCACAGCCAC"	"PEC"
"TAATTCCGTCGTCTCT"	"Cyst.IM-CD"
"TAATTCCTCAGAGCGA"	"Podocytes"
"TAATTCCTCCACACAA"	"T-cell"
"TAATTCCTCGTGTGGC"	"Cyst.IM-CD"
"TAATTCCTCTAATTCC"	"Cyst.IM-CD"
"TACAACGCATGGGAAC"	"Cyst.cTAL"
"TACAACGGTCCTGTCT"	"Cyst.PC-CD"
"TACAACGGTGACAGGT"	"Cyst.IC-A_2"
"TACACCCCAAGACAAT"	"Cyst.IM-CD"
"TACACCCCATTCTCTA"	"Cyst.IC-A_2"
"TACACCCGTTGGCCGT"	"Mac/DC"
"TACACCCTCCTACCGT"	"PEC"
"TACACCCTCTCCGAGG"	"Cyst.PC-CD"
"TACAGGTAGCGTTCCG"	"Cyst.PC-CD"
"TACAGGTCACTAGGTT"	"PEC"
"TACAGGTCATGTTTGG"	"Podocytes"
"TACAGGTGTACAGAGC"	"Cyst.IM-CD"
"TACAGGTGTCCTATAG"	"Cyst.PC-CD"
"TACAGGTTCATCTACT"	"Cyst.PC-CD"
"TACAGGTTCGTTCTCG"	"PEC"
"TACAGGTTCTCAACGA"	"PEC"
"TACATTCAGAGATGCC"	"Cyst.IM-CD"
"TACATTCAGGAATTAC"	"PEC"
"TACATTCCAAGACGGT"	"PEC"
"TACATTCCACAGCTGC"	"T-cell"
"TACATTCGTAACCAGG"	"Cyst.PC-CD"
"TACATTCGTTAAGGAT"	"Mast-cell"
"TACATTCTCGTTCTGC"	"Podocytes"
"TACATTCTCTAACGCA"	"Cyst.IC-A_2"
"TACCCACCAAGGCGTA"	"Cyst.PT_1"
"TACCCACCACAAGTTC"	"Cyst.IM-CD"
"TACCCACCACGGCTAC"	"Cyst.PC-CD"
"TACCCACCAGTGGCTC"	"Cyst.cTAL"
"TACCCACGTAACTAAG"	"Cyst.PC-CD"
"TACCCACGTACACTCA"	"Cyst.PC-CD"
"TACCCACGTACATACC"	"Cyst.IM-CD"
"TACCCACTCGAGAGAC"	"Cyst.IC-A_1"
"TACCCGTAGCTGCCTG"	"PEC"
"TACCCGTAGTGCGCTC"	"Cyst.IM-CD"
"TACCCGTGTCGTATTG"	"Cyst.CD"
"TACCCGTGTGAGTTTC"	"Cyst.IC-A_2"
"TACCCGTGTTTAGTCG"	"Cyst.IM-CD"
"TACCGAACAGGACGAT"	"VSMC"
"TACCGAAGTTGGAGGT"	"Cyst.PC-CD"
"TACCGAAGTTTGACAC"	"Mac/DC"
"TACCGAATCTTCGTAT"	"Cyst.PC-CD"
"TACCGGGAGCTGACCC"	"Cyst.IC-A_1"
"TACCGGGAGTAAGCAT"	"B-cell_1"
"TACCGGGCAAAGACTA"	"VSMC"
"TACCGGGCAGTGTGCC"	"Cyst.IC-A_1"
"TACCGGGGTCTTGTCC"	"Cyst.IM-CD"
"TACCGGGGTGAGATTA"	"Cyst.IM-CD"
"TACCGGGTCCGCTAGG"	"Cyst.IC-A_1"
"TACCTCGCACTACTTT"	"Cyst.PC-CD"
"TACCTCGCAGGGCTTC"	"Cyst.PC-CD"
"TACCTCGCATTGTAGC"	"Cyst.IC-A_2"
"TACCTCGGTAACGGTG"	"PEC"
"TACCTCGGTATCGTAC"	"Podocytes"
"TACCTCGGTTAAGACA"	"Cyst.IM-CD"
"TACCTGCAGGTCGCCT"	"Cyst.cTAL"
"TACCTGCAGGTTCATC"	"T-cell"
"TACCTGCCAAAGACGC"	"Cyst.CD"
"TACCTGCCACGGCCAT"	"Cyst.PC-CD"
"TACCTGCCACTGCACG"	"Cyst.PT_1"
"TACCTGCCATCGTGGC"	"PEC"
"TACCTGCGTATACCTG"	"Cyst.PC-CD"
"TACCTGCGTCTAACGT"	"Cyst.IM-CD"
"TACCTGCTCGAGAGCA"	"Podocytes"
"TACGCTCCAAGTTGGG"	"Cyst.PC-CD"
"TACGCTCCACCCTGTT"	"Podocytes"
"TACGCTCGTATGAGGC"	"Cyst.PC-CD"
"TACGCTCGTGACAGCA"	"Cyst.IM-CD"
"TACGCTCGTGAGGATC"	"PEC"
"TACGCTCTCACTCCGT"	"Podocytes"
"TACGCTCTCCGGTAGC"	"Mast-cell"
"TACGCTCTCCTCACCA"	"Cyst.cTAL"
"TACGGGCAGGCTAGCA"	"Cyst.CD"
"TACGGGCAGTCGAAAT"	"Cyst.IM-CD"
"TACGGGCAGTGGCGAT"	"VSMC"
"TACGGGCAGTTGCTGT"	"Mac/DC"
"TACGGGCCACCCTCTA"	"Cyst.PC-CD"
"TACGGGCGTAGACGGT"	"Cyst.IC-A_2"
"TACGGGCGTATCGATC"	"Cyst.IC-A_1"
"TACGGGCGTCCATAGT"	"Podocytes"
"TACGGGCTCAAGGCTT"	"PEC"
"TACGGGCTCACTCGAA"	"PEC"
"TACGGTAAGATCACCT"	"Cyst.PC-CD"
"TACGGTACAACAGATA"	"Cyst.cTAL"
"TACGGTACATCGCTGG"	"B-cell_1"
"TACGGTATCATCTACT"	"EC"
"TACGGTATCGAAATCC"	"Cyst.PC-CD"
"TACGGTATCGTTTACT"	"Cyst.cTAL"
"TACGTCCAGCCATATC"	"Cyst.PC-CD"
"TACGTCCAGCTCTGTA"	"Podocytes"
"TACGTCCAGGCTTAAA"	"Cyst.PC-CD"
"TACGTCCAGTCATCCA"	"Cyst.PC-CD"
"TACGTCCGTAGACGTG"	"Cyst.cTAL"
"TACGTCCGTCGTTCAA"	"Podocytes"
"TACTGCCCAGGGACTA"	"Cyst.IM-CD"
"TACTGCCCATTCCTAT"	"Cyst.IM-CD"
"TACTGCCGTAACGATA"	"Cyst.IC-A_2"
"TACTGCCGTTCTAACG"	"Cyst.IC-A_2"
"TACTTACAGCAAGGAA"	"Cyst.PC-CD"
"TACTTACAGCGAGGAG"	"Cyst.PC-CD"
"TACTTACAGCGAGTCA"	"PEC"
"TACTTACAGGCTAGCA"	"T-cell"
"TACTTACAGGTCTACT"	"Cyst.IM-CD"
"TACTTACCACGCCAGT"	"Cyst.PT_1"
"TACTTACCATACCAGT"	"Podocytes"
"TACTTACCATGATGCT"	"B-cell_1"
"TACTTACGTCTGATCA"	"Cyst.PC-CD"
"TACTTACGTGGACCTC"	"Cyst.PC-CD"
"TACTTACGTTAAGAAC"	"Cyst.PC-CD"
"TACTTACGTTTACCAG"	"Cyst.PC-CD"
"TACTTACTCCTAGAGT"	"Cyst.PC-CD"
"TACTTCAAGTCAACAA"	"Podocytes"
"TACTTCACAGATTCGT"	"EC"
"TACTTCACAGGTTCGC"	"Cyst.PT_1"
"TACTTGTAGGTATAGT"	"Podocytes"
"TACTTGTAGTCAGGGT"	"Cyst.PC-CD"
"TACTTGTCATCCGAGC"	"EC"
"TACTTGTTCGACGTCG"	"VSMC"
"TACTTGTTCTAGTGAC"	"Cyst.IM-CD"
"TACTTGTTCTCGTTTA"	"Cyst.IM-CD"
"TACTTGTTCTTGATTC"	"Cyst.PC-CD"
"TAGACCAAGACTGTTC"	"Podocytes"
"TAGACCAAGGTGAGAA"	"Cyst.IC-A_1"
"TAGACCAGTAACGGTG"	"PEC"
"TAGACCAGTCTGTGAT"	"PEC"
"TAGACCAGTGCGTTTA"	"VSMC"
"TAGACCATCACCGCTT"	"T-cell"
"TAGACCATCTACGCGG"	"PEC"
"TAGACTGAGGAACGAA"	"B-cell_1"
"TAGACTGAGTCTTGGT"	"PEC"
"TAGACTGCAACCTAAC"	"PEC"
"TAGACTGCAAGGTCAG"	"Cyst.PC-CD"
"TAGACTGCACAACGCC"	"B-cell_1"
"TAGACTGCACAGACGA"	"Cyst.cTAL"
"TAGACTGCATCATTTC"	"Cyst.IM-CD"
"TAGACTGGTATCGGTT"	"Cyst.PC-CD"
"TAGACTGGTTCTCGCT"	"B-cell_1"
"TAGACTGTCGTTCAGA"	"Cyst.PT_1"
"TAGAGTCAGACCTCAT"	"Cyst.IM-CD"
"TAGAGTCCAATAGTGA"	"Cyst.IC-A_1"
"TAGAGTCCACGTCGGT"	"Cyst.IM-CD"
"TAGAGTCGTCTCTCAC"	"Cyst.cTAL"
"TAGATCGAGTTGAATG"	"Cyst.PT_1"
"TAGATCGGTGTTCAGT"	"T-cell"
"TAGATCGTCAACCTCC"	"Cyst.PC-CD"
"TAGATCGTCTCAACGA"	"Mast-cell"
"TAGCACAAGGTCATAA"	"Podocytes"
"TAGCACAGTTATAGAG"	"Cyst.PT_2"
"TAGCACATCAAGGAGC"	"PEC"
"TAGGAGGCATCGAACT"	"Podocytes"
"TAGGAGGGTACGAGTG"	"B-cell_1"
"TAGGAGGTCATACAGC"	"Mast-cell"
"TAGGAGGTCGAGTGAG"	"Cyst.PT_1"
"TAGGGTTAGTTAGAAC"	"EC"
"TAGGGTTCAGGACATG"	"Cyst.PC-CD"
"TAGGGTTGTATGAAAC"	"Cyst.PC-CD"
"TAGGGTTGTGAGCGAT"	"Cyst.IM-CD"
"TAGGGTTGTTCGTAAC"	"Podocytes"
"TAGGGTTTCAAGATAG"	"Podocytes"
"TAGGTACAGAAACACT"	"PEC"
"TAGGTACAGCGTTCCG"	"Podocytes"
"TAGGTACCAAACGGCA"	"Cyst.IM-CD"
"TAGGTACTCACGAGGA"	"Cyst.PC-CD"
"TAGGTTGAGGGAGTTC"	"Cyst.cTAL"
"TAGGTTGTCCAAGCTA"	"Cyst.cTAL"
"TAGGTTGTCGTCGATA"	"Cyst.IM-CD"
"TAGTGCAAGCAGGGAG"	"B-cell_2"
"TAGTGCAAGGAGGCAG"	"Cyst.PT_1"
"TAGTGCAAGGTCGTAG"	"PEC"
"TAGTGCAAGTCACACT"	"PEC"
"TAGTGCACACCTGCAG"	"Podocytes"
"TATACCTAGCTTTGTG"	"Cyst.PC-CD"
"TATACCTCAGCGATTT"	"Cyst.PT_1"
"TATACCTCAGGCATGA"	"VSMC"
"TATACCTCATGACCCG"	"Cyst.IC-A_2"
"TATACCTGTGAACGGT"	"Cyst.PC-CD"
"TATACCTGTGACTGTT"	"Cyst.PC-CD"
"TATACCTGTGAGATCG"	"Cyst.PC-CD"
"TATACCTGTGATAGAT"	"B-cell_2"
"TATACCTTCATGACAC"	"PEC"
"TATACCTTCCATAGGT"	"Cyst.PC-CD"
"TATACCTTCCTAGCCT"	"Mac/DC"
"TATATCCGTGTTACAC"	"VSMC"
"TATATCCTCCCAAGCG"	"Cyst.PT_2"
"TATCAGGAGGATTACA"	"Cyst.IC-A_2"
"TATCAGGCACGCGTGT"	"Podocytes"
"TATCAGGTCATTACGG"	"PEC"
"TATCCTACACAACGTT"	"Cyst.IC-A_2"
"TATCCTACACAAGGTG"	"Cyst.PC-CD"
"TATCCTAGTTCAAGGG"	"PEC"
"TATCCTATCCTACCGT"	"Mac/DC"
"TATCCTATCGCTAATG"	"T-cell"
"TATCGCCAGCAGAAAG"	"VSMC"
"TATCGCCAGTTCTACG"	"PEC"
"TATCGCCCAACTTGCA"	"Cyst.cTAL"
"TATCGCCCATTAGGCT"	"Cyst.cTAL"
"TATCGCCGTTAAACCC"	"Podocytes"
"TATCGCCTCGCTTACC"	"B-cell_1"
"TATCTGTAGGCTAAAT"	"PEC"
"TATCTGTCAATTAGGA"	"PEC"
"TATCTGTCAGTCGTTA"	"EC"
"TATCTGTCATGACAGG"	"Cyst.cTAL"
"TATCTGTGTTGCAACT"	"T-cell"
"TATCTGTGTTGCTAGT"	"Cyst.cTAL"
"TATCTTGAGCATGTTC"	"Cyst.cTAL"
"TATCTTGAGCGCCGTT"	"Cyst.IM-CD"
"TATCTTGCAAATAAGC"	"Cyst.PC-CD"
"TATCTTGCAACTTCTT"	"Cyst.IM-CD"
"TATCTTGGTTGCCGAC"	"Cyst.PC-CD"
"TATCTTGTCAGAACCT"	"Cyst.PC-CD"
"TATGTTCCACACACTA"	"Cyst.PC-CD"
"TATGTTCCAGCGGTCT"	"Cyst.PC-CD"
"TATGTTCGTATACCCA"	"Cyst.PT_1"
"TATGTTCGTGGATTTC"	"Podocytes"
"TATGTTCGTTAATGAG"	"Cyst.IM-CD"
"TATGTTCTCCATGCAA"	"Cyst.PC-CD"
"TATGTTCTCCGTGTAA"	"PEC"
"TATTCCAAGATGGGCT"	"T-cell"
"TATTCCAAGCCTGACC"	"Cyst.PC-CD"
"TATTCCAAGTGAGGTC"	"B-cell_2"
"TATTCCACATACCATG"	"Podocytes"
"TATTCCAGTACGATCT"	"Cyst.cTAL"
"TATTCCAGTCCACTTC"	"Podocytes"
"TATTCCAGTGATGAAT"	"Cyst.PC-CD"
"TATTCCAGTTGATGTC"	"VSMC"
"TATTCCATCAAGTGTC"	"EC"
"TATTCCATCTATTCGT"	"Cyst.PC-CD"
"TATTCCATCTTCCAGC"	"Podocytes"
"TATTGCTAGAACGCGT"	"Podocytes"
"TATTGCTAGGACATCG"	"Mast-cell"
"TATTGCTAGTCACTGT"	"Cyst.CD"
"TATTGCTCAAAGCACG"	"Cyst.IC-A_2"
"TATTGCTCACAGTGTT"	"PEC"
"TATTGCTCACCAAATC"	"Cyst.IM-CD"
"TATTGCTCAGTAGTGG"	"Cyst.IC-A_1"
"TATTGCTGTTTCAGAC"	"Cyst.IM-CD"
"TATTGGGAGGGAGATA"	"Mast-cell"
"TATTGGGAGGGTTAGC"	"Podocytes"
"TATTGGGAGGTCTTTG"	"Cyst.PT_2"
"TATTGGGCAATACAGA"	"PEC"
"TATTGGGCATTCGATG"	"Cyst.IC-A_1"
"TATTGGGGTGGATGAC"	"Cyst.IC-A_1"
"TATTGGGGTTGTCATG"	"Podocytes"
"TATTGGGTCGCCGATG"	"Cyst.IM-CD"
"TATTTCGAGGGCCAAT"	"Cyst.PC-CD"
"TATTTCGCAAGGCAAC"	"Cyst.PC-CD"
"TATTTCGCAGCATGCC"	"Cyst.PC-CD"
"TATTTCGCAGCTATTG"	"Cyst.PC-CD"
"TATTTCGCATCGCTCT"	"Cyst.PC-CD"
"TATTTCGCATGTTTGG"	"Cyst.IM-CD"
"TATTTCGGTATCACGT"	"Cyst.IM-CD"
"TATTTCGGTGAACGGT"	"Cyst.IC-A_2"
"TATTTCGTCAACTTTC"	"Cyst.IC-A_2"
"TATTTCGTCCGAGCTG"	"Cyst.IM-CD"
"TATTTCGTCTACCTTA"	"Cyst.IM-CD"
"TATTTCGTCTAGGAAA"	"Cyst.cTAL"
"TATTTCGTCTCTGACC"	"Podocytes"
"TATTTCGTCTGGGTCG"	"Cyst.IC-A_1"
"TCAAGACAGAACGTGC"	"Cyst.PC-CD"
"TCAAGACAGCTAAGTA"	"Cyst.IM-CD"
"TCAAGACAGGAGAATG"	"Cyst.IM-CD"
"TCAAGACAGGTAAGTT"	"Cyst.IC-A_1"
"TCAAGACAGTGCTAGG"	"Cyst.PC-CD"
"TCAAGACAGTGGAATT"	"VSMC"
"TCAAGACCAACCCTCT"	"Mac/DC"
"TCAAGACCATGACGGA"	"Cyst.IC-A_1"
"TCAAGACGTTAATCGC"	"Cyst.IM-CD"
"TCAAGACTCCTTATCA"	"Mac/DC"
"TCAAGACTCTAGTCAG"	"Cyst.PC-CD"
"TCAAGCACAATGTTGC"	"PEC"
"TCAAGCACACCTTCGT"	"Cyst.PC-CD"
"TCAAGCACAGTCCGTG"	"Cyst.IM-CD"
"TCAAGCAGTCCGTTTC"	"Cyst.PC-CD"
"TCAAGCAGTCGTTATG"	"Cyst.IM-CD"
"TCAAGCATCAAGGCTT"	"Cyst.PC-CD"
"TCAAGTGAGAGCCTGA"	"Cyst.IC-A_2"
"TCAAGTGAGGATCACG"	"Cyst.PC-CD"
"TCAAGTGAGTAAGGGA"	"Cyst.cTAL"
"TCAAGTGAGTTGGAAT"	"VSMC"
"TCAAGTGCATCCGGTG"	"Cyst.IM-CD"
"TCAAGTGCATCTATCT"	"Cyst.PT_2"
"TCAAGTGGTAAGGTCG"	"Cyst.PC-CD"
"TCAAGTGGTCTACAGT"	"Cyst.IC-A_2"
"TCAAGTGGTTCGTAAC"	"Cyst.PC-CD"
"TCAAGTGTCCAGGACC"	"Cyst.PC-CD"
"TCAATCTAGCCTTTGA"	"Mac/DC"
"TCAATCTAGGTCGCCT"	"Podocytes"
"TCAATCTCAAGACGGT"	"B-cell_2"
"TCAATCTGTTGTTTGG"	"PEC"
"TCAATCTGTTTGTTCT"	"Cyst.IC-A_1"
"TCAATCTTCCGTTGGG"	"PEC"
"TCAATCTTCGAGTGAG"	"EC"
"TCAATTCAGCCGGATA"	"PEC"
"TCAATTCAGGACACTG"	"Cyst.PC-CD"
"TCAATTCGTCGAGCAA"	"Cyst.IM-CD"
"TCAATTCGTCTGGTTA"	"Cyst.IM-CD"
"TCAATTCGTTTGAACC"	"PEC"
"TCACAAGCACACCTTC"	"Cyst.IM-CD"
"TCACAAGCAGTGACCC"	"PEC"
"TCACAAGCATTCAGGT"	"Cyst.PC-CD"
"TCACAAGCATTCTCCG"	"Cyst.IC-A_1"
"TCACAAGGTGATACCT"	"Podocytes"
"TCACAAGGTGCATTAC"	"Podocytes"
"TCACAAGGTGTGTCGC"	"Cyst.CD"
"TCACAAGTCATTACGG"	"Cyst.IM-CD"
"TCACAAGTCCCGAGTG"	"Cyst.PC-CD"
"TCACAAGTCGACGACC"	"Cyst.PC-CD"
"TCACACCCAACTTGGT"	"Cyst.PC-CD"
"TCACACCGTCCCAAAT"	"Cyst.PT_2"
"TCACACCGTCTTAGTG"	"Cyst.PC-CD"
"TCACACCTCGCAATGT"	"Cyst.PC-CD"
"TCACATTAGTAAAGCT"	"Cyst.PC-CD"
"TCACATTAGTGCACTT"	"VSMC"
"TCACATTAGTGGTGAC"	"B-cell_1"
"TCACATTGTCAATGGG"	"T-cell"
"TCACATTGTCGCATTA"	"Cyst.PC-CD"
"TCACATTGTGAGCCAA"	"Cyst.IC-A_2"
"TCACGCTAGAGTGTTA"	"Cyst.PT_1"
"TCACGCTAGCATCAAA"	"Cyst.IC-A_1"
"TCACGCTGTATTAAGG"	"VSMC"
"TCACGCTGTTAGAAAC"	"Cyst.PC-CD"
"TCACGCTGTTGGCCGT"	"EC"
"TCACGGGAGACTCGAG"	"Cyst.PC-CD"
"TCACGGGAGCGACTGA"	"Podocytes"
"TCACGGGCAAAGGAGA"	"T-cell"
"TCACGGGCAACGTTAC"	"PEC"
"TCACGGGCACGTAACT"	"Cyst.PC-CD"
"TCACGGGCAGCACGAA"	"PEC"
"TCACGGGCATGGTGGA"	"Podocytes"
"TCACGGGGTAGCCCTG"	"Cyst.IM-CD"
"TCACGGGGTCATAGTC"	"Cyst.IM-CD"
"TCACGGGGTCATGCAT"	"Cyst.PC-CD"
"TCACGGGTCAAGAGTA"	"Cyst.PC-CD"
"TCACGGGTCCTTACCG"	"VSMC"
"TCACGGGTCGGTATGT"	"Cyst.PC-CD"
"TCACTATAGACAACTA"	"Podocytes"
"TCACTATGTATCAAGA"	"B-cell_1"
"TCACTATGTCTTTATC"	"Cyst.PC-CD"
"TCACTATTCCTCATAT"	"Cyst.cTAL"
"TCACTCGCACGGTGCT"	"Cyst.PC-CD"
"TCACTCGGTACACGCC"	"Podocytes"
"TCACTCGTCCTAGCGG"	"B-cell_2"
"TCACTCGTCTTACACT"	"Podocytes"
"TCAGCAAAGCTATCTG"	"Podocytes"
"TCAGCAAGTATGCAAA"	"Cyst.PC-CD"
"TCAGCAAGTCCAAATC"	"Cyst.PC-CD"
"TCAGCAAGTCGGTAAG"	"EC"
"TCAGCAATCGGACGTC"	"Cyst.PT_2"
"TCAGCCTAGTCATGCT"	"EC"
"TCAGCCTAGTCGAATA"	"Mac/DC"
"TCAGCCTCAAGGCCTC"	"Cyst.IC-A_2"
"TCAGCCTCACCTGATA"	"Cyst.IM-CD"
"TCAGCCTCACCTTCCA"	"Cyst.PC-CD"
"TCAGCCTGTAGTTACC"	"Cyst.PC-CD"
"TCAGCCTGTGGCATCC"	"Cyst.PC-CD"
"TCAGCCTGTTAATGAG"	"Cyst.IC-A_1"
"TCAGCCTGTTACCCAA"	"EC"
"TCAGCCTTCATAGACC"	"PEC"
"TCAGCCTTCGTCGACG"	"B-cell_1"
"TCAGGGCAGACGAGCT"	"Cyst.cTAL"
"TCAGGGCCAAGATCCT"	"Mac/DC"
"TCAGGGCCAGCTCGGT"	"Cyst.PC-CD"
"TCAGGGCGTTGCGGAA"	"Cyst.PC-CD"
"TCAGGGCTCGCTCATC"	"Cyst.PC-CD"
"TCAGGGCTCTCGTGAA"	"EC"
"TCAGGGCTCTGTGCTC"	"Mast-cell"
"TCAGGTAAGCGGTATG"	"Cyst.cTAL"
"TCAGGTAAGGCTAAAT"	"Cyst.PC-CD"
"TCAGGTAAGGTCTGGA"	"Cyst.PC-CD"
"TCAGGTACAAGGTCAG"	"Podocytes"
"TCAGGTACACGGCTAC"	"Cyst.IM-CD"
"TCAGGTACAGAGTTGG"	"Mac/DC"
"TCAGGTAGTCTGTGCG"	"Cyst.PT_1"
"TCAGGTAGTGATACAA"	"PEC"
"TCAGGTATCACGTAGT"	"Mast-cell"
"TCAGGTATCGGAAACG"	"Cyst.IM-CD"
"TCAGTCCAGGACCCAA"	"PEC"
"TCAGTCCCAAGCGATG"	"Podocytes"
"TCAGTCCCACGCGTGT"	"Cyst.IM-CD"
"TCAGTCCCAGTCGGTC"	"Cyst.PC-CD"
"TCAGTCCCATACCACA"	"PEC"
"TCAGTCCGTCTGTGCG"	"Cyst.PC-CD"
"TCAGTGACAAAGCACG"	"T-cell"
"TCAGTGAGTGATAGAT"	"Cyst.PC-CD"
"TCAGTGATCCCAGGAC"	"Cyst.IM-CD"
"TCAGTGATCCGGGACT"	"PEC"
"TCAGTTTAGAGAGCGG"	"Cyst.cTAL"
"TCAGTTTAGCCAACCC"	"B-cell_2"
"TCAGTTTAGTTTGTCG"	"Mac/DC"
"TCAGTTTCAGAGGTAC"	"Cyst.IM-CD"
"TCAGTTTCAGGTTTAC"	"Cyst.PC-CD"
"TCAGTTTGTAACAGGC"	"Mac/DC"
"TCAGTTTGTCGTAATC"	"Cyst.PC-CD"
"TCAGTTTTCCGTAGTA"	"Cyst.IM-CD"
"TCAGTTTTCGCTGACG"	"Cyst.PC-CD"
"TCAGTTTTCTGCCTCA"	"Cyst.IC-A_1"
"TCATACTCACCCTTAC"	"Cyst.IC-A_2"
"TCATACTCAGTAACGG"	"Cyst.IC-A_2"
"TCATACTGTGAATAAC"	"Cyst.PC-CD"
"TCATACTTCGCATGAT"	"PEC"
"TCATATCGTAAGTTAG"	"Cyst.IC-A_1"
"TCATATCGTATCGCTA"	"Podocytes"
"TCATATCGTGTGCTTA"	"PEC"
"TCATCATAGGATTCCT"	"Cyst.IC-A_2"
"TCATCATAGTTGTACC"	"Cyst.PC-CD"
"TCATCATCAAGGCTTT"	"PEC"
"TCATCATCATAGAGGC"	"T-cell"
"TCATCATGTCCTACGG"	"Cyst.IM-CD"
"TCATCATGTCGTTGCG"	"Cyst.IM-CD"
"TCATCATTCATTTCGT"	"Cyst.IC-A_2"
"TCATCATTCCACCTGT"	"Cyst.CD"
"TCATCATTCGTCGACG"	"Cyst.IC-A_1"
"TCATCCGAGCCTATTG"	"VSMC"
"TCATCCGAGTGCACTT"	"Mac/DC"
"TCATCCGCACCGGCTA"	"PEC"
"TCATCCGCAGTCTGGC"	"VSMC"
"TCATCCGCATCATTTC"	"EC"
"TCATCCGCATGGAGAC"	"Cyst.cTAL"
"TCATCCGGTGTAAATG"	"Cyst.IC-A_2"
"TCATCCGTCAGTGATC"	"Cyst.PC-CD"
"TCATGAGAGACGTCCC"	"Cyst.PC-CD"
"TCATGAGAGCTGACAG"	"Cyst.IM-CD"
"TCATGAGGTGTCTTGA"	"PEC"
"TCATGAGGTTCCTTGC"	"Cyst.IM-CD"
"TCATGCCAGTGCACCC"	"Cyst.PC-CD"
"TCATGCCGTCTAACTG"	"Cyst.IM-CD"
"TCATGCCGTGCCTGAC"	"Cyst.IM-CD"
"TCATGCCGTGGACCTC"	"Cyst.cTAL"
"TCATGCCTCAGCGGAA"	"Cyst.IM-CD"
"TCATGCCTCCCAAGTA"	"Cyst.IM-CD"
"TCATGCCTCGAGCCAC"	"Cyst.IC-A_1"
"TCATGCCTCTCATGGA"	"Cyst.PC-CD"
"TCATGGAAGATGTTCC"	"Cyst.PC-CD"
"TCATGGATCAATCCGA"	"Cyst.IM-CD"
"TCATGTTCAAGGGCAT"	"VSMC"
"TCATGTTCAGAGTGAC"	"T-cell"
"TCATGTTGTCGATTTG"	"Cyst.IM-CD"
"TCATGTTGTGAAAGTT"	"Mac/DC"
"TCATGTTTCAGCCTCT"	"Cyst.IC-A_1"
"TCATTACAGAATACAC"	"Cyst.IC-A_2"
"TCATTACAGCTGTGCC"	"Cyst.PC-CD"
"TCATTACAGTGTTGTC"	"Podocytes"
"TCATTACAGTTCCAGT"	"Cyst.IC-A_1"
"TCATTACCATGACAGG"	"Cyst.IM-CD"
"TCATTACTCGACATAC"	"Cyst.IM-CD"
"TCATTCAAGATTACCC"	"VSMC"
"TCATTCAAGCACTTTG"	"T-cell"
"TCATTCAAGTGCCAGA"	"Cyst.PC-CD"
"TCATTCACAAAGGGCT"	"Cyst.PC-CD"
"TCATTCATCCACTAGA"	"Podocytes"
"TCATTGTCAGTAACAA"	"Cyst.IM-CD"
"TCATTGTCAGTCTACA"	"Cyst.IM-CD"
"TCATTGTGTGAATTGA"	"Cyst.IM-CD"
"TCATTGTTCCCGTGAG"	"PEC"
"TCATTTGAGATCGACG"	"Mac/DC"
"TCATTTGAGGTTAGTA"	"Cyst.cTAL"
"TCATTTGGTTCGGTTA"	"Cyst.PC-CD"
"TCATTTGGTTTGATCG"	"PEC"
"TCATTTGTCAAGGCTT"	"Cyst.PC-CD"
"TCATTTGTCACTTGTT"	"PEC"
"TCATTTGTCCTCATAT"	"Cyst.IC-A_1"
"TCCACCAAGCACAAAT"	"Cyst.PC-CD"
"TCCACCAGTAACATGA"	"Cyst.PC-CD"
"TCCACCATCAACTACG"	"Mast-cell"
"TCCACCATCAAGGACG"	"Cyst.PC-CD"
"TCCACCATCGTGGGTC"	"Cyst.PC-CD"
"TCCACGTAGCTGTTAC"	"Cyst.IC-A_2"
"TCCACGTCAACACACT"	"Cyst.PC-CD"
"TCCACGTCATCTTAGG"	"EC"
"TCCACGTGTCTGGTTA"	"Cyst.PC-CD"
"TCCAGAAAGATGCAGC"	"T-cell"
"TCCAGAACAGGTGGAT"	"Cyst.PC-CD"
"TCCAGAAGTCGTGGTC"	"Cyst.PC-CD"
"TCCAGAAGTTTAGACC"	"Podocytes"
"TCCAGAATCTGTACAG"	"EC"
"TCCATCGCATTGTCGA"	"Cyst.PT_1"
"TCCATCGTCGCATTGA"	"PEC"
"TCCATGCAGACTAGAT"	"Cyst.IC-A_2"
"TCCATGCAGATACGAT"	"Cyst.cTAL"
"TCCATGCAGTCGAAGC"	"Cyst.IC-A_1"
"TCCATGCGTGTCTTAG"	"Cyst.PC-CD"
"TCCATGCGTTAGAAGT"	"Cyst.PC-CD"
"TCCCACAAGTGTAGAT"	"Cyst.IM-CD"
"TCCCACAGTGGGACAT"	"Cyst.PC-CD"
"TCCCACATCACAGAGG"	"Cyst.PC-CD"
"TCCCACATCCCTCGTA"	"VSMC"
"TCCCACATCCCTTTGG"	"Cyst.PC-CD"
"TCCCACATCCTCACGT"	"Cyst.IC-A_1"
"TCCCAGTCACCTTCGT"	"Cyst.PC-CD"
"TCCCAGTCACGAGGTA"	"Cyst.IC-A_1"
"TCCCAGTCATAAGATG"	"Cyst.IM-CD"
"TCCCAGTGTAGCACAG"	"Cyst.IM-CD"
"TCCCAGTGTCATAACC"	"VSMC"
"TCCCAGTGTGCGTCGT"	"Cyst.IM-CD"
"TCCCAGTGTTCGTACA"	"Cyst.PC-CD"
"TCCCAGTTCATCACCC"	"Cyst.IC-A_1"
"TCCCAGTTCGAACACT"	"PEC"
"TCCCAGTTCGGACCAC"	"PEC"
"TCCCAGTTCTACCAGA"	"Cyst.IM-CD"
"TCCCATGAGCGAATGC"	"Cyst.IM-CD"
"TCCCATGAGTCACTAC"	"Cyst.PC-CD"
"TCCCATGCAACCAACT"	"Cyst.PC-CD"
"TCCCATGCAGGTCCGT"	"Cyst.PC-CD"
"TCCCATGCATAGCTGT"	"Cyst.PC-CD"
"TCCCATGTCAAAGAAC"	"Cyst.PC-CD"
"TCCCATGTCAAGTAAG"	"Podocytes"
"TCCGAAAAGCTCACTA"	"Cyst.CD"
"TCCGAAAAGTTTGTCG"	"Cyst.PC-CD"
"TCCGAAACATTCGGGC"	"Cyst.IC-A_2"
"TCCGAAAGTTTAAGGA"	"Cyst.PC-CD"
"TCCGAAATCCTACTGC"	"Cyst.IC-A_2"
"TCCGAAATCGACGAGA"	"Cyst.IC-A_1"
"TCCGATCAGATCGACG"	"Cyst.IC-A_1"
"TCCGATCAGGCCTTGC"	"PEC"
"TCCGATCAGGTAACTA"	"EC"
"TCCGATCAGTGATCGG"	"Cyst.IC-A_2"
"TCCGATCTCTCCGCAT"	"Cyst.PC-CD"
"TCCGGGAAGATGGTCG"	"PEC"
"TCCGGGAAGGCCTTCG"	"Mac/DC"
"TCCGGGAGTGGCTGCT"	"Cyst.IC-A_2"
"TCCGTGTCAATTGTGC"	"Cyst.IM-CD"
"TCCGTGTGTACTGACT"	"EC"
"TCCGTGTGTGAGACGT"	"Cyst.PC-CD"
"TCCGTGTGTGCCCTTT"	"T-cell"
"TCCGTGTGTTGCCGAC"	"Cyst.cTAL"
"TCCGTGTTCAAACGAA"	"Podocytes"
"TCCGTGTTCAGCTTCC"	"T-cell"
"TCCGTGTTCTACCACC"	"Cyst.CD"
"TCCTAATAGAACAAGG"	"Cyst.PC-CD"
"TCCTAATAGAGAGCGG"	"VSMC"
"TCCTAATAGCCATCCG"	"Cyst.IM-CD"
"TCCTAATAGGTACTGG"	"Cyst.CD"
"TCCTAATAGTAAGAGG"	"Cyst.IC-A_1"
"TCCTAATCAACCGATT"	"Cyst.PC-CD"
"TCCTAATCAGTTGTCA"	"Podocytes"
"TCCTAATGTCAGACTT"	"Cyst.IC-A_2"
"TCCTAATGTGACGCCT"	"Cyst.cTAL"
"TCCTAATTCCCTTGTG"	"PEC"
"TCCTAATTCCTCAGGG"	"Cyst.IM-CD"
"TCCTAATTCGATGCTA"	"Cyst.IC-A_2"
"TCCTCCCAGAAGCTGC"	"Cyst.PC-CD"
"TCCTCCCAGCACCGTC"	"VSMC"
"TCCTCCCAGTCAGAGC"	"Podocytes"
"TCCTCCCCAATAAGGT"	"Cyst.PC-CD"
"TCCTCCCGTAGACACG"	"Cyst.IC-A_1"
"TCCTCCCGTTACTCAG"	"Cyst.PC-CD"
"TCCTCCCTCTAGCCTC"	"Cyst.PC-CD"
"TCCTCCCTCTTACCGC"	"VSMC"
"TCCTCGAAGTGCCGAA"	"Cyst.IC-A_1"
"TCCTCGACAACGCCCA"	"Cyst.cTAL"
"TCCTCGACAGGTCAAG"	"PEC"
"TCCTCGACATCAGCAT"	"PEC"
"TCCTCGATCCTGGGAC"	"Cyst.IM-CD"
"TCCTCGATCTTCTGGC"	"VSMC"
"TCCTCTTAGACCAAAT"	"Cyst.PC-CD"
"TCCTCTTAGGAAAGGT"	"PEC"
"TCCTCTTCACTTCAAG"	"Cyst.cTAL"
"TCCTCTTCACTTCCTG"	"Cyst.PC-CD"
"TCCTCTTCAGAAGTGC"	"Cyst.PC-CD"
"TCCTCTTGTGAGACCA"	"Cyst.CD"
"TCCTCTTTCAGGCGAA"	"Cyst.PC-CD"
"TCCTCTTTCTAGGCCG"	"B-cell_2"
"TCCTCTTTCTGTGCGG"	"VSMC"
"TCCTGCACAAGACTGG"	"PEC"
"TCCTGCACATATGAAG"	"Cyst.PC-CD"
"TCCTGCACATTGAAAG"	"Cyst.PC-CD"
"TCCTGCAGTGTCTTAG"	"T-cell"
"TCCTGCAGTTGACTGT"	"Cyst.PC-CD"
"TCCTGCATCGATCCCT"	"Cyst.PC-CD"
"TCCTTCTAGCGAGGAG"	"Podocytes"
"TCCTTCTAGGCTGAAC"	"Cyst.IC-A_2"
"TCCTTCTAGTAGCATA"	"Cyst.PC-CD"
"TCCTTCTGTAGGTAGC"	"Cyst.cTAL"
"TCCTTCTGTTGAATCC"	"Cyst.cTAL"
"TCCTTCTTCCTAAGTG"	"PEC"
"TCCTTTCAGATTGAGT"	"Cyst.IC-A_1"
"TCCTTTCAGTGACCTT"	"Cyst.IM-CD"
"TCCTTTCGTCAAATCC"	"Cyst.IC-A_1"
"TCCTTTCGTCTCGGGT"	"Cyst.PC-CD"
"TCCTTTCGTGGAGGTT"	"Cyst.cTAL"
"TCCTTTCGTGGCAACA"	"Cyst.PC-CD"
"TCCTTTCTCACGGGCT"	"Podocytes"
"TCCTTTCTCAGACAAA"	"Cyst.IC-A_1"
"TCCTTTCTCCGCTGTT"	"Cyst.IC-A_2"
"TCCTTTCTCGCAGTGC"	"Cyst.IM-CD"
"TCCTTTCTCGTGTTCC"	"Mac/DC"
"TCCTTTCTCTGGTCAA"	"EC"
"TCGAACAAGAAATTCG"	"PEC"
"TCGAACACAACGACAG"	"Cyst.PC-CD"
"TCGAACACACATGGTT"	"Cyst.IM-CD"
"TCGAACACACTGCACG"	"Cyst.cTAL"
"TCGAACACAGTGTATC"	"Mast-cell"
"TCGAACAGTATAGCTC"	"Cyst.cTAL"
"TCGAACAGTGCGACAA"	"Cyst.PC-CD"
"TCGAACAGTTCGATTG"	"PEC"
"TCGAACAGTTGTGTTG"	"Cyst.IC-A_1"
"TCGAACATCAGACAAA"	"Podocytes"
"TCGAAGTAGAGGTCAC"	"Cyst.PC-CD"
"TCGAAGTAGGCATTTC"	"T-cell"
"TCGAAGTAGGTTCAGG"	"Cyst.PC-CD"
"TCGAAGTAGTATAGAC"	"PEC"
"TCGAAGTCAAGACCTT"	"Cyst.IM-CD"
"TCGACCTCATGTTACG"	"Cyst.IM-CD"
"TCGACCTGTGGTTTGT"	"Cyst.IM-CD"
"TCGACCTGTTTAGAGA"	"Cyst.PC-CD"
"TCGACCTTCTCATAGG"	"Cyst.IM-CD"
"TCGACGGAGAGTCACG"	"Cyst.IM-CD"
"TCGACGGGTGTGTGGA"	"Cyst.PC-CD"
"TCGACGGTCCTACGGG"	"EC"
"TCGATTTAGAAGTATC"	"Cyst.IM-CD"
"TCGATTTCAGTCTACA"	"EC"
"TCGATTTGTACAGCGA"	"Cyst.IC-A_1"
"TCGATTTGTTTCGATG"	"EC"
"TCGCACTAGAGCAGCT"	"Cyst.PC-CD"
"TCGCACTAGCCTGGAA"	"EC"
"TCGCACTCACAGAGCA"	"Podocytes"
"TCGCACTCAGCAGAAC"	"Cyst.IM-CD"
"TCGCACTGTAGATTGA"	"PEC"
"TCGCACTGTCACCACG"	"Podocytes"
"TCGCACTGTCGAACGA"	"Podocytes"
"TCGCACTGTGATACCT"	"Cyst.IM-CD"
"TCGCAGGAGTCCTGTA"	"Cyst.PC-CD"
"TCGCAGGCATCGATGT"	"Cyst.PC-CD"
"TCGCAGGGTCAGCGTC"	"Cyst.PC-CD"
"TCGCAGGTCCGCTGTT"	"Cyst.PC-CD"
"TCGCAGGTCCTTCTTC"	"Cyst.IC-A_1"
"TCGCTCAAGCCAAGCA"	"Cyst.PC-CD"
"TCGCTCAAGGGCTGAT"	"Mast-cell"
"TCGCTCACAACGATTC"	"Cyst.PC-CD"
"TCGCTCACACCCAATA"	"Cyst.PC-CD"
"TCGCTCACAGCGTGCT"	"VSMC"
"TCGCTCAGTGGTACAG"	"Cyst.cTAL"
"TCGCTCATCAATCCAG"	"PEC"
"TCGCTCATCGAGTTGT"	"Cyst.PC-CD"
"TCGCTCATCGGCATTA"	"PEC"
"TCGCTTGAGCGACCCT"	"Cyst.IM-CD"
"TCGCTTGCAACCTAAC"	"Cyst.IC-A_1"
"TCGCTTGCACATAACC"	"Cyst.PC-CD"
"TCGCTTGCAGACCTGC"	"Cyst.IM-CD"
"TCGCTTGGTCATACCA"	"PEC"
"TCGCTTGTCATGGCCG"	"Cyst.PC-CD"
"TCGCTTGTCGTCCTTG"	"Cyst.IM-CD"
"TCGGATAAGCACACAG"	"Cyst.PC-CD"
"TCGGATAAGCCTCAAT"	"Cyst.PC-CD"
"TCGGATAAGGGTTGCA"	"EC"
"TCGGATAAGGTGCCAA"	"PEC"
"TCGGATAGTCGTGTTA"	"Cyst.PC-CD"
"TCGGATAGTGCACAAG"	"Cyst.IC-A_1"
"TCGGATAGTGGATGAC"	"Cyst.IM-CD"
"TCGGATAGTGGTAATA"	"Podocytes"
"TCGGATATCACTAGCA"	"Cyst.PT_2"
"TCGGATATCACTCTTA"	"Cyst.IM-CD"
"TCGGATATCAGCTTGA"	"Cyst.PC-CD"
"TCGGGACCATTGTGCA"	"Cyst.cTAL"
"TCGGGACGTACAGCGA"	"Podocytes"
"TCGGGACGTCTTGCGG"	"Cyst.PT_1"
"TCGGGACGTGTATTGC"	"PEC"
"TCGGGACGTTGTGCAT"	"Cyst.IM-CD"
"TCGGGACTCCGCTGTT"	"EC"
"TCGGGACTCTACCTTA"	"PEC"
"TCGGGACTCTCAAAGC"	"Cyst.PC-CD"
"TCGGGCAAGAGTTGAT"	"VSMC"
"TCGGGCAAGCTTTGTG"	"PEC"
"TCGGGCAAGGCCCAAA"	"Podocytes"
"TCGGGCAAGGTTGGTG"	"Cyst.IM-CD"
"TCGGGCACAACAAGAT"	"Cyst.IC-A_1"
"TCGGGCACACATGTTG"	"PEC"
"TCGGGCACATATCGGT"	"Cyst.PC-CD"
"TCGGGCACATGGATCT"	"Cyst.PC-CD"
"TCGGGCACATGTTCAG"	"Cyst.IC-A_1"
"TCGGGCAGTGGTGATG"	"Cyst.IC-A_2"
"TCGGGTGCAAGCTGTT"	"Cyst.IM-CD"
"TCGGGTGCAATCGCGC"	"Mac/DC"
"TCGGGTGCATGAGATA"	"Cyst.CD"
"TCGGGTGGTACGATTC"	"Mast-cell"
"TCGGGTGGTTGGTGTT"	"Cyst.PC-CD"
"TCGGGTGGTTGTGCCG"	"PEC"
"TCGGTCTCATCTAACG"	"Cyst.IC-A_1"
"TCGGTCTGTATGGTAA"	"Cyst.PT_2"
"TCGGTCTGTGGCTGCT"	"PEC"
"TCGGTCTTCATCCCGT"	"Cyst.IM-CD"
"TCGGTCTTCGCCTTGT"	"Cyst.IC-A_2"
"TCGTAGAAGACCGCCT"	"Cyst.PC-CD"
"TCGTAGAAGCTAGCCC"	"PEC"
"TCGTAGAGTTTAGTCG"	"Cyst.IM-CD"
"TCGTAGATCGATGGAG"	"Cyst.IM-CD"
"TCGTAGATCGGACTTA"	"Cyst.PT_2"
"TCGTAGATCGGTCTGG"	"Cyst.PC-CD"
"TCGTCCAAGAACGCGT"	"Mac/DC"
"TCGTCCAAGCGCTGCT"	"T-cell"
"TCGTCCACATGGGTCC"	"VSMC"
"TCGTCCAGTCCCGCAA"	"Cyst.IM-CD"
"TCGTCCAGTCGTTGCG"	"Cyst.PC-CD"
"TCGTGCTAGACAGCTG"	"Cyst.IM-CD"
"TCGTGCTCACAGACGA"	"PEC"
"TCGTGCTGTTTGGGTT"	"Cyst.IC-A_1"
"TCGTGCTTCGTTATCT"	"Cyst.IC-A_1"
"TCGTGGGAGACAAGCC"	"Cyst.IM-CD"
"TCGTGGGCAATGCTCA"	"Mac/DC"
"TCGTGGGCACGACCTG"	"Mac/DC"
"TCGTGGGCACTGGACC"	"Cyst.cTAL"
"TCGTGGGCAGTGTGCC"	"Cyst.PC-CD"
"TCGTGGGCATCGAACT"	"Podocytes"
"TCGTGGGTCAATCTTC"	"Cyst.PC-CD"
"TCTAACTAGATGGCAC"	"Cyst.PC-CD"
"TCTAACTCAAGCCTGC"	"Cyst.IC-A_1"
"TCTAACTCATTGCAAC"	"Cyst.IM-CD"
"TCTAACTGTAGCGATG"	"Cyst.PC-CD"
"TCTAACTGTCACTACA"	"Cyst.IC-A_1"
"TCTAACTGTGCATTTG"	"EC"
"TCTAACTGTTTCGTGA"	"PEC"
"TCTAACTTCATTGAGC"	"Mast-cell"
"TCTAACTTCCTAGCGG"	"Cyst.PT_2"
"TCTAACTTCGCACTCT"	"EC"
"TCTACATAGAGGACTC"	"T-cell"
"TCTACATAGCCATGCC"	"Cyst.PT_2"
"TCTACATCAATAACGA"	"Cyst.IM-CD"
"TCTACATCACAATCTG"	"Cyst.IM-CD"
"TCTACATGTCCGCAGT"	"Cyst.PC-CD"
"TCTACATGTGATTGGG"	"VSMC"
"TCTACATTCCTACAAG"	"Cyst.CD"
"TCTACATTCTTTGCGC"	"Cyst.PC-CD"
"TCTACCGAGCAGTACG"	"Cyst.IM-CD"
"TCTACCGAGGTGCAGT"	"Cyst.IM-CD"
"TCTACCGGTAACGTTC"	"Cyst.PC-CD"
"TCTACCGGTACCGGCT"	"Podocytes"
"TCTACCGGTTATCTGG"	"PEC"
"TCTATACAGCGTCTCG"	"Cyst.IC-A_2"
"TCTATACAGGTACAGC"	"EC"
"TCTATACCAAAGGGTC"	"B-cell_1"
"TCTATACCACTGATTG"	"Cyst.PC-CD"
"TCTATACCACTTTATC"	"PEC"
"TCTATACCAGTTCCAA"	"Cyst.PC-CD"
"TCTATACGTACTGCCG"	"Cyst.IC-A_2"
"TCTATACGTCTGGTTA"	"Cyst.PC-CD"
"TCTATACGTTGTAAAG"	"Podocytes"
"TCTATACTCAACCTTT"	"Cyst.PC-CD"
"TCTATACTCCCTAGGG"	"PEC"
"TCTATACTCGTGGTAT"	"Podocytes"
"TCTATCAAGCAGCCCT"	"Cyst.PC-CD"
"TCTATCAAGGCGTTAG"	"VSMC"
"TCTATCAAGGGAGGGT"	"Cyst.IM-CD"
"TCTATCAAGTAATACG"	"Cyst.IM-CD"
"TCTATCAGTATACCCA"	"Cyst.PC-CD"
"TCTATCAGTCATGGCC"	"PEC"
"TCTATCAGTCTAACTG"	"Mast-cell"
"TCTATCAGTGCCGTTG"	"Cyst.PC-CD"
"TCTATCATCCTACGGG"	"Cyst.IM-CD"
"TCTCACGAGCAATAAC"	"Cyst.PC-CD"
"TCTCACGAGTGGTGAC"	"Podocytes"
"TCTCACGGTCCTACAA"	"Cyst.IM-CD"
"TCTCACGTCTTGATTC"	"VSMC"
"TCTCAGCCAAAGACGC"	"VSMC"
"TCTCAGCGTATCATGC"	"Cyst.IM-CD"
"TCTCAGCTCGTAGGGA"	"Cyst.cTAL"
"TCTCCGAAGCATCAAA"	"VSMC"
"TCTCCGAAGCGCCTCA"	"Cyst.IM-CD"
"TCTCCGAAGTGTTCCA"	"Cyst.IM-CD"
"TCTCCGACACAGCCAC"	"B-cell_1"
"TCTCCGACATGTGCCG"	"Cyst.IM-CD"
"TCTCCGATCACAAGAA"	"Mast-cell"
"TCTCCGATCAGACAAA"	"T-cell"
"TCTCCGATCAGCATTG"	"Cyst.IC-A_1"
"TCTCCGATCCGCTAGG"	"Cyst.IM-CD"
"TCTCCGATCCGGCTTT"	"Cyst.IM-CD"
"TCTCCGATCGCTCATC"	"Cyst.PT_2"
"TCTCTGGCACAAATCC"	"Cyst.PT_2"
"TCTCTGGCATTGGGAG"	"Cyst.PC-CD"
"TCTCTGGGTAGGTCAG"	"Cyst.IM-CD"
"TCTCTGGGTATGTCCA"	"PEC"
"TCTCTGGTCAAAGCCT"	"Cyst.PC-CD"
"TCTCTGGTCTACACAG"	"Cyst.cTAL"
"TCTCTGGTCTTTGCGC"	"Cyst.IM-CD"
"TCTGCCACACTAACCA"	"Cyst.IM-CD"
"TCTGCCAGTCCGTACG"	"Mast-cell"
"TCTGCCAGTCTGTAGT"	"Cyst.IM-CD"
"TCTGCCATCGGACTGC"	"Cyst.IC-A_1"
"TCTGGCTGTATCCCTC"	"Cyst.IC-A_1"
"TCTGGCTGTCATAAAG"	"Cyst.PT_1"
"TCTGGCTTCAATCGGT"	"Cyst.PC-CD"
"TCTGTCGAGCAACTTC"	"Cyst.cTAL"
"TCTGTCGAGCGTACAG"	"Cyst.PC-CD"
"TCTGTCGCAACCGTAT"	"Podocytes"
"TCTGTCGGTGCCGAAA"	"T-cell"
"TCTGTCGGTTTGGCTA"	"B-cell_1"
"TCTTAGTAGGATGAGA"	"Cyst.PC-CD"
"TCTTAGTAGGTGATCG"	"Cyst.PC-CD"
"TCTTAGTCAGCACAGA"	"Cyst.PC-CD"
"TCTTAGTGTGCCCAGT"	"Cyst.cTAL"
"TCTTCCTAGTCCCGGT"	"PEC"
"TCTTCCTCAATTGTGC"	"PEC"
"TCTTCCTGTTGTTGTG"	"Podocytes"
"TCTTCCTTCCAGCACG"	"Mac/DC"
"TCTTCCTTCTCCTACG"	"Cyst.PC-CD"
"TCTTCCTTCTTCTAAC"	"Mast-cell"
"TCTTGCGAGGGTATAT"	"Mac/DC"
"TCTTGCGGTACGTACT"	"Mast-cell"
"TCTTGCGGTACTGAGG"	"Cyst.PC-CD"
"TCTTGCGGTTGACGGA"	"Cyst.PC-CD"
"TCTTTGAAGCAGGGAG"	"Mac/DC"
"TCTTTGAAGCTAGAAT"	"T-cell"
"TCTTTGAAGCTTGTTG"	"Cyst.PC-CD"
"TCTTTGAAGGAGTACC"	"Podocytes"
"TCTTTGACAAGCGAGT"	"Cyst.IM-CD"
"TCTTTGACACCACTGG"	"Cyst.IM-CD"
"TCTTTGAGTATCAGGG"	"Cyst.IC-A_2"
"TCTTTGAGTCTCAAGT"	"Cyst.PC-CD"
"TGAACGTCAACCCTCT"	"VSMC"
"TGAACGTCAGGAGGAG"	"Podocytes"
"TGAACGTGTATTCTCT"	"VSMC"
"TGAACGTTCATGTCAG"	"Cyst.IC-A_1"
"TGAACGTTCGACTCCT"	"Cyst.PC-CD"
"TGAATCGAGACATGCG"	"PEC"
"TGAATCGCAAGGTCTT"	"Cyst.IM-CD"
"TGAATCGCAGCTTTGA"	"Cyst.CD"
"TGAATGCAGGCAGCTA"	"Cyst.cTAL"
"TGAATGCCACAAGTGG"	"Cyst.IC-A_2"
"TGAATGCCACCAGACC"	"PEC"
"TGAATGCCACGGGTAA"	"Cyst.IC-A_2"
"TGAATGCCACGGTGTC"	"Cyst.IM-CD"
"TGAATGCGTCCCGTGA"	"Cyst.PC-CD"
"TGAATGCTCTCTAAGG"	"PEC"
"TGACAGTAGTACTCGT"	"Cyst.PC-CD"
"TGACAGTCACTTCTCG"	"EC"
"TGACAGTCAGGTCAGA"	"Cyst.IC-A_1"
"TGACAGTGTTACACTG"	"Cyst.PC-CD"
"TGACAGTGTTCTGAGT"	"Cyst.IM-CD"
"TGACAGTTCGAGCACC"	"Cyst.IC-A_1"
"TGACCCTGTATTGACC"	"Cyst.PC-CD"
"TGACCCTGTTCAAACC"	"Cyst.PC-CD"
"TGACCCTTCGGCTTGG"	"Cyst.IC-A_2"
"TGACCCTTCTACAGGT"	"Cyst.IM-CD"
"TGACCCTTCTGAACGT"	"Cyst.cTAL"
"TGACGCGAGCCTCAGC"	"Mac/DC"
"TGACGCGAGGGAGGTG"	"PEC"
"TGACGCGCAAGGACAC"	"PEC"
"TGACGCGCAATAACGA"	"Cyst.IC-A_1"
"TGACGCGCAATACAGA"	"Cyst.PC-CD"
"TGACGCGCACTTCATT"	"Cyst.IM-CD"
"TGACGCGGTATAATGG"	"Cyst.PC-CD"
"TGACGCGGTGTTCCAA"	"Cyst.PC-CD"
"TGACGCGTCCAATCCC"	"Podocytes"
"TGACTCCAGCAGAAAG"	"Cyst.IM-CD"
"TGACTCCAGTTCCGTA"	"Cyst.PC-CD"
"TGACTCCCAAGAGTGC"	"PEC"
"TGACTCCCAGAACATA"	"Podocytes"
"TGACTCCGTAGACAGC"	"Cyst.PC-CD"
"TGACTCCGTCGCCTAG"	"PEC"
"TGACTCCGTCTGTGCG"	"Cyst.IC-A_1"
"TGACTCCGTGGCCCAT"	"Cyst.PC-CD"
"TGAGACTAGGACTGGT"	"Cyst.cTAL"
"TGAGACTCACTAGGTT"	"Podocytes"
"TGAGACTCAGACCAGA"	"Cyst.cTAL"
"TGAGACTCAGTTAGGG"	"Cyst.cTAL"
"TGAGACTGTGCTATTG"	"Cyst.CD"
"TGAGACTGTGGTCCCA"	"Podocytes"
"TGAGACTTCCGCGAGT"	"B-cell_1"
"TGAGACTTCCGTTGGG"	"Cyst.PT_1"
"TGAGCATAGAAGTGTT"	"T-cell"
"TGAGCATAGATTCGCT"	"Podocytes"
"TGAGCATAGCACCGTC"	"T-cell"
"TGAGCATAGTTGGACG"	"Cyst.cTAL"
"TGAGCATCACCCTGTT"	"Cyst.PC-CD"
"TGAGCATGTTGGCCTG"	"Cyst.cTAL"
"TGAGCATTCCTCACCA"	"Mast-cell"
"TGAGCATTCTCGGCTT"	"Cyst.PT_1"
"TGAGCGCAGTAACGAT"	"Cyst.IC-A_1"
"TGAGCGCAGTCCCGGT"	"Cyst.PC-CD"
"TGAGCGCCAACTCCAA"	"EC"
"TGAGCGCGTAGCGTAG"	"Mac/DC"
"TGAGCGCTCACCTCTG"	"EC"
"TGAGCGCTCAGGAAGC"	"Cyst.PC-CD"
"TGAGGAGAGACATAGT"	"VSMC"
"TGAGGAGAGTGGAAAG"	"Cyst.PC-CD"
"TGAGGAGCACAAGTGG"	"PEC"
"TGAGGAGCACGTCGGT"	"Cyst.IC-A_2"
"TGAGGAGCAGTATTCG"	"Cyst.IM-CD"
"TGAGGAGGTCATCACA"	"Cyst.IC-A_2"
"TGAGGAGGTTCGGTCG"	"Cyst.CD"
"TGAGGAGTCGATACTG"	"Cyst.IC-A_2"
"TGAGGAGTCGTAACAC"	"T-cell"
"TGAGGGACACATTACG"	"Cyst.IM-CD"
"TGAGGGATCATGCCCT"	"Cyst.PC-CD"
"TGAGGTTAGAATTGTG"	"Cyst.PC-CD"
"TGAGGTTAGATGAAGG"	"Podocytes"
"TGAGGTTAGCTCCGAC"	"Cyst.PC-CD"
"TGAGGTTAGGGATCAC"	"Cyst.IM-CD"
"TGAGGTTGTGAATATG"	"Cyst.PC-CD"
"TGAGGTTTCAAACCTG"	"Cyst.IM-CD"
"TGAGGTTTCCTGCTAC"	"Cyst.IM-CD"
"TGAGTCACACGCAGTC"	"Cyst.PT_1"
"TGAGTCACAGTCACGC"	"Cyst.PC-CD"
"TGAGTCAGTCCAGTTA"	"Mast-cell"
"TGAGTCAGTGCGTGCT"	"Cyst.IM-CD"
"TGAGTCAGTTCACGAT"	"Cyst.PC-CD"
"TGAGTCATCGTGGAAG"	"Cyst.cTAL"
"TGAGTCATCTCACCCA"	"Cyst.PC-CD"
"TGAGTCATCTGCGGGT"	"Mac/DC"
"TGATCAGAGACCAGAC"	"Cyst.PT_1"
"TGATCAGCAATCTCGA"	"VSMC"
"TGATCAGCAGTATACC"	"EC"
"TGATCAGGTATGGAGC"	"Cyst.PC-CD"
"TGATCAGGTTGGGACA"	"Cyst.PC-CD"
"TGATCAGTCATCTACT"	"Podocytes"
"TGATCAGTCTGTCAGA"	"Cyst.IC-A_1"
"TGATCTTAGTTGCTGT"	"Cyst.cTAL"
"TGATCTTCAGCATCTA"	"Podocytes"
"TGATGCAAGAGTTGAT"	"PEC"
"TGATGCAAGGGATCAC"	"Cyst.IC-A_1"
"TGATGCACAGTAGTGG"	"Cyst.PC-CD"
"TGATGCATCTGTGCAA"	"Cyst.IM-CD"
"TGATGGTCAGTTGTTG"	"EC"
"TGATGGTTCCGGCTTT"	"EC"
"TGATGGTTCCTCATAT"	"Cyst.PC-CD"
"TGATTCTCACTTGTGA"	"T-cell"
"TGATTCTGTCACGCTG"	"Cyst.IM-CD"
"TGATTCTTCTATCCAT"	"Cyst.IC-A_1"
"TGATTTCAGTGCACCC"	"Cyst.cTAL"
"TGATTTCAGTTCATGC"	"Cyst.IC-A_2"
"TGATTTCCATCAGCTA"	"Cyst.PC-CD"
"TGATTTCCATGTTTGG"	"Podocytes"
"TGATTTCGTAACCCGC"	"Cyst.IC-A_2"
"TGATTTCGTTCACGAT"	"Cyst.PC-CD"
"TGATTTCTCTTCCAGC"	"T-cell"
"TGCACGGAGTGCAACG"	"T-cell"
"TGCACGGCAGCTACCG"	"Cyst.IC-A_1"
"TGCACGGCATCCTGTC"	"Cyst.IM-CD"
"TGCACGGCATGGTGGA"	"Cyst.PT_1"
"TGCACGGGTATACAGA"	"Cyst.IM-CD"
"TGCACGGGTTGGAGGT"	"Cyst.PT_1"
"TGCACGGTCCCAAGCG"	"T-cell"
"TGCAGATCATACCGTA"	"Cyst.IM-CD"
"TGCAGATCATCTCAAG"	"Cyst.cTAL"
"TGCAGATCATGAAAGT"	"Cyst.IM-CD"
"TGCAGATGTACTCGCG"	"Cyst.IC-A_2"
"TGCAGATTCATATGGC"	"Cyst.PC-CD"
"TGCAGATTCTCCTGTG"	"Cyst.PC-CD"
"TGCAGGCCATACTTTC"	"Cyst.PC-CD"
"TGCAGGCGTGTGATGG"	"Cyst.PC-CD"
"TGCAGGCGTTCGGTAT"	"PEC"
"TGCAGGCGTTCTTCAT"	"Cyst.PC-CD"
"TGCAGGCTCTGTCTCG"	"Podocytes"
"TGCAGTAAGACATACA"	"Cyst.IC-A_1"
"TGCAGTACAAATGGTA"	"PEC"
"TGCAGTACAATCGCAT"	"Cyst.IC-A_1"
"TGCAGTACAGAATGTA"	"Cyst.PC-CD"
"TGCAGTACAGCTTCCT"	"Cyst.PC-CD"
"TGCAGTACAGGTTACT"	"VSMC"
"TGCAGTAGTACAAGCG"	"Cyst.PC-CD"
"TGCAGTAGTACTAAGA"	"Cyst.IC-A_2"
"TGCAGTAGTGACTAAA"	"PEC"
"TGCAGTAGTGCACATT"	"Cyst.PC-CD"
"TGCAGTAGTTCGTGCG"	"Cyst.PC-CD"
"TGCAGTATCAAGGAGC"	"Cyst.IM-CD"
"TGCAGTATCACCCTCA"	"Cyst.IM-CD"
"TGCAGTATCAGATTGC"	"T-cell"
"TGCAGTATCCGATAAC"	"Podocytes"
"TGCATCCAGCCGGATA"	"Cyst.IM-CD"
"TGCATCCCACAAGCTT"	"Cyst.PC-CD"
"TGCATCCGTAAGATAC"	"Cyst.IM-CD"
"TGCATCCGTAAGTTAG"	"Cyst.IM-CD"
"TGCATCCGTCTACATG"	"Cyst.cTAL"
"TGCATCCGTGCCTGCA"	"PEC"
"TGCATCCTCAACGAGG"	"B-cell_1"
"TGCATCCTCAATCCAG"	"T-cell"
"TGCATGAAGATGGCAC"	"PEC"
"TGCATGAAGTGCAACG"	"Podocytes"
"TGCATGACAAATCGTC"	"Cyst.cTAL"
"TGCATGACAAATTGGA"	"Cyst.PC-CD"
"TGCATGACACTCCACT"	"Cyst.PC-CD"
"TGCATGAGTGAGGATC"	"Cyst.IM-CD"
"TGCATGAGTTCCGCGA"	"Cyst.IC-A_1"
"TGCATGAGTTGATGTC"	"PEC"
"TGCATGAGTTGCATCA"	"Cyst.PC-CD"
"TGCATGATCAGTGGGA"	"Cyst.IM-CD"
"TGCATGATCCTTCTGG"	"Cyst.CD"
"TGCATGATCGTCAAAC"	"Cyst.PC-CD"
"TGCATGATCTGCTTTA"	"Cyst.IM-CD"
"TGCCGAGAGTAGCAAT"	"Cyst.PC-CD"
"TGCCGAGCAAAGTATG"	"Cyst.PC-CD"
"TGCCGAGCAAGATCCT"	"Cyst.IM-CD"
"TGCCGAGGTCCAATCA"	"Cyst.PC-CD"
"TGCCGAGGTTGCATAC"	"Cyst.PC-CD"
"TGCCGAGTCAACTACG"	"PEC"
"TGCCGAGTCACCATAG"	"Cyst.cTAL"
"TGCCGAGTCTGAATGC"	"Cyst.IM-CD"
"TGCCGAGTCTGAGGTT"	"Podocytes"
"TGCGACGCAATACAGA"	"Mast-cell"
"TGCGACGGTCATCACA"	"PEC"
"TGCGACGGTTGCTCGG"	"Cyst.IM-CD"
"TGCGACGTCCTAAGTG"	"EC"
"TGCGATAAGACGGTCA"	"Cyst.PC-CD"
"TGCGATAAGAGCAGCT"	"Cyst.IC-A_1"
"TGCGATAAGCGACATG"	"Cyst.IM-CD"
"TGCGATATCAGTGATC"	"Cyst.cTAL"
"TGCGATATCGCATGAT"	"Cyst.IC-A_1"
"TGCGATATCTCTTGCG"	"Cyst.IC-A_2"
"TGCGGCACACTTCTCG"	"Cyst.PC-CD"
"TGCGGCAGTTCGTACA"	"VSMC"
"TGCGGCATCCTCTGCA"	"Cyst.PC-CD"
"TGCGGGTAGCCGGAAT"	"Cyst.PC-CD"
"TGCGGGTAGCGTCAAG"	"PEC"
"TGCGGGTCACTTCATT"	"Podocytes"
"TGCGGGTCAGATCCTA"	"PEC"
"TGCGGGTGTACGTACT"	"Cyst.PC-CD"
"TGCGGGTGTCCAGGTC"	"Podocytes"
"TGCGGGTGTCGATTAC"	"Podocytes"
"TGCGGGTGTGTAAACA"	"VSMC"
"TGCGGGTGTGTCGCTG"	"Cyst.IC-A_1"
"TGCGGGTTCTTTCAGT"	"Cyst.IC-A_2"
"TGCTCCAAGTATAGAC"	"PEC"
"TGCTCCACACATCATG"	"Cyst.PC-CD"
"TGCTCCAGTGAGTAGC"	"Cyst.IM-CD"
"TGCTCGTCAACTGAAA"	"EC"
"TGCTCGTCAATTGAGA"	"Podocytes"
"TGCTCGTGTGCGAGTA"	"Cyst.IC-A_1"
"TGCTCGTTCAGCCTCT"	"Cyst.IM-CD"
"TGCTCGTTCCCGTGTT"	"Cyst.IM-CD"
"TGCTGAAAGGTATCTC"	"Cyst.IM-CD"
"TGCTGAACAACGACAG"	"PEC"
"TGCTGAACACTTGAGT"	"Cyst.IM-CD"
"TGCTGAACATTGTACG"	"Cyst.IC-A_2"
"TGCTGAAGTACAGCGA"	"VSMC"
"TGCTGAAGTATGGTAA"	"Podocytes"
"TGCTGAAGTGTCGATT"	"PEC"
"TGCTGAAGTTTCCATT"	"Cyst.IM-CD"
"TGCTGAATCAAGCCCG"	"Cyst.IM-CD"
"TGCTGAATCGCCATAA"	"B-cell_1"
"TGCTGAATCGCTAGCG"	"Podocytes"
"TGCTTCGAGTCGAATA"	"Cyst.CD"
"TGCTTCGCAGACCAGA"	"Cyst.IM-CD"
"TGCTTCGCAGAGGCAT"	"Cyst.cTAL"
"TGCTTCGCAGAGGGTT"	"Cyst.cTAL"
"TGCTTCGCAGGTTCCG"	"PEC"
"TGCTTCGGTATGCTAC"	"Cyst.IC-A_2"
"TGCTTCGTCGTTGTTT"	"Cyst.cTAL"
"TGCTTGCAGATACGAT"	"Cyst.IC-A_2"
"TGCTTGCCACACAGCC"	"Cyst.cTAL"
"TGCTTGCCAGGAGACT"	"Cyst.cTAL"
"TGCTTGCGTCCTACAA"	"PEC"
"TGCTTGCGTGCAACGA"	"Cyst.CD"
"TGCTTGCTCCGAGATT"	"Cyst.IM-CD"
"TGCTTGCTCGGTAACT"	"PEC"
"TGGAACTCAAACAGGC"	"Cyst.cTAL"
"TGGAACTCAGACCAAG"	"Cyst.cTAL"
"TGGAACTGTTTCGATG"	"Cyst.PC-CD"
"TGGAACTTCATTCCTA"	"Podocytes"
"TGGAACTTCCGGGACT"	"Mast-cell"
"TGGAGAGAGGGAGGCA"	"Cyst.IC-A_1"
"TGGAGAGCAACTTGGT"	"Cyst.IC-A_1"
"TGGAGAGGTACTCGCG"	"Podocytes"
"TGGAGAGTCGGACAAG"	"Cyst.IM-CD"
"TGGAGAGTCGGCCCAA"	"Cyst.IC-A_1"
"TGGAGAGTCGTACCTC"	"VSMC"
"TGGAGAGTCTAGCCTC"	"Cyst.IM-CD"
"TGGAGAGTCTGGGATT"	"Mac/DC"
"TGGAGGACAAACTAGA"	"EC"
"TGGAGGACAACTGCTA"	"Cyst.CD"
"TGGAGGACACACAGAG"	"Cyst.PC-CD"
"TGGAGGACACGTTGGC"	"Cyst.IM-CD"
"TGGAGGACATAACCCA"	"Cyst.PC-CD"
"TGGAGGAGTCCTTGTC"	"Cyst.IM-CD"
"TGGAGGAGTCTGGTTA"	"Cyst.IM-CD"
"TGGAGGATCCTCACTG"	"VSMC"
"TGGAGGATCTCTGAGA"	"Cyst.IC-A_1"
"TGGATCAAGGCGTCCT"	"Cyst.IC-A_1"
"TGGATCACAACCAGAG"	"Cyst.PC-CD"
"TGGATCACAGGTTCAT"	"VSMC"
"TGGATCAGTAGACACG"	"Cyst.IM-CD"
"TGGATCAGTATGAGGC"	"PEC"
"TGGATCAGTCGACGCT"	"Cyst.PC-CD"
"TGGATCAGTTGGTAGG"	"Cyst.IM-CD"
"TGGATCAGTTTCGACA"	"Cyst.PC-CD"
"TGGATCATCATCCTAT"	"Cyst.PC-CD"
"TGGATCATCCTTCACG"	"PEC"
"TGGATGTAGCACTCTA"	"Podocytes"
"TGGATGTAGGGATCGT"	"Cyst.IC-A_2"
"TGGATGTGTCGTATGT"	"Cyst.IC-A_2"
"TGGATGTGTGGTCCCA"	"Cyst.PC-CD"
"TGGATGTGTTTCGTGA"	"Cyst.PC-CD"
"TGGATGTTCCCTGGTT"	"Cyst.PC-CD"
"TGGCGTGAGAATTCAG"	"Cyst.PC-CD"
"TGGCGTGAGTTCCGGC"	"Cyst.PC-CD"
"TGGCGTGCAGAAGTTA"	"Cyst.PC-CD"
"TGGCGTGCAGACCAGA"	"Cyst.PC-CD"
"TGGCGTGGTAACATCC"	"Cyst.PT_1"
"TGGCGTGGTACGACTT"	"Cyst.PC-CD"
"TGGCGTGGTACTCGAT"	"Cyst.IC-A_1"
"TGGCGTGGTATGCTAC"	"Podocytes"
"TGGCGTGGTCTACAAC"	"Cyst.IC-A_1"
"TGGCGTGGTCTCTCTG"	"Cyst.IC-A_1"
"TGGCGTGTCAAGGAGC"	"Cyst.PC-CD"
"TGGGAAGAGAGGCTGT"	"Cyst.PC-CD"
"TGGGAAGAGTCGAGGT"	"Cyst.IM-CD"
"TGGGAAGCAATCAGCT"	"Cyst.IC-A_1"
"TGGGAAGCATTCAGGT"	"PEC"
"TGGGAAGGTCTACGTA"	"PEC"
"TGGGAAGTCAGCACCG"	"Cyst.PC-CD"
"TGGGAGAGTCGTCGGT"	"Cyst.PC-CD"
"TGGGAGATCATCACTT"	"Cyst.PC-CD"
"TGGGATTAGCTCCACG"	"Cyst.PC-CD"
"TGGGATTCAATTCACG"	"Cyst.PC-CD"
"TGGGATTCATCATCCC"	"PEC"
"TGGGATTGTAACTTCG"	"Cyst.cTAL"
"TGGGATTGTAGGACCA"	"PEC"
"TGGGATTGTCTCCTGT"	"Cyst.PC-CD"
"TGGGATTGTGCTTATG"	"Cyst.IM-CD"
"TGGGATTTCTGAGCAT"	"Podocytes"
"TGGGCGTAGGCTGTAG"	"EC"
"TGGGCGTCAATAACGA"	"PEC"
"TGGGCGTCATTGAGGG"	"Cyst.PC-CD"
"TGGGCGTGTCTACGTA"	"VSMC"
"TGGGCGTGTGACCTGC"	"Cyst.PC-CD"
"TGGGCGTGTGGGCTTC"	"EC"
"TGGGCGTGTGGGTCAA"	"Cyst.cTAL"
"TGGGCGTGTTCGGCGT"	"Cyst.PC-CD"
"TGGGCTGCAAATGCTC"	"Cyst.PT_1"
"TGGGCTGCAACGTTAC"	"Cyst.IC-A_1"
"TGGGCTGCACATATCG"	"Mac/DC"
"TGGGCTGGTACAAGTA"	"EC"
"TGGGCTGGTATCGCGC"	"Cyst.cTAL"
"TGGGCTGGTGGTCCCA"	"Cyst.cTAL"
"TGGGCTGGTTCAGTAC"	"PEC"
"TGGGCTGGTTCCTAAG"	"PEC"
"TGGGCTGGTTGCATAC"	"Cyst.PC-CD"
"TGGGCTGTCATGCCAA"	"Cyst.IM-CD"
"TGGGCTGTCCGTGACG"	"Mast-cell"
"TGGGCTGTCCTCCACA"	"Mac/DC"
"TGGGCTGTCTACGCAA"	"Cyst.CD"
"TGGGCTGTCTCAACCC"	"Podocytes"
"TGGGTTACAGCTGTGC"	"Cyst.IC-A_1"
"TGGGTTACAGGCTTGC"	"Cyst.IC-A_1"
"TGGGTTACATTGAAGA"	"Cyst.PC-CD"
"TGGGTTAGTCACTAGT"	"Cyst.PC-CD"
"TGGGTTAGTTCAGTAC"	"Mac/DC"
"TGGTACAAGACCATGG"	"Cyst.IM-CD"
"TGGTACAAGACCTTTG"	"Cyst.PC-CD"
"TGGTACAAGACTCTTG"	"Cyst.IM-CD"
"TGGTACAAGAGTGAAG"	"Cyst.PC-CD"
"TGGTACAAGGTGCCTC"	"Cyst.PC-CD"
"TGGTACAAGTTGGCTT"	"T-cell"
"TGGTACACAGTCGAGA"	"Cyst.CD"
"TGGTACACATGTACGT"	"PEC"
"TGGTACAGTGTTGACT"	"Cyst.IC-A_1"
"TGGTACATCTAAGCGT"	"Cyst.IM-CD"
"TGGTAGTAGAAGCGGG"	"Podocytes"
"TGGTAGTAGCAACAAT"	"Cyst.PC-CD"
"TGGTAGTAGCACACCC"	"Cyst.IC-A_2"
"TGGTAGTAGTCGTTAC"	"Cyst.PC-CD"
"TGGTAGTAGTGGCAGT"	"Cyst.PT_1"
"TGGTAGTAGTTGCATC"	"Podocytes"
"TGGTAGTCACACCGCA"	"Cyst.PC-CD"
"TGGTAGTCAGCCCACA"	"B-cell_1"
"TGGTAGTGTTACTCAG"	"Cyst.PC-CD"
"TGGTAGTTCGACCACG"	"Cyst.IM-CD"
"TGGTGATCAACGCATT"	"Cyst.PC-CD"
"TGGTGATCACCCATAA"	"Cyst.PC-CD"
"TGGTGATCAGTCAGAG"	"VSMC"
"TGGTGATGTGCTCCGA"	"Mast-cell"
"TGGTGATTCAGGAGAC"	"Cyst.IM-CD"
"TGGTGATTCGGCTGAC"	"Cyst.IC-A_1"
"TGGTTAGAGAGGATCC"	"PEC"
"TGGTTAGAGCAAGCCA"	"Cyst.PC-CD"
"TGGTTAGAGCACACCC"	"Cyst.IC-A_1"
"TGGTTAGCAAATCAAG"	"VSMC"
"TGGTTAGCATTGCTGA"	"Cyst.IM-CD"
"TGGTTAGGTGTCATCA"	"Cyst.PC-CD"
"TGGTTAGTCTAACACG"	"PEC"
"TGGTTAGTCTTCACAT"	"PEC"
"TGTAACGCAAAGGAGA"	"Cyst.IC-A_1"
"TGTAACGCACCGTGGT"	"T-cell"
"TGTAACGCATCGGAGA"	"PEC"
"TGTAACGGTTCCTAGA"	"PEC"
"TGTAACGTCGCCGAAC"	"Cyst.IC-A_1"
"TGTAACGTCGCTTACC"	"Cyst.IM-CD"
"TGTAACGTCTTGGCTC"	"Cyst.IC-A_1"
"TGTAAGCAGGATAATC"	"Cyst.PC-CD"
"TGTAAGCCAGGCATTT"	"Cyst.IM-CD"
"TGTAAGCGTCCCTCAT"	"Cyst.IM-CD"
"TGTAAGCGTGATTAGA"	"Podocytes"
"TGTAAGCTCGGCTCTT"	"Cyst.PT_1"
"TGTAAGCTCTGGCCTT"	"Cyst.PC-CD"
"TGTACAGAGTCGCGAA"	"Podocytes"
"TGTACAGAGTTGGACG"	"Cyst.PC-CD"
"TGTACAGCAGCAGGAT"	"Podocytes"
"TGTACAGCATTCATCT"	"Cyst.PC-CD"
"TGTACAGGTCTAGGCC"	"Cyst.IC-A_1"
"TGTACAGTCCGAGTGC"	"Cyst.PC-CD"
"TGTACAGTCGGTCATA"	"Cyst.PT_1"
"TGTACAGTCTGAGCAT"	"Cyst.PC-CD"
"TGTACAGTCTTGGGCG"	"VSMC"
"TGTAGACCAGAAATCA"	"PEC"
"TGTAGACCAGATCCTA"	"Cyst.IM-CD"
"TGTAGACGTTGATGTC"	"Cyst.IC-A_2"
"TGTAGACGTTTCCCAC"	"Mac/DC"
"TGTAGACTCCGTATAG"	"Podocytes"
"TGTCAGAAGCGCCCAT"	"Cyst.IM-CD"
"TGTCAGACAAACTCTG"	"Cyst.PC-CD"
"TGTCAGACATGGCTAT"	"Cyst.PC-CD"
"TGTCAGACATTGACCA"	"Cyst.PC-CD"
"TGTCAGAGTACGAGTG"	"Cyst.cTAL"
"TGTCAGAGTTACCCAA"	"Cyst.IM-CD"
"TGTCAGAGTTCAGGTT"	"Cyst.IM-CD"
"TGTCAGATCTGAGAGG"	"PEC"
"TGTCCACAGAATAACC"	"Cyst.IC-A_1"
"TGTCCACAGCATGGGT"	"Podocytes"
"TGTCCACAGCCATTGT"	"Cyst.PT_2"
"TGTCCACCAAGCAATA"	"B-cell_1"
"TGTCCACGTAGACTGG"	"T-cell"
"TGTCCACGTAGCTGTT"	"Cyst.IM-CD"
"TGTCCACTCATCACCC"	"Cyst.IM-CD"
"TGTCCCAAGTAGCAAT"	"Mac/DC"
"TGTCCCAGTTAACAGA"	"Cyst.PC-CD"
"TGTCCCATCCTCTCTT"	"PEC"
"TGTCCCATCTACCCAC"	"Mast-cell"
"TGTCCTGAGCAAACAT"	"Cyst.PC-CD"
"TGTCCTGGTAGAGGAA"	"Cyst.IM-CD"
"TGTCCTGGTCGAAGCA"	"Cyst.IC-A_2"
"TGTCCTGGTGGGTATG"	"B-cell_1"
"TGTCCTGGTGTCATCA"	"Cyst.PC-CD"
"TGTCCTGGTTTCACTT"	"Cyst.PC-CD"
"TGTCCTGTCCGCTGTT"	"Cyst.PC-CD"
"TGTGAGTCAATACAGA"	"Cyst.IM-CD"
"TGTGAGTGTAGTAAGT"	"Cyst.PC-CD"
"TGTGAGTGTCACGTGC"	"VSMC"
"TGTGAGTGTCGGTGAA"	"Cyst.PC-CD"
"TGTGAGTGTCGTTATG"	"Cyst.PC-CD"
"TGTGAGTGTGTATACC"	"VSMC"
"TGTGAGTTCTTTCAGT"	"Cyst.PT_1"
"TGTGATGAGCCTGTGC"	"Podocytes"
"TGTGATGCACATAACC"	"PEC"
"TGTGATGGTCACTGAT"	"Cyst.IM-CD"
"TGTGATGGTCCGGTCA"	"Podocytes"
"TGTGATGGTTACAGCT"	"PEC"
"TGTGATGTCCTCATAT"	"Cyst.CD"
"TGTGATGTCTCCAATT"	"Cyst.PC-CD"
"TGTGCGGAGCTACTAC"	"Podocytes"
"TGTGCGGAGGATCATA"	"Cyst.IC-A_1"
"TGTGCGGAGTTGCCTA"	"Cyst.cTAL"
"TGTGCGGCACGCGCTA"	"Cyst.PC-CD"
"TGTGCGGCACTGTGAT"	"PEC"
"TGTGCGGGTGCGAACA"	"Cyst.cTAL"
"TGTGCGGGTTAGAGAT"	"PEC"
"TGTGCGGTCCCGAGTG"	"PEC"
"TGTGCGGTCGAGCCTG"	"Cyst.PT_1"
"TGTGGCGAGTCATACC"	"PEC"
"TGTGGCGCACATACTG"	"Mac/DC"
"TGTGGCGGTGTCCGGT"	"Cyst.IC-A_1"
"TGTGGCGTCGGTGAAG"	"Cyst.PC-CD"
"TGTGTGAAGGCTTCCG"	"Cyst.cTAL"
"TGTGTGAAGTCCGCCA"	"Cyst.PC-CD"
"TGTGTGACAGAATGTA"	"Cyst.IC-A_2"
"TGTGTGACAGTAGGAC"	"PEC"
"TGTTACTCAACATACC"	"Cyst.PC-CD"
"TGTTACTCAATTCTCT"	"Cyst.cTAL"
"TGTTACTGTGCCTACG"	"Cyst.PC-CD"
"TGTTACTGTGCGGATA"	"T-cell"
"TGTTACTTCAACGCTA"	"VSMC"
"TGTTCATCACCATTCC"	"Cyst.cTAL"
"TGTTCATGTAGACGTG"	"Cyst.IM-CD"
"TGTTCCGAGCGTGAGT"	"Cyst.PC-CD"
"TGTTCCGAGTAGGCCA"	"Mac/DC"
"TGTTCCGCACAGTACT"	"PEC"
"TGTTCCGGTCGCGGTT"	"Cyst.CD"
"TGTTCCGGTGAGATAT"	"Cyst.PC-CD"
"TGTTCTAAGATAGCAT"	"Cyst.IC-A_2"
"TGTTCTAAGGCCTAGA"	"Cyst.IC-A_2"
"TGTTCTACAAGAGAGA"	"PEC"
"TGTTCTACAGAATTCC"	"Cyst.PC-CD"
"TGTTCTAGTATTCTCT"	"Cyst.PT_2"
"TGTTCTAGTCAAAGCG"	"Cyst.cTAL"
"TGTTCTAGTGGTCTCG"	"Cyst.CD"
"TGTTGAGAGACCATAA"	"Cyst.PC-CD"
"TGTTGAGAGGTCTTTG"	"Cyst.IM-CD"
"TGTTGAGCATCGCTGG"	"Mac/DC"
"TGTTGAGGTCCAAAGG"	"Cyst.PC-CD"
"TGTTGAGGTTCCGTTC"	"Mast-cell"
"TGTTGAGTCAGTCTTT"	"Cyst.PC-CD"
"TGTTGAGTCGAACTCA"	"Cyst.PT_1"
"TGTTGGAAGGGAGGTG"	"Cyst.PC-CD"
"TGTTGGATCAGCCTTC"	"Cyst.cTAL"
"TGTTGGATCCTGTAGA"	"Cyst.IM-CD"
"TGTTTGTAGCTCGTGC"	"PEC"
"TGTTTGTAGGCCTGCT"	"Cyst.IC-A_2"
"TGTTTGTTCGTAACTG"	"Cyst.CD"
"TGTTTGTTCTAGCCTC"	"Cyst.PC-CD"
"TGTTTGTTCTCGTTTA"	"Cyst.PC-CD"
"TGTTTGTTCTTACTGT"	"EC"
"TTAATCCGTAGAATAC"	"EC"
"TTAATCCGTCGCGGTT"	"Cyst.IM-CD"
"TTAATCCGTTCACCGG"	"Cyst.PC-CD"
"TTAATCCGTTTAGACC"	"Cyst.IC-A_1"
"TTAATCCTCAGATTGC"	"PEC"
"TTACAGGCAATCAAGA"	"Cyst.IC-A_2"
"TTACAGGCAATCGCCG"	"Podocytes"
"TTACAGGCACTTCAAG"	"Cyst.PC-CD"
"TTACAGGCATAGTCGT"	"Cyst.PC-CD"
"TTACAGGTCACTCGAA"	"Cyst.PC-CD"
"TTACAGGTCCTTCGAC"	"Cyst.IC-A_2"
"TTACAGGTCGAGTGGA"	"Cyst.PC-CD"
"TTACAGGTCTCAGAAC"	"Cyst.IC-A_2"
"TTACCATAGAAGGCTC"	"Cyst.PC-CD"
"TTACCATCACTTGTCC"	"Cyst.IC-A_1"
"TTACCATCAGGACTAG"	"Cyst.IM-CD"
"TTACCATGTACGATGG"	"PEC"
"TTACCATTCTGATGGT"	"PEC"
"TTACCGCGTACAATAG"	"Cyst.IM-CD"
"TTACCGCGTTTCGGCG"	"Cyst.cTAL"
"TTACCGCTCCACCCTA"	"Cyst.IM-CD"
"TTACCGCTCGGCTGAC"	"PEC"
"TTACCGCTCTCACCCA"	"Cyst.cTAL"
"TTACGCCAGATTCGAA"	"Cyst.PC-CD"
"TTACGCCTCAGGAGAC"	"Cyst.IC-A_1"
"TTACGCCTCCTAGAGT"	"Cyst.cTAL"
"TTACGTTAGATCGCCC"	"Cyst.IM-CD"
"TTACGTTAGCTGTGCC"	"Podocytes"
"TTACGTTCAGTAGAGC"	"EC"
"TTACGTTCATAGAAAC"	"VSMC"
"TTACGTTGTATTCCTT"	"Cyst.PC-CD"
"TTACGTTGTCTGTGAT"	"Cyst.IM-CD"
"TTACGTTTCACTCGAA"	"Podocytes"
"TTACGTTTCCCGAATA"	"PEC"
"TTACGTTTCGCAGAGA"	"Cyst.IM-CD"
"TTACTGTAGCGTTAGG"	"Cyst.PC-CD"
"TTACTGTCACTACCCT"	"VSMC"
"TTACTGTCATTCCTAT"	"Cyst.PC-CD"
"TTACTGTGTACCTAAC"	"Mast-cell"
"TTACTGTGTGTGTTTG"	"PEC"
"TTACTGTGTTAATGAG"	"Cyst.IC-A_1"
"TTACTGTTCCGTTTCG"	"Cyst.IC-A_1"
"TTACTGTTCTTCCAGC"	"Cyst.PC-CD"
"TTAGGCACAATTGCGT"	"Mac/DC"
"TTAGGCACACAATTCG"	"Cyst.cTAL"
"TTAGGCACACACCTAA"	"Cyst.PC-CD"
"TTAGGCACAGTCTTCC"	"Cyst.PC-CD"
"TTAGGGTGTGCTATTG"	"Podocytes"
"TTAGGGTGTGGTACAG"	"Cyst.PC-CD"
"TTAGGGTTCCGTGTGG"	"Cyst.IC-A_1"
"TTAGGGTTCTCCAAGA"	"Cyst.PC-CD"
"TTAGTCTAGTAAGCAT"	"Cyst.PC-CD"
"TTAGTCTAGTACAACA"	"Podocytes"
"TTAGTCTCAATCGTCA"	"VSMC"
"TTAGTCTCAATTTCGG"	"Cyst.PC-CD"
"TTAGTCTCACGGCACT"	"Cyst.IM-CD"
"TTAGTCTCAGAGATGC"	"EC"
"TTAGTCTGTATCAGGG"	"T-cell"
"TTAGTCTGTTTCGTAG"	"Cyst.PC-CD"
"TTAGTCTTCCTCTCGA"	"Cyst.PC-CD"
"TTATTGCAGACAACAT"	"Cyst.PC-CD"
"TTATTGCAGGCACTAG"	"Cyst.IC-A_2"
"TTATTGCAGTCGTCTA"	"Cyst.PC-CD"
"TTATTGCCACTACAGT"	"Cyst.PC-CD"
"TTATTGCCAGTCGGAA"	"PEC"
"TTATTGCGTGCCCGTA"	"Cyst.IM-CD"
"TTATTGCGTGGCTAGA"	"Cyst.IM-CD"
"TTATTGCTCACATTGG"	"Cyst.IM-CD"
"TTATTGCTCCTAGAGT"	"Cyst.PC-CD"
"TTCAATCCATGAAAGT"	"Cyst.IC-A_2"
"TTCAATCGTACAGTCT"	"Cyst.CD"
"TTCAATCTCACTTTGT"	"Podocytes"
"TTCAATCTCCCGTTCA"	"Cyst.IC-A_1"
"TTCACCGAGTTACGGG"	"Cyst.PC-CD"
"TTCACCGGTTGCCAAT"	"Cyst.PC-CD"
"TTCACCGTCATGAGGG"	"PEC"
"TTCACGCAGGAACTCG"	"Cyst.PT_1"
"TTCACGCAGGCACGAT"	"Cyst.IC-A_1"
"TTCACGCAGTCACGAG"	"Cyst.PT_1"
"TTCACGCCAGCTAACT"	"Cyst.PC-CD"
"TTCACGCGTTACACTG"	"Cyst.IC-A_2"
"TTCAGGAAGCATTTGC"	"Cyst.PC-CD"
"TTCAGGAAGTCGCGAA"	"Podocytes"
"TTCAGGACAGTGCGCT"	"Cyst.IM-CD"
"TTCAGGAGTACTGCGC"	"Mast-cell"
"TTCAGGAGTCGAACAG"	"Cyst.cTAL"
"TTCAGGATCTCGTCGT"	"Cyst.IM-CD"
"TTCAGGATCTTCGGAA"	"Cyst.CD"
"TTCATGTAGATTAGAC"	"Cyst.IM-CD"
"TTCATGTCACCCTGAG"	"Cyst.PC-CD"
"TTCATGTCAGGTGAGT"	"Cyst.IM-CD"
"TTCATGTTCTTCTTCC"	"Cyst.cTAL"
"TTCATGTTCTTTCAGT"	"PEC"
"TTCATTGAGCAACTTC"	"Cyst.PC-CD"
"TTCATTGAGTCGCGAA"	"Cyst.PC-CD"
"TTCATTGCAATGTCAC"	"Cyst.PC-CD"
"TTCATTGCACGCGGTT"	"Cyst.PC-CD"
"TTCATTGCAGCATACT"	"Cyst.PT_1"
"TTCATTGCAGGCGATA"	"Mac/DC"
"TTCATTGCATCCTAAG"	"B-cell_1"
"TTCATTGGTTTCGCTC"	"Cyst.PC-CD"
"TTCATTGTCATACGGT"	"PEC"
"TTCATTGTCCCGTGAG"	"Cyst.PC-CD"
"TTCCAATAGATGTAGT"	"Mac/DC"
"TTCCAATAGGTCCCTG"	"Podocytes"
"TTCCAATCAAGTTCGT"	"PEC"
"TTCCAATCACCCAACG"	"PEC"
"TTCCAATCACTGGAAG"	"Cyst.PC-CD"
"TTCCAATCATATGGCT"	"Cyst.IC-A_1"
"TTCCAATGTACACTCA"	"Cyst.PC-CD"
"TTCCAATTCCCGGTAG"	"Cyst.PC-CD"
"TTCCAATTCGTTACCC"	"Cyst.PT_1"
"TTCCACGAGTAAACTG"	"VSMC"
"TTCCACGCAGACGGAT"	"PEC"
"TTCCACGCAGTCGGTC"	"Cyst.PC-CD"
"TTCCACGGTATCGTGT"	"Cyst.IM-CD"
"TTCCACGGTCACCGAC"	"Cyst.PC-CD"
"TTCCACGGTCAGGTAG"	"Cyst.PC-CD"
"TTCCACGTCTGAACGT"	"Cyst.PC-CD"
"TTCCGGTAGAGTAACT"	"PEC"
"TTCCGGTAGTGCGTCC"	"PEC"
"TTCCGGTAGTTGGCGA"	"Cyst.cTAL"
"TTCCGGTGTGTCCGTG"	"Cyst.IC-A_2"
"TTCCGTGAGGGCAATC"	"Cyst.IM-CD"
"TTCCGTGTCAGAGTTC"	"Cyst.IM-CD"
"TTCCGTGTCGCGAAGA"	"PEC"
"TTCCGTGTCTTCGACC"	"PEC"
"TTCCTAACACCGTGAC"	"Cyst.cTAL"
"TTCCTAAGTAGGCTCC"	"Cyst.PC-CD"
"TTCCTAAGTGCATTTG"	"Cyst.IC-A_1"
"TTCCTAAGTTAGGAGC"	"EC"
"TTCCTCTAGAGATGCC"	"Cyst.PC-CD"
"TTCCTCTAGAGGTCGT"	"PEC"
"TTCCTCTCAGACATCT"	"Cyst.cTAL"
"TTCCTCTCATTCGGGC"	"Cyst.IC-A_2"
"TTCCTCTGTACCAGAG"	"PEC"
"TTCCTCTGTCCCTGTT"	"Cyst.IC-A_1"
"TTCCTCTGTTTACCTT"	"Cyst.PC-CD"
"TTCCTCTTCCATTCGC"	"PEC"
"TTCCTCTTCGCCGAAC"	"Cyst.IM-CD"
"TTCCTCTTCGCCGATG"	"Cyst.IC-A_2"
"TTCCTCTTCGTTAGAC"	"Cyst.IM-CD"
"TTCCTTCAGAGGTTTA"	"Cyst.PC-CD"
"TTCCTTCAGCGGACAT"	"Cyst.PC-CD"
"TTCCTTCAGTGGATAT"	"Podocytes"
"TTCCTTCCAGTAGAGC"	"Cyst.cTAL"
"TTCCTTCGTGGCAGAT"	"PEC"
"TTCCTTCGTGTTATCG"	"Cyst.PC-CD"
"TTCCTTCGTTAAGGAT"	"VSMC"
"TTCGATTAGAAGAGCA"	"PEC"
"TTCGATTAGCGGGTTA"	"Cyst.PC-CD"
"TTCGATTCACTTGACA"	"PEC"
"TTCGATTCAGATTCGT"	"Podocytes"
"TTCGATTCATAATCCG"	"PEC"
"TTCGATTGTCTCGGGT"	"Cyst.PT_1"
"TTCGATTGTGGCGTAA"	"Cyst.PC-CD"
"TTCGATTTCCAACCGG"	"Cyst.IC-A_1"
"TTCGATTTCCCTTCCC"	"Cyst.PC-CD"
"TTCGATTTCGAAGGAC"	"Cyst.cTAL"
"TTCGATTTCTGTCGTC"	"Cyst.PC-CD"
"TTCGCTGCAAGAAATC"	"Cyst.IC-A_1"
"TTCGCTGCAGAGTCTT"	"Mac/DC"
"TTCGCTGCAGGAGGAG"	"Cyst.cTAL"
"TTCGCTGGTTCTCCCA"	"Cyst.CD"
"TTCGCTGGTTGGAGAC"	"Cyst.PC-CD"
"TTCGCTGGTTTACGAC"	"Cyst.IM-CD"
"TTCGCTGTCACCCATC"	"Cyst.PT_1"
"TTCGCTGTCGCTAATG"	"PEC"
"TTCGGTCAGAGATCGC"	"EC"
"TTCGGTCAGGCACTAG"	"Cyst.IM-CD"
"TTCGGTCCAACAGTGG"	"Cyst.PC-CD"
"TTCGGTCGTATCGCGC"	"Cyst.PC-CD"
"TTCGGTCGTCACAATC"	"Cyst.IM-CD"
"TTCTAACCACAGACGA"	"Cyst.PC-CD"
"TTCTAACGTCCATCTC"	"Mac/DC"
"TTCTAACGTTACTCAG"	"PEC"
"TTCTAACGTTCGAACT"	"PEC"
"TTCTAACTCTGCGAGC"	"PEC"
"TTCTAGTAGAGGTTAT"	"Podocytes"
"TTCTAGTCAGACCTGC"	"Cyst.PC-CD"
"TTCTAGTCAGCGATTT"	"Cyst.PC-CD"
"TTCTAGTGTGTCCATA"	"Cyst.IM-CD"
"TTCTAGTTCATCTACT"	"Cyst.PC-CD"
"TTCTAGTTCATGGTAC"	"Cyst.IM-CD"
"TTCTAGTTCGGTGAAG"	"Mast-cell"
"TTCTAGTTCTTGGCTC"	"Cyst.PC-CD"
"TTCTCTCAGAACTCCT"	"Cyst.cTAL"
"TTCTCTCAGAGTGTTA"	"Cyst.PT_1"
"TTCTCTCAGGCCTGCT"	"Mast-cell"
"TTCTCTCCAAATGGCG"	"PEC"
"TTCTCTCGTACTAAGA"	"Cyst.PT_1"
"TTCTCTCGTCAAACGG"	"Cyst.PC-CD"
"TTCTCTCGTGGCATCC"	"Cyst.IM-CD"
"TTCTCTCGTTCCAAAC"	"Cyst.IC-A_1"
"TTCTCTCTCTTGGTCC"	"Cyst.cTAL"
"TTCTGTAAGGTTAGTA"	"Cyst.PC-CD"
"TTCTGTACACGCGGTT"	"Cyst.PC-CD"
"TTCTGTACATCTCCCA"	"Cyst.IC-A_2"
"TTCTGTATCATATGGC"	"Cyst.PC-CD"
"TTCTGTATCCATACAG"	"Cyst.IC-A_2"
"TTCTTCCAGCACTAGG"	"EC"
"TTCTTCCAGCTCCCTT"	"Cyst.IM-CD"
"TTCTTCCAGGCCCACT"	"B-cell_1"
"TTCTTCCCACAACATC"	"Cyst.IM-CD"
"TTCTTCCCATGTCAGT"	"Cyst.IM-CD"
"TTCTTCCGTCTGTTAG"	"Cyst.PT_1"
"TTCTTCCGTTAGTCGT"	"Cyst.IM-CD"
"TTCTTCCGTTGCAAGG"	"Cyst.IM-CD"
"TTCTTCCGTTGGACCC"	"Cyst.IM-CD"
"TTCTTCCTCCGCTTAC"	"Cyst.PC-CD"
"TTCTTCCTCGAGTACT"	"Podocytes"
"TTCTTCCTCGCGGTAC"	"Cyst.IC-A_2"
"TTCTTCCTCGCTCATC"	"Cyst.IM-CD"
"TTCTTCCTCTGGACCG"	"Cyst.IC-A_2"
"TTCTTGAAGTCATGAA"	"Cyst.PC-CD"
"TTCTTGAAGTGGCCTC"	"Cyst.PC-CD"
"TTCTTGACACGGATCC"	"Cyst.IC-A_2"
"TTCTTGACAGTTTGGT"	"Cyst.CD"
"TTCTTGAGTTCAAGTC"	"Cyst.PC-CD"
"TTCTTGAGTTGAAGTA"	"VSMC"
"TTCTTGAGTTGCATGT"	"Cyst.IC-A_1"
"TTCTTGATCGCATAGT"	"PEC"
"TTCTTGATCGTGCAGC"	"Cyst.PC-CD"
"TTGAACGAGTTTGTCG"	"Podocytes"
"TTGAACGTCGCTGTTC"	"Mac/DC"
"TTGACCCAGACCAGAC"	"Cyst.IC-A_2"
"TTGACCCAGATACGAT"	"Cyst.PT_1"
"TTGACCCCAAATGAGT"	"T-cell"
"TTGACCCGTCCATACA"	"Cyst.cTAL"
"TTGACCCGTCCATAGT"	"Cyst.PC-CD"
"TTGACCCGTGATACAA"	"Podocytes"
"TTGACCCGTTGGGAAC"	"Podocytes"
"TTGACCCTCCAATCCC"	"PEC"
"TTGACCCTCCGCACGA"	"PEC"
"TTGAGTGAGCAGTAAT"	"Mast-cell"
"TTGAGTGAGGAACGTC"	"Cyst.IC-A_1"
"TTGAGTGGTGAGGAAA"	"Mast-cell"
"TTGAGTGTCCTAGCTC"	"Cyst.IM-CD"
"TTGAGTGTCGTTGTGA"	"Cyst.IC-A_2"
"TTGAGTGTCTAGGAAA"	"Cyst.PC-CD"
"TTGATGGCATCCGAAT"	"VSMC"
"TTGATGGGTCCTATAG"	"Podocytes"
"TTGATGGTCCAGTTCC"	"PEC"
"TTGCATTAGCAGTACG"	"Cyst.PC-CD"
"TTGCATTAGGCACAAC"	"Mast-cell"
"TTGCATTAGGTCGTGA"	"T-cell"
"TTGCATTCATTGAAAG"	"Mast-cell"
"TTGCATTGTAGCCAGA"	"PEC"
"TTGCATTTCAACGCTA"	"PEC"
"TTGCATTTCTTAATCC"	"Podocytes"
"TTGCCTGAGATGAATC"	"Cyst.PC-CD"
"TTGCCTGAGGTTAGTA"	"Cyst.PC-CD"
"TTGCCTGCACGTCGTG"	"PEC"
"TTGCCTGGTCGTACTA"	"Cyst.cTAL"
"TTGCCTGTCTCTTGCG"	"Cyst.PC-CD"
"TTGCGTCAGAAGAGCA"	"Cyst.PC-CD"
"TTGCGTCAGCTGAAGC"	"Cyst.cTAL"
"TTGCGTCAGGGCTGAT"	"Cyst.PC-CD"
"TTGCGTCCATCTCGTC"	"Mac/DC"
"TTGCGTCGTCACTGAT"	"T-cell"
"TTGCGTCTCGACGCGT"	"EC"
"TTGCGTCTCGTTCGCT"	"Mast-cell"
"TTGCTGCAGATTAGAC"	"Cyst.CD"
"TTGCTGCAGTATTGCC"	"Cyst.IM-CD"
"TTGCTGCCAAATCCCA"	"B-cell_1"
"TTGCTGCCACGCCAGT"	"Cyst.PC-CD"
"TTGCTGCCACGCGTCA"	"Cyst.IC-A_1"
"TTGCTGCCAGCTTTGA"	"Cyst.PC-CD"
"TTGCTGCCATGCAGGA"	"Cyst.IM-CD"
"TTGCTGCGTAGAGATT"	"Cyst.IM-CD"
"TTGCTGCGTGTATCCA"	"Cyst.IM-CD"
"TTGCTGCGTTCTCCCA"	"EC"
"TTGCTGCGTTCTTCAT"	"Cyst.PC-CD"
"TTGCTGCTCAGTCCGG"	"Podocytes"
"TTGGATGAGCAACCAG"	"Cyst.PC-CD"
"TTGGATGAGTCACTAC"	"PEC"
"TTGGATGCAAGTCCAT"	"Mast-cell"
"TTGGATGCACTCACTC"	"Cyst.PC-CD"
"TTGGATGGTTCTCAGA"	"Cyst.PC-CD"
"TTGGGATAGCAAGTCG"	"Cyst.IC-A_1"
"TTGGGATCATACTGTG"	"Cyst.PC-CD"
"TTGGGATGTAGAGTTA"	"Cyst.IC-A_2"
"TTGGGATGTATACAGA"	"Cyst.PC-CD"
"TTGGGATGTCTGCCTT"	"Podocytes"
"TTGGGATGTGCTGCAC"	"Cyst.IC-A_1"
"TTGGGATGTTCTGAGT"	"Cyst.cTAL"
"TTGGGATTCATTGCCC"	"Cyst.IM-CD"
"TTGGGATTCCAGGACC"	"B-cell_2"
"TTGGGATTCCGCAACG"	"Cyst.IC-A_1"
"TTGGGATTCTTACCAT"	"T-cell"
"TTGGGCGAGGGCAAGG"	"Cyst.PC-CD"
"TTGGGCGCATTGAAAG"	"Mast-cell"
"TTGGGCGGTGAGACCA"	"Mac/DC"
"TTGGGCGTCCGACAGC"	"Cyst.IC-A_1"
"TTGGGTAAGCACCCAC"	"Podocytes"
"TTGGGTAAGTGTTCAC"	"Cyst.CD"
"TTGGGTACAAAGTGTA"	"T-cell"
"TTGGGTACAAATTAGG"	"Cyst.cTAL"
"TTGGGTACAAGACAAT"	"Podocytes"
"TTGGGTAGTGGCGTAA"	"Cyst.IM-CD"
"TTGGGTAGTGTCGCTG"	"Cyst.cTAL"
"TTGGGTATCCATTGCC"	"Podocytes"
"TTGGTTTCAAGTGGAC"	"B-cell_2"
"TTGGTTTGTGCACGCT"	"VSMC"
"TTGGTTTTCAAAGAAC"	"Cyst.PC-CD"
"TTGGTTTTCAGCCTTC"	"Cyst.PC-CD"
"TTGGTTTTCCATCTGC"	"Cyst.IM-CD"
"TTGGTTTTCCGCCTAT"	"Cyst.cTAL"
"TTGTGGAAGCAATTAG"	"Cyst.IM-CD"
"TTGTGGAAGCAGCCTC"	"VSMC"
"TTGTGGATCCGCACGA"	"Cyst.IC-A_1"
"TTGTGTTGTACGACAG"	"Podocytes"
"TTGTGTTGTATAGCTC"	"Cyst.IC-A_1"
"TTGTGTTGTATCCCTC"	"Cyst.cTAL"
"TTGTGTTGTTCTCCTG"	"Cyst.PC-CD"
"TTGTGTTTCAAGGACG"	"Cyst.IC-A_2"
"TTGTGTTTCAGACCCG"	"PEC"
"TTGTGTTTCATGGTAC"	"EC"
"TTGTGTTTCGAATCCA"	"PEC"
"TTGTTCAAGGTATCTC"	"PEC"
"TTGTTCAAGGTGCATG"	"Cyst.PC-CD"
"TTGTTCACAACAGAGC"	"Cyst.IM-CD"
"TTGTTCACAAGATGTA"	"Cyst.PC-CD"
"TTGTTCACACCATTCC"	"Cyst.PC-CD"
"TTGTTCACACCGTACG"	"EC"
"TTGTTCACACGACAGA"	"Cyst.PC-CD"
"TTGTTCATCCTAGCTC"	"PEC"
"TTGTTGTAGCATCAAA"	"PEC"
"TTGTTGTCACGGGCTT"	"PEC"
"TTGTTGTGTCCCACGA"	"Cyst.PC-CD"
"TTGTTGTTCGACGCTG"	"Cyst.IC-A_1"
"TTGTTTGAGGATCACG"	"Cyst.IC-A_2"
"TTGTTTGGTCAGTCGC"	"Cyst.IC-A_1"
"TTGTTTGGTCATCCCT"	"Cyst.PC-CD"
"TTGTTTGTCAAGTTGC"	"Mast-cell"
"TTGTTTGTCAGTGTGT"	"Cyst.IM-CD"
"TTGTTTGTCTCGCGTT"	"Cyst.cTAL"
"TTTACCAAGGAACTAT"	"Cyst.PC-CD"
"TTTACCAAGGAGTCTG"	"T-cell"
"TTTACCACACAATTCG"	"PEC"
"TTTACCACACCAGTAT"	"Mac/DC"
"TTTACCACAGACCCGT"	"Cyst.cTAL"
"TTTACCAGTAGACAGC"	"Cyst.PC-CD"
"TTTACCAGTGTTACAC"	"EC"
"TTTACCAGTTTACACG"	"Cyst.PC-CD"
"TTTACCATCATTACGG"	"PEC"
"TTTACGTAGACTACGG"	"Podocytes"
"TTTACGTAGGATACCG"	"Cyst.IM-CD"
"TTTACGTAGTTCATGC"	"Mast-cell"
"TTTACGTCACTGTGTA"	"T-cell"
"TTTACGTGTCTAACTG"	"Cyst.PC-CD"
"TTTACGTGTGGCTGCT"	"PEC"
"TTTACGTGTTCATCTT"	"Cyst.IM-CD"
"TTTACGTTCGGTTCAA"	"VSMC"
"TTTACTGCAAGTGTCT"	"Cyst.PC-CD"
"TTTACTGCATCTAACG"	"Cyst.PC-CD"
"TTTACTGGTATCAGGG"	"Cyst.cTAL"
"TTTACTGGTTGACTGT"	"Podocytes"
"TTTACTGTCACCCATC"	"PEC"
"TTTAGTCAGCACCTGC"	"Mac/DC"
"TTTAGTCCACATGGTT"	"Podocytes"
"TTTAGTCCAGGACAGT"	"Mast-cell"
"TTTAGTCGTGCCTTTC"	"Cyst.IM-CD"
"TTTAGTCGTTGTCATG"	"VSMC"
"TTTAGTCTCATTACTC"	"Cyst.PC-CD"
"TTTAGTCTCATTGCGA"	"Cyst.PC-CD"
"TTTAGTCTCGCTACAA"	"Podocytes"
"TTTAGTCTCTGACGCG"	"EC"
"TTTATGCCATAACTCG"	"Mast-cell"
"TTTATGCGTAGGTAGC"	"Cyst.IM-CD"
"TTTATGCGTGTTCAGT"	"EC"
"TTTATGCGTTCAGGTT"	"Cyst.PC-CD"
"TTTATGCTCGCCTAGG"	"Cyst.IC-A_1"
"TTTATGCTCGGACCAC"	"Podocytes"
"TTTCACAAGCTGACAG"	"Cyst.IM-CD"
"TTTCACACAACAGCTT"	"Cyst.IC-A_2"
"TTTCACACAACCGATT"	"VSMC"
"TTTCACAGTTAAACAG"	"Cyst.IM-CD"
"TTTCACAGTTACACAC"	"VSMC"
"TTTCACAGTTCTATCT"	"Cyst.PC-CD"
"TTTCACAGTTCTTCAT"	"Cyst.PT_2"
"TTTCACATCAACTCTT"	"Cyst.IC-A_2"
"TTTCACATCCACGGAC"	"Mac/DC"
"TTTCAGTAGCCTAACT"	"Cyst.IC-A_1"
"TTTCAGTCAAGCTACT"	"Cyst.PC-CD"
"TTTCAGTCAATGTGGG"	"Podocytes"
"TTTCAGTCACAGCTGC"	"Cyst.cTAL"
"TTTCAGTCACTAACGT"	"EC"
"TTTCAGTCATTCCTCG"	"Podocytes"
"TTTCAGTTCCGATGTA"	"Cyst.IC-A_1"
"TTTCAGTTCTGTAAGC"	"VSMC"
"TTTCAGTTCTTGGAAC"	"Cyst.cTAL"
"TTTCATGAGATGTTGA"	"Cyst.IC-A_1"
"TTTCATGCATAGATCC"	"Cyst.PC-CD"
"TTTCATGCATATCTCT"	"Cyst.IC-A_2"
"TTTCATGTCACTACTT"	"Cyst.IC-A_1"
"TTTCCTCAGCCGCTTG"	"Cyst.cTAL"
"TTTCCTCCAACGCATT"	"T-cell"
"TTTCCTCCAGCGCTTG"	"Cyst.IM-CD"
"TTTCCTCCAGCTAACT"	"Cyst.PC-CD"
"TTTCCTCCAGGTTCAT"	"Cyst.PT_2"
"TTTCCTCGTCTGTAAC"	"Cyst.PC-CD"
"TTTCCTCTCCCAAGTA"	"B-cell_1"
"TTTCCTCTCGAATGCT"	"Cyst.PC-CD"
"TTTCGATAGGCCTTCG"	"Cyst.PC-CD"
"TTTCGATAGGTAAACT"	"Cyst.PC-CD"
"TTTCGATGTTCTGACA"	"Cyst.PC-CD"
"TTTCGATGTTTGAAAG"	"Cyst.IC-A_1"
"TTTCGATTCCTTCTTC"	"Cyst.IM-CD"
"TTTGACTAGATGCTTC"	"Cyst.IM-CD"
"TTTGACTCACTGATTG"	"Cyst.IC-A_2"
"TTTGACTTCAACTTTC"	"PEC"
"TTTGATCCAGACAATA"	"Mast-cell"
"TTTGATCGTATGTCCA"	"Cyst.IC-A_1"
"TTTGATCGTGCTGATT"	"Cyst.IM-CD"
"TTTGATCTCGTACCTC"	"Cyst.PC-CD"
"TTTGATCTCTAGTTCT"	"Cyst.IC-A_1"
"TTTGGAGAGAGCCTGA"	"EC"
"TTTGGAGCAACGGCTC"	"B-cell_1"
"TTTGGAGCAGTGGCTC"	"VSMC"
"TTTGGAGGTTACGGAG"	"Cyst.PC-CD"
"TTTGGAGTCACCGCTT"	"Cyst.IC-A_2"
"TTTGGAGTCAGATGCT"	"Cyst.PC-CD"
"TTTGGAGTCTCTGACC"	"Cyst.PC-CD"
"TTTGGTTAGGTCACCC"	"Cyst.IM-CD"
"TTTGGTTCAAATGCTC"	"Cyst.PC-CD"
"TTTGGTTCAGAGCCCT"	"Cyst.PT_2"
"TTTGGTTGTAACAGGC"	"Cyst.IM-CD"
"TTTGGTTGTACCATAC"	"Cyst.CD"
"TTTGGTTGTCCACATA"	"Cyst.PC-CD"
"TTTGGTTGTCCTATAG"	"PEC"
"TTTGGTTGTGACTGTT"	"Cyst.PC-CD"
"TTTGGTTGTGTTACAC"	"Podocytes"
"TTTGGTTTCCGCAGTG"	"Cyst.IM-CD"
"TTTGGTTTCTAGTCAG"	"Mast-cell"
"TTTGTTGAGTTCCATG"	"EC"
"TTTGTTGGTACGATTC"	"Podocytes"
"TTTGTTGGTAGCCCTG"	"PEC"
"TTTGTTGGTTCAGCTA"	"Cyst.IC-A_1"
"TTTGTTGTCAACTCTT"	"Cyst.IC-A_2"
"TTTGTTGTCGCAACAT"	"Cyst.IC-A_1"
"TTTGTTGTCGTGTTCC"	"Cyst.IC-A_1"
