""	"Ident"
"AAACCCAAGGAAAGGT"	"LOH, MTAL cell"
"AAACCCATCGTGGACC"	"Exclude_hematopoietic"
"AAACGAAAGAATCCCT"	"LOH, MTAL cell"
"AAACGAAAGACGGTTG"	"Exclude_hematopoietic"
"AAACGAAAGCTCCGAC"	"LOH, MTAL cell"
"AAACGAACACAAGCCC"	"Exclude_hematopoietic"
"AAACGCTCATGCACTA"	"Exclude_hematopoietic"
"AAACGCTGTTTCGACA"	"Exclude_hematopoietic"
"AAACGCTTCAAGTCTG"	"Exclude_endothelial"
"AAAGAACAGACGAAGA"	"Exclude_hematopoietic"
"AAAGAACAGATGGGCT"	"Exclude_hematopoietic"
"AAAGAACTCGGTTAGT"	"Exclude_hematopoietic"
"AAAGGATAGTGCTCGC"	"LOH, MTAL cell"
"AAAGGATCACAGTCGC"	"LOH, MTAL cell"
"AAAGGATGTCCTTAAG"	"Exclude_hematopoietic"
"AAAGGATTCCATAAGC"	"Exclude_hematopoietic"
"AAAGGATTCGGAATTC"	"Exclude_hematopoietic"
"AAAGGGCAGAGGGTAA"	"Exclude_hematopoietic"
"AAAGGGCAGGCACTAG"	"Exclude_endothelial"
"AAAGGGCCAACCGGAA"	"TPC_2"
"AAAGGGCGTACAAGTA"	"TPC_2"
"AAAGGGCGTATGAAGT"	"TPC_1"
"AAAGGGCTCAAGCCAT"	"TPC_2"
"AAAGGGCTCCCTCGAT"	"LOH, MTAL cell"
"AAAGGTACAAATTGCC"	"Exclude_hematopoietic"
"AAAGGTACACTTGGGC"	"Exclude_hematopoietic"
"AAAGGTATCATCTCTA"	"Exclude_hematopoietic"
"AAAGGTATCGACGACC"	"Exclude_hematopoietic"
"AAAGGTATCTAGCCAA"	"Exclude_hematopoietic"
"AAAGGTATCTCCACTG"	"LOH, MTAL cell"
"AAAGGTATCTCTGCTG"	"LOH, MTAL cell"
"AAAGTCCCAGTGTATC"	"Exclude_hematopoietic"
"AAAGTCCTCAAGGCTT"	"Exclude_hematopoietic"
"AAAGTCCTCCGACGGT"	"Exclude_hematopoietic"
"AAAGTCCTCTCTCTAA"	"Exclude_hematopoietic"
"AAAGTGACAACGAGGT"	"Exclude_hematopoietic"
"AAAGTGAGTGTGTGGA"	"Exclude_hematopoietic"
"AAAGTGATCAGCTCTC"	"Exclude_hematopoietic"
"AAATGGAAGCACACCC"	"LOH, MTAL cell"
"AAATGGAAGTCGCGAA"	"Exclude_hematopoietic"
"AAATGGACAGCGATTT"	"Exclude_hematopoietic"
"AAATGGACAGCTGTAT"	"PEC"
"AAATGGATCCACGTCT"	"LOH, MTAL cell"
"AAATGGATCGGTTAGT"	"Exclude_hematopoietic"
"AACAAAGAGTCCTGTA"	"Exclude_hematopoietic"
"AACAAAGCAATAGTGA"	"Exclude_hematopoietic"
"AACAAAGCACAGTATC"	"Exclude_hematopoietic"
"AACAAAGCACCCTGTT"	"Exclude_hematopoietic"
"AACAAAGGTGGGCTCT"	"TPC_1"
"AACAAAGTCAACGTGT"	"Exclude_hematopoietic"
"AACAAAGTCCGTACGG"	"Exclude_hematopoietic"
"AACAAAGTCGCTCATC"	"Exclude_hematopoietic"
"AACAACCCAACGTATC"	"Exclude_hematopoietic"
"AACAACCCAACTGAAA"	"Exclude_hematopoietic"
"AACAACCCATCGGAGA"	"Exclude_endothelial"
"AACAAGAAGCGAGTCA"	"Exclude_hematopoietic"
"AACAAGACAAATGAAC"	"Exclude_hematopoietic"
"AACAAGAGTGACTGTT"	"Exclude_hematopoietic"
"AACACACAGCAGGCAT"	"Exclude_hematopoietic"
"AACACACCACGCCAGT"	"Exclude_hematopoietic"
"AACACACGTCAAGGCA"	"PEC"
"AACACACGTCAATGGG"	"Exclude_hematopoietic"
"AACACACTCAGCACCG"	"Exclude_hematopoietic"
"AACACACTCGCTCTAC"	"Exclude_hematopoietic"
"AACACACTCGTTCTCG"	"Exclude_hematopoietic"
"AACAGGGCATACATCG"	"Exclude_hematopoietic"
"AACAGGGCATGAATAG"	"Exclude_hematopoietic"
"AACAGGGGTCCACTCT"	"Exclude_hematopoietic"
"AACCAACAGCCTTTGA"	"Exclude_hematopoietic"
"AACCAACAGCGTGAGT"	"Exclude_hematopoietic"
"AACCAACTCATGACAC"	"Exclude_hematopoietic"
"AACCAACTCTCGGTCT"	"LOH, MTAL cell"
"AACCACAGTTTGGGAG"	"TPC_1"
"AACCATGCAAAGCTAA"	"Exclude_hematopoietic"
"AACCATGCACAAATAG"	"Exclude_hematopoietic"
"AACCATGGTACCAGAG"	"Exclude_hematopoietic"
"AACCATGGTCACTCGG"	"Exclude_hematopoietic"
"AACCATGGTCGTTTCC"	"TPC_2"
"AACCATGTCGTGTCAA"	"TPC_1"
"AACCCAAAGCTCGGCT"	"Exclude_hematopoietic"
"AACCTGAAGCATTTGC"	"Exclude_hematopoietic"
"AACCTGAAGGCTGGAT"	"TPC_1"
"AACCTGATCAGTGTCA"	"TPC_2"
"AACCTGATCGCGCCAA"	"Exclude_hematopoietic"
"AACCTTTGTAGACGGT"	"TPC_1"
"AACCTTTTCTCCCAAC"	"Exclude_hematopoietic"
"AACGAAAGTGCGTTTA"	"Exclude_hematopoietic"
"AACGGGAAGTTGAAAC"	"LOH, MTAL cell"
"AACGGGACATAACAGA"	"LOH, MTAL cell"
"AACGGGAGTTCAAAGA"	"Exclude_hematopoietic"
"AACGGGATCATAGGCT"	"Exclude_hematopoietic"
"AACGTCAAGCCGATAG"	"Exclude_hematopoietic"
"AACGTCACAACACAGG"	"LOH, MTAL cell"
"AACTTCTCAATAGGGC"	"Exclude_hematopoietic"
"AAGAACAAGGTGCTTT"	"LOH, MTAL cell"
"AAGAACACAATAGTCC"	"Exclude_hematopoietic"
"AAGAACATCACGACTA"	"Exclude_hematopoietic"
"AAGACAAAGGTCGTCC"	"Exclude_hematopoietic"
"AAGACAACAAGGTCGA"	"Exclude_hematopoietic"
"AAGACAACATGAGAAT"	"Exclude_hematopoietic"
"AAGACAAGTACGTTCA"	"Exclude_hematopoietic"
"AAGACAAGTCCCGGTA"	"TPC_1"
"AAGACAATCCTCTTTC"	"LOH, MTAL cell"
"AAGACAATCCTGGCTT"	"LOH, MTAL cell"
"AAGACTCAGATTACCC"	"Exclude_hematopoietic"
"AAGACTCCAAGTTCGT"	"Exclude_hematopoietic"
"AAGACTCCAGACCCGT"	"Exclude_hematopoietic"
"AAGACTCCATCACAGT"	"Exclude_hematopoietic"
"AAGACTCTCATTACGG"	"Exclude_hematopoietic"
"AAGACTCTCCGGACTG"	"Exclude_hematopoietic"
"AAGATAGCAACCACGC"	"Exclude_endothelial"
"AAGATAGGTCAAACGG"	"Exclude_hematopoietic"
"AAGATAGTCCGCTAGG"	"Exclude_hematopoietic"
"AAGCATCCAAGAGATT"	"LOH, MTAL cell"
"AAGCATCCAGTTTGGT"	"TPC_2"
"AAGCATCTCAGCAATC"	"Exclude_hematopoietic"
"AAGCATCTCTCCTACG"	"LOH, MTAL cell"
"AAGCCATGTGGAACAC"	"Exclude_hematopoietic"
"AAGCCATTCACATCAG"	"Exclude_hematopoietic"
"AAGCCATTCATAGCAC"	"Exclude_hematopoietic"
"AAGCGAGCAACCAACT"	"Exclude_hematopoietic"
"AAGCGAGCAGAGGACT"	"Exclude_hematopoietic"
"AAGCGTTTCACATACG"	"Exclude_hematopoietic"
"AAGCGTTTCTCGCTTG"	"Exclude_hematopoietic"
"AAGGAATCAAGACCGA"	"Exclude_hematopoietic"
"AAGGAATCACGGCTAC"	"LOH, MTAL cell"
"AAGGAATCAGACCTGC"	"LOH, MTAL cell"
"AAGGAATCAGCTACCG"	"Exclude_hematopoietic"
"AAGGAATGTGATAGTA"	"Exclude_hematopoietic"
"AAGGAATGTGCCCTTT"	"Exclude_hematopoietic"
"AAGGAATGTTGTTGTG"	"Exclude_hematopoietic"
"AAGGAATTCCCTAGGG"	"Exclude_hematopoietic"
"AAGGAATTCGGTCAGC"	"Exclude_hematopoietic"
"AAGGTAATCACGAACT"	"Exclude_hematopoietic"
"AAGTACCCAACGCATT"	"TPC_1"
"AAGTACCCACCAGCGT"	"Exclude_hematopoietic"
"AAGTACCCACGATAGG"	"Exclude_hematopoietic"
"AAGTACCCAGGGAATC"	"Exclude_hematopoietic"
"AAGTCGTCATCCGATA"	"Exclude_hematopoietic"
"AAGTCGTGTCCATCTC"	"Exclude_hematopoietic"
"AAGTCGTGTCCCTAAA"	"Exclude_hematopoietic"
"AAGTGAAAGAGCTGAC"	"Exclude_hematopoietic"
"AAGTGAACACACCTAA"	"LOH, MTAL cell"
"AAGTGAACATCAGTCA"	"Exclude_hematopoietic"
"AAGTGAAGTACCGTCG"	"TPC_1"
"AAGTTCGAGGTGGCTA"	"Exclude_hematopoietic"
"AAGTTCGCAAACGAGC"	"LOH, MTAL cell"
"AAGTTCGGTAGACTGG"	"LOH, MTAL cell"
"AAGTTCGTCGTTACCC"	"Exclude_hematopoietic"
"AAGTTCGTCTTGGGCG"	"Exclude_hematopoietic"
"AATAGAGCATAACAGA"	"Exclude_hematopoietic"
"AATAGAGCATCCTAAG"	"Exclude_hematopoietic"
"AATAGAGTCGGCGATC"	"LOH, MTAL cell"
"AATCACGAGAATTGTG"	"Exclude_endothelial"
"AATCACGAGAGCAGAA"	"Exclude_hematopoietic"
"AATCACGCACAAGCAG"	"LOH, MTAL cell"
"AATCACGCACTCCGAG"	"LOH, MTAL cell"
"AATCACGTCGGCATCG"	"Exclude_hematopoietic"
"AATCGACAGATTACCC"	"Exclude_hematopoietic"
"AATCGACCACACTGGC"	"Exclude_hematopoietic"
"AATCGACGTACTAGCT"	"Exclude_hematopoietic"
"AATCGACGTTGTAGCT"	"LOH, MTAL cell"
"AATCGACTCTAGTGAC"	"Exclude_hematopoietic"
"AATCGTGAGATGCTTC"	"Exclude_hematopoietic"
"AATCGTGCAGGTAGTG"	"Exclude_endothelial"
"AATCGTGGTCATATGC"	"TPC_2"
"AATCGTGGTCGTTATG"	"Exclude_hematopoietic"
"AATGAAGAGGGCAACT"	"LOH, MTAL cell"
"AATGAAGAGTCAAGCG"	"Exclude_hematopoietic"
"AATGAAGCAAGGTCGA"	"Exclude_hematopoietic"
"AATGAAGGTCGAAACG"	"Exclude_hematopoietic"
"AATGAAGTCACGAACT"	"LOH, MTAL cell"
"AATGACCTCACTACGA"	"Exclude_hematopoietic"
"AATGCCACACGGCCAT"	"Exclude_hematopoietic"
"AATGGAACATATGAAG"	"LOH, MTAL cell"
"AATGGAAGTAACAGTA"	"Exclude_hematopoietic"
"AATGGCTCAGCAGTCC"	"Exclude_hematopoietic"
"AATGGCTCATCTGCGG"	"Exclude_hematopoietic"
"AATGGCTGTATACCCA"	"Exclude_hematopoietic"
"AATGGCTTCCGCCTAT"	"Exclude_hematopoietic"
"AATTCCTAGACTCAAA"	"LOH, MTAL cell"
"AATTCCTAGCAGTCTT"	"Exclude_hematopoietic"
"AATTCCTCAAGGACAC"	"Exclude_hematopoietic"
"AATTCCTCATGACTGT"	"LOH, MTAL cell"
"AATTCCTGTGGACCAA"	"Exclude_hematopoietic"
"AATTCCTGTTAAACCC"	"Exclude_hematopoietic"
"AATTTCCAGAGTCTTC"	"Exclude_hematopoietic"
"AATTTCCGTGTACAGG"	"Exclude_hematopoietic"
"AATTTCCGTTATGGTC"	"Exclude_hematopoietic"
"AATTTCCTCAAGGAGC"	"Exclude_hematopoietic"
"ACAAAGACATCCGAGC"	"LOH, MTAL cell"
"ACAAAGAGTATGGTTC"	"Exclude_hematopoietic"
"ACAACCAAGAGAGCCT"	"Exclude_hematopoietic"
"ACAACCAAGGTAGCCA"	"Exclude_hematopoietic"
"ACAACCACACTTGAGT"	"Exclude_hematopoietic"
"ACAACCACAGCATTGT"	"Exclude_hematopoietic"
"ACAACCACAGTCAGTT"	"Exclude_endothelial"
"ACAACCAGTGACTATC"	"Exclude_hematopoietic"
"ACAACCAGTGTCTTAG"	"Exclude_hematopoietic"
"ACAACCAGTTGCGGCT"	"Exclude_hematopoietic"
"ACAAGCTCAGTGGCTC"	"LOH, MTAL cell"
"ACAAGCTTCTGGACTA"	"LOH, MTAL cell"
"ACACAGTTCACTTGGA"	"Exclude_hematopoietic"
"ACACCAAGTCGGTGTC"	"Exclude_hematopoietic"
"ACACCAAGTTCAGCTA"	"TPC_1"
"ACACGCGGTTTAGACC"	"Exclude_hematopoietic"
"ACACGCGTCTGCTCTG"	"Exclude_hematopoietic"
"ACACTGAAGGATTTAG"	"Exclude_hematopoietic"
"ACACTGAAGGTTCACT"	"Exclude_hematopoietic"
"ACACTGAAGTAGAGTT"	"Exclude_hematopoietic"
"ACACTGAAGTCGCTAT"	"TPC_2"
"ACACTGAGTACAAGTA"	"Exclude_hematopoietic"
"ACACTGAGTCACTTAG"	"Exclude_hematopoietic"
"ACACTGATCTCTAAGG"	"TPC_1"
"ACACTGATCTCTCTAA"	"Exclude_hematopoietic"
"ACAGAAACAAAGACTA"	"TPC_1"
"ACAGAAACAGCGTGAA"	"TPC_2"
"ACAGAAACAGCGTTTA"	"Exclude_hematopoietic"
"ACAGAAAGTAGGACTG"	"Exclude_hematopoietic"
"ACAGCCGAGCTGTTCA"	"Exclude_hematopoietic"
"ACAGCCGCAATTCTCT"	"Exclude_hematopoietic"
"ACAGCCGCACCTTCCA"	"TPC_2"
"ACAGCCGTCGAAGCCC"	"LOH, MTAL cell"
"ACAGGGACAAATGAAC"	"TPC_2"
"ACAGGGATCCACATAG"	"TPC_2"
"ACAGGGATCTCTATAC"	"Exclude_hematopoietic"
"ACATCCCAGAGGACTC"	"Exclude_hematopoietic"
"ACATCCCCAAGTCATC"	"Exclude_hematopoietic"
"ACATCCCCATCCTAAG"	"Exclude_hematopoietic"
"ACATCGAAGTAACCTC"	"Exclude_hematopoietic"
"ACATCGAAGTAGCATA"	"Exclude_hematopoietic"
"ACATCGACAGAACATA"	"Exclude_hematopoietic"
"ACATCGAGTTGTTGCA"	"Exclude_hematopoietic"
"ACATGCACAGCACACC"	"Exclude_hematopoietic"
"ACATGCAGTGTCATCA"	"Exclude_hematopoietic"
"ACATTTCCAACGAGGT"	"Exclude_hematopoietic"
"ACATTTCCATGACAGG"	"TPC_2"
"ACATTTCTCCTGTTGC"	"Exclude_hematopoietic"
"ACCAAACAGCAGCCCT"	"TPC_2"
"ACCAAACCAAGACGGT"	"LOH, MTAL cell"
"ACCAAACCAGAGACTG"	"Exclude_hematopoietic"
"ACCAAACCAGGCTACC"	"Exclude_hematopoietic"
"ACCAACAAGTTGCCCG"	"Exclude_hematopoietic"
"ACCAACAGTAGTGCGA"	"Exclude_hematopoietic"
"ACCACAAAGCGACATG"	"Exclude_hematopoietic"
"ACCACAATCCGCGATG"	"Exclude_hematopoietic"
"ACCACAATCTCACTCG"	"LOH, MTAL cell"
"ACCACAATCTGGGATT"	"Exclude_hematopoietic"
"ACCATTTCATAACTCG"	"Exclude_hematopoietic"
"ACCCAAAAGGTCCAGA"	"TPC_2"
"ACCCAAAAGTCTCTGA"	"Exclude_hematopoietic"
"ACCCAAACACATTACG"	"Exclude_hematopoietic"
"ACCCAAATCGACGCTG"	"Exclude_hematopoietic"
"ACCCAAATCGTAGTGT"	"TPC_2"
"ACCCTCAAGCATTTCG"	"Exclude_hematopoietic"
"ACCCTCACAGGACTTT"	"Exclude_hematopoietic"
"ACCCTCAGTACGAGTG"	"Exclude_hematopoietic"
"ACCCTCAGTTACCTGA"	"Exclude_hematopoietic"
"ACCCTCATCTCATTGT"	"Exclude_hematopoietic"
"ACCCTTGAGTTGGACG"	"LOH, MTAL cell"
"ACCCTTGCACACGTGC"	"Exclude_hematopoietic"
"ACCCTTGGTGCATGTT"	"Exclude_hematopoietic"
"ACCCTTGGTGGGCTTC"	"Exclude_hematopoietic"
"ACCCTTGTCTATGTGG"	"Exclude_hematopoietic"
"ACCGTTCCACAAGCCC"	"Exclude_hematopoietic"
"ACCGTTCCACTCGATA"	"Exclude_hematopoietic"
"ACCGTTCGTCGAAGCA"	"Exclude_hematopoietic"
"ACCGTTCGTTACCGTA"	"Exclude_hematopoietic"
"ACCGTTCTCACAAGGG"	"LOH, MTAL cell"
"ACCGTTCTCCATTGTT"	"IC-A"
"ACCGTTCTCGTTCTGC"	"LOH, MTAL cell"
"ACCTACCGTACGAGCA"	"Exclude_hematopoietic"
"ACCTACCGTGTTCGAT"	"Exclude_hematopoietic"
"ACCTGAAAGAGTTGCG"	"Exclude_hematopoietic"
"ACCTGAAAGCGTACAG"	"Exclude_hematopoietic"
"ACCTGAACACAGCGCT"	"TPC_1"
"ACCTGAAGTTTGGAGG"	"Exclude_hematopoietic"
"ACCTGTCCATTGAGCT"	"TPC_2"
"ACCTGTCGTGGACAGT"	"Exclude_hematopoietic"
"ACCTGTCTCTCAACGA"	"Exclude_hematopoietic"
"ACCTGTCTCTGGTGGC"	"Exclude_hematopoietic"
"ACGATCAAGAAGGTAG"	"Exclude_hematopoietic"
"ACGATCAAGAGCCGAT"	"Exclude_hematopoietic"
"ACGATCAAGCTTGTGT"	"TPC_2"
"ACGATCAAGGCAGTCA"	"Exclude_hematopoietic"
"ACGATCACAAGATGTA"	"Exclude_hematopoietic"
"ACGATCACAGGAATAT"	"Exclude_hematopoietic"
"ACGATCACATCCAACA"	"Exclude_hematopoietic"
"ACGATCACATGGAACG"	"Exclude_hematopoietic"
"ACGATCAGTGAGCCAA"	"Exclude_hematopoietic"
"ACGATGTAGCAGTACG"	"Exclude_hematopoietic"
"ACGATGTCAAATTGCC"	"TPC_2"
"ACGATGTGTCGTGTTA"	"TPC_2"
"ACGATGTGTTGCATCA"	"TPC_2"
"ACGATGTTCAGCACCG"	"LOH, MTAL cell"
"ACGATGTTCATTGCGA"	"Exclude_hematopoietic"
"ACGATGTTCCGGTAAT"	"TPC_1"
"ACGCACGAGCAGATAT"	"Exclude_hematopoietic"
"ACGCACGCAGGATTCT"	"Exclude_hematopoietic"
"ACGCACGGTGTTACTG"	"Exclude_endothelial"
"ACGCACGTCGCACTCT"	"LOH, MTAL cell"
"ACGCACGTCTCCACTG"	"Exclude_endothelial"
"ACGGAAGGTGATGAAT"	"Exclude_hematopoietic"
"ACGGGTCTCTAGGCCG"	"Exclude_hematopoietic"
"ACGGTCGGTTGTGGAG"	"TPC_2"
"ACGGTCGTCCCAGTGG"	"Exclude_hematopoietic"
"ACGGTCGTCTTTCGAT"	"LOH, MTAL cell"
"ACGGTTAAGCTGAAGC"	"Exclude_hematopoietic"
"ACGGTTAAGGTAGACC"	"Exclude_hematopoietic"
"ACGGTTACACAGCTTA"	"Exclude_hematopoietic"
"ACGGTTACATTGCCTC"	"Exclude_hematopoietic"
"ACGGTTATCAAGGAGC"	"Exclude_hematopoietic"
"ACGGTTATCCATCTAT"	"Exclude_hematopoietic"
"ACGTAACAGTCAATCC"	"Exclude_hematopoietic"
"ACGTACAAGCCTGGAA"	"Exclude_hematopoietic"
"ACGTACAAGTGCAGGT"	"TPC_1"
"ACGTACATCATCGTAG"	"Exclude_hematopoietic"
"ACGTAGTCACACTTAG"	"Exclude_hematopoietic"
"ACGTAGTCACTCACTC"	"Exclude_hematopoietic"
"ACGTCCTAGGTTCCAT"	"Exclude_hematopoietic"
"ACGTCCTCAATAACGA"	"Exclude_hematopoietic"
"ACGTCCTCAGCTGTGC"	"PEC"
"ACGTCCTTCACTGTCC"	"Exclude_hematopoietic"
"ACGTCCTTCCAACCGG"	"Exclude_hematopoietic"
"ACGTTCCAGGTGCTAG"	"TPC_2"
"ACGTTCCCATGGTACT"	"Exclude_hematopoietic"
"ACGTTCCGTAGACGGT"	"TPC_2"
"ACGTTCCTCCACATAG"	"TPC_2"
"ACTACGAAGTCACGAG"	"Exclude_hematopoietic"
"ACTACGACAAGAGGTC"	"Exclude_hematopoietic"
"ACTACGACATGACCCG"	"Exclude_hematopoietic"
"ACTACGAGTAGACGGT"	"LOH, MTAL cell"
"ACTACGAGTCGCCTAG"	"TPC_2"
"ACTACGAGTGAAAGTT"	"Exclude_hematopoietic"
"ACTACGATCATGGCCG"	"Exclude_endothelial"
"ACTACGATCTGAGGCC"	"Exclude_hematopoietic"
"ACTACGATCTGGCCGA"	"TPC_2"
"ACTATCTGTGTATCCA"	"TPC_2"
"ACTATCTTCCTCAGGG"	"Exclude_hematopoietic"
"ACTATGGCAACACAAA"	"Exclude_hematopoietic"
"ACTATGGCAGACGGAT"	"TPC_2"
"ACTATGGCATCACAGT"	"LOH, MTAL cell"
"ACTATGGTCGAGATGG"	"LOH, MTAL cell"
"ACTATGGTCGCTGTCT"	"Exclude_hematopoietic"
"ACTATTCAGAAGTCAT"	"Exclude_hematopoietic"
"ACTATTCAGATAACAC"	"Exclude_hematopoietic"
"ACTATTCCAGCGACAA"	"Exclude_hematopoietic"
"ACTATTCGTGTGTCGC"	"Exclude_hematopoietic"
"ACTCCCACAATCTCTT"	"LOH, MTAL cell"
"ACTCCCACAGTCAGTT"	"Exclude_hematopoietic"
"ACTCCCAGTAGTCTTG"	"LOH, MTAL cell"
"ACTCCCAGTCACCCTT"	"Exclude_hematopoietic"
"ACTCCCAGTCGGATTT"	"LOH, MTAL cell"
"ACTCCCATCAACTGGT"	"LOH, MTAL cell"
"ACTCTCGAGTTACTCG"	"Exclude_hematopoietic"
"ACTCTCGTCGCTAATG"	"LOH, MTAL cell"
"ACTGATGAGTAGAATC"	"Exclude_hematopoietic"
"ACTGATGCACCGTGCA"	"Exclude_hematopoietic"
"ACTGATGCACGCTGTG"	"Exclude_hematopoietic"
"ACTGATGCATTGAAGA"	"Exclude_hematopoietic"
"ACTGATGGTAGAGATT"	"Exclude_hematopoietic"
"ACTGATGTCGCCGAAC"	"LOH, MTAL cell"
"ACTGCAAAGTAGCCAG"	"Exclude_hematopoietic"
"ACTGCAATCAAGGACG"	"Exclude_hematopoietic"
"ACTGTCCCACAGAGCA"	"Exclude_hematopoietic"
"ACTGTCCGTCCAGGTC"	"Exclude_hematopoietic"
"ACTGTCCGTGACTATC"	"Exclude_hematopoietic"
"ACTGTCCGTTGCATCA"	"Exclude_hematopoietic"
"ACTGTCCTCCAGCCTT"	"Exclude_hematopoietic"
"ACTGTCCTCTACTCAT"	"Exclude_hematopoietic"
"ACTGTGAAGGGACCAT"	"TPC_2"
"ACTGTGAAGTGGTTGG"	"Exclude_hematopoietic"
"ACTGTGACACTATGTG"	"Exclude_hematopoietic"
"ACTGTGAGTATCCTTT"	"LOH, MTAL cell"
"ACTGTGATCAGTAGGG"	"Exclude_hematopoietic"
"ACTTAGGCAAGTACCT"	"TPC_2"
"ACTTATCTCGTCTAAG"	"LOH, MTAL cell"
"ACTTCCGTCTTAGCCC"	"LOH, MTAL cell"
"ACTTCGCGTATAGGAT"	"Exclude_hematopoietic"
"ACTTTCAAGCAGTACG"	"Exclude_hematopoietic"
"ACTTTCAAGGCCTTGC"	"Exclude_hematopoietic"
"ACTTTCACAAGGTCAG"	"TPC_1"
"ACTTTCACACTTCCTG"	"TPC_2"
"ACTTTGTCAAGCAGGT"	"Exclude_hematopoietic"
"ACTTTGTCACGAAAGC"	"Exclude_hematopoietic"
"ACTTTGTGTCCAAATC"	"Exclude_hematopoietic"
"ACTTTGTTCTCTCAAT"	"LOH, MTAL cell"
"AGAAATGAGATCACTC"	"Exclude_hematopoietic"
"AGAAATGCAGCTCATA"	"Exclude_hematopoietic"
"AGAAATGTCAGCTAGT"	"TPC_1"
"AGAAATGTCGTTAGAC"	"Exclude_hematopoietic"
"AGAACAAAGTTGTAAG"	"Exclude_endothelial"
"AGAACAACACCTGATA"	"Exclude_hematopoietic"
"AGAACAACAGTCGCTG"	"TPC_2"
"AGAACAAGTTGCATGT"	"Exclude_hematopoietic"
"AGAACCTAGCAATAGT"	"LOH, MTAL cell"
"AGAACCTAGCGACTTT"	"Exclude_hematopoietic"
"AGAACCTTCCGCAACG"	"Exclude_hematopoietic"
"AGAACCTTCGCTACGG"	"Exclude_hematopoietic"
"AGAAGCGAGAGCCCAA"	"Exclude_hematopoietic"
"AGAAGCGTCAGGTGTT"	"Exclude_hematopoietic"
"AGAAGTAAGCTACGTT"	"Exclude_hematopoietic"
"AGAAGTAAGCTGGAGT"	"Exclude_hematopoietic"
"AGAAGTAAGGAACTAT"	"Exclude_hematopoietic"
"AGAAGTACACTGCGAC"	"LOH, MTAL cell"
"AGAAGTATCAAGCTGT"	"Exclude_hematopoietic"
"AGAAGTATCACGGACC"	"Exclude_hematopoietic"
"AGACAAACAACCAACT"	"Exclude_hematopoietic"
"AGACAAACACCAAAGG"	"Exclude_hematopoietic"
"AGACAAACACCTCTAC"	"Exclude_hematopoietic"
"AGACAAACACGCCACA"	"Exclude_hematopoietic"
"AGACAAATCACTCCGT"	"Exclude_hematopoietic"
"AGACACTAGTTCACTG"	"Exclude_hematopoietic"
"AGACACTCAGGCTTGC"	"Exclude_hematopoietic"
"AGACAGGAGGGCCAAT"	"Exclude_hematopoietic"
"AGACAGGCACAAGGTG"	"Exclude_hematopoietic"
"AGACAGGCATTCTGTT"	"LOH, MTAL cell"
"AGACAGGGTCTACATG"	"Exclude_hematopoietic"
"AGACCATAGGTCTTTG"	"Exclude_hematopoietic"
"AGACCATGTTAAGACA"	"LOH, MTAL cell"
"AGACCCGAGGCGAACT"	"Exclude_hematopoietic"
"AGACCCGCATCTGCGG"	"TPC_1"
"AGACTCAAGGAACTAT"	"Exclude_hematopoietic"
"AGACTCAGTGTCTTGA"	"Exclude_hematopoietic"
"AGAGAATAGTGTACCT"	"Exclude_hematopoietic"
"AGAGAATGTTGCAACT"	"Exclude_hematopoietic"
"AGAGAATTCTCTAGGA"	"Exclude_hematopoietic"
"AGAGAATTCTGAGGCC"	"Exclude_hematopoietic"
"AGAGAATTCTGCTAGA"	"Exclude_hematopoietic"
"AGAGAATTCTTGTGCC"	"Exclude_hematopoietic"
"AGAGAGCCATCGCTAA"	"Exclude_hematopoietic"
"AGAGCAGAGATCACCT"	"Exclude_hematopoietic"
"AGAGCCCCACACGTGC"	"Exclude_hematopoietic"
"AGAGCCCGTCGCACAC"	"Exclude_hematopoietic"
"AGAGCCCTCTCTCGCA"	"Exclude_hematopoietic"
"AGATAGACATGGAATA"	"Exclude_hematopoietic"
"AGATAGAGTGACGTCC"	"Exclude_hematopoietic"
"AGATCCAAGAATCTAG"	"Exclude_hematopoietic"
"AGATCCAAGCCTGAAG"	"TPC_2"
"AGATCCACACCAGGTC"	"LOH, MTAL cell"
"AGATCGTAGGGTTGCA"	"Exclude_hematopoietic"
"AGATCGTCAGACCAAG"	"Exclude_hematopoietic"
"AGATCGTGTACGGATG"	"Exclude_hematopoietic"
"AGATCGTGTCTCGGGT"	"Exclude_hematopoietic"
"AGATGAACAACGTATC"	"Exclude_hematopoietic"
"AGATGAACATTGCTTT"	"Exclude_hematopoietic"
"AGATGAATCCGGGACT"	"Exclude_hematopoietic"
"AGATGCTCAACGGTAG"	"Exclude_hematopoietic"
"AGATGCTGTGTGGTCC"	"Exclude_hematopoietic"
"AGATGCTTCTCGGGAC"	"Exclude_hematopoietic"
"AGCATCAAGGTGGCTA"	"Exclude_hematopoietic"
"AGCATCAAGTAATTGG"	"Exclude_hematopoietic"
"AGCATCACATACATCG"	"Exclude_hematopoietic"
"AGCCAATAGGCTAACG"	"LOH, MTAL cell"
"AGCCAATCATCTTAGG"	"LOH, MTAL cell"
"AGCCACGAGTAGAATC"	"LOH, MTAL cell"
"AGCCACGTCAAGTCTG"	"Exclude_hematopoietic"
"AGCCACGTCTCTTGCG"	"Exclude_hematopoietic"
"AGCGATTAGGATTTAG"	"LOH, MTAL cell"
"AGCGATTGTCGTCGGT"	"Exclude_hematopoietic"
"AGCGATTTCACTGGTA"	"Exclude_hematopoietic"
"AGCGATTTCCGTATGA"	"Exclude_hematopoietic"
"AGCGCCAAGATACATG"	"Exclude_hematopoietic"
"AGCGCCAAGATCGACG"	"Exclude_hematopoietic"
"AGCGCCAAGATCGCCC"	"Exclude_hematopoietic"
"AGCGCCACATCGTTCC"	"Exclude_hematopoietic"
"AGCGCCAGTAGAATAC"	"Exclude_hematopoietic"
"AGCGCCATCCTCACTG"	"LOH, MTAL cell"
"AGCGCCATCGTTCAGA"	"TPC_2"
"AGCGCCATCTCCAAGA"	"Exclude_hematopoietic"
"AGCGCTGAGACTTAAG"	"PEC"
"AGCGCTGAGCATAGGC"	"Exclude_hematopoietic"
"AGCGCTGGTAATTAGG"	"Exclude_hematopoietic"
"AGCGTATCACATTACG"	"LOH, MTAL cell"
"AGCGTCGCAACGGGTA"	"LOH, MTAL cell"
"AGCTACAAGTACTCGT"	"Exclude_hematopoietic"
"AGCTACATCGAACCTA"	"Exclude_hematopoietic"
"AGCTACATCGGTAAGG"	"Exclude_hematopoietic"
"AGCTCAAAGAATTTGG"	"LOH, MTAL cell"
"AGCTCAACAGCGGATA"	"Exclude_hematopoietic"
"AGCTCAACAGGGTTGA"	"LOH, MTAL cell"
"AGCTTCCAGACAAGCC"	"Exclude_hematopoietic"
"AGCTTCCAGGAATGTT"	"Exclude_hematopoietic"
"AGCTTCCAGTCGGCCT"	"Exclude_hematopoietic"
"AGCTTCCCACAGAGAC"	"Exclude_hematopoietic"
"AGCTTCCCAGAAATCA"	"Exclude_hematopoietic"
"AGCTTCCGTAGGATAT"	"Exclude_hematopoietic"
"AGCTTCCGTCCGTACG"	"Exclude_hematopoietic"
"AGCTTCCGTCCTACAA"	"Exclude_hematopoietic"
"AGCTTCCGTCGGCTAC"	"Exclude_hematopoietic"
"AGCTTCCGTCTGATAC"	"Exclude_hematopoietic"
"AGCTTCCTCCGCAACG"	"Exclude_hematopoietic"
"AGCTTCCTCTGAGAAA"	"Exclude_hematopoietic"
"AGGAAATTCAGGTGTT"	"Exclude_hematopoietic"
"AGGAAATTCGGTCGGT"	"Exclude_hematopoietic"
"AGGAATAGTCAGTCGC"	"Exclude_hematopoietic"
"AGGAATAGTTTCAGAC"	"LOH, MTAL cell"
"AGGAATATCGAGTCCG"	"Exclude_hematopoietic"
"AGGAATATCGCATAGT"	"Exclude_hematopoietic"
"AGGACGAAGTGGTGAC"	"LOH, MTAL cell"
"AGGACTTCAGTAGGAC"	"Exclude_hematopoietic"
"AGGACTTGTCAACATC"	"TPC_1"
"AGGAGGTAGCTCTATG"	"TPC_2"
"AGGAGGTCAACTCATG"	"Exclude_hematopoietic"
"AGGAGGTCATTAGGAA"	"Exclude_hematopoietic"
"AGGATAACAGGTTACT"	"Exclude_hematopoietic"
"AGGATCTAGACCAGAC"	"Exclude_hematopoietic"
"AGGATCTCATAGGTTC"	"Exclude_hematopoietic"
"AGGATCTTCTTCACAT"	"Exclude_hematopoietic"
"AGGCATTAGACCGCCT"	"Exclude_hematopoietic"
"AGGCATTCACCAGGTC"	"Exclude_hematopoietic"
"AGGCATTCATCGGCCA"	"Exclude_hematopoietic"
"AGGCATTGTCAGGTAG"	"Exclude_hematopoietic"
"AGGCATTGTCCAGTTA"	"TPC_1"
"AGGCATTGTCTTGAAC"	"Exclude_hematopoietic"
"AGGCATTTCGGCAGTC"	"Exclude_hematopoietic"
"AGGCCACAGGTAAGAG"	"Exclude_hematopoietic"
"AGGCCACAGGTAGACC"	"TPC_1"
"AGGCCACCACGTACAT"	"TPC_1"
"AGGCCACCAGGCACTC"	"Exclude_hematopoietic"
"AGGCCACTCATCTCTA"	"Exclude_hematopoietic"
"AGGCTGCAGGTACCTT"	"Exclude_hematopoietic"
"AGGCTGCCACGCAGTC"	"Exclude_hematopoietic"
"AGGCTGCCAGACGATG"	"TPC_2"
"AGGCTGCGTCGAATTC"	"IC-A"
"AGGGAGTGTGGACCAA"	"TPC_1"
"AGGGAGTTCGGTATGT"	"Exclude_hematopoietic"
"AGGGCCTGTCAGTCCG"	"Exclude_hematopoietic"
"AGGGCCTGTCATAAAG"	"TPC_2"
"AGGGCTCAGGTACAAT"	"Exclude_hematopoietic"
"AGGGCTCAGTCCCGAC"	"Exclude_hematopoietic"
"AGGGCTCGTTTGTTGG"	"Exclude_hematopoietic"
"AGGGTCCCACTTGTGA"	"LOH, MTAL cell"
"AGGGTCCCAGTATGAA"	"Exclude_hematopoietic"
"AGGGTCCCATGACAGG"	"Exclude_hematopoietic"
"AGGGTCCGTCGTTGGC"	"Exclude_hematopoietic"
"AGGGTGAAGAGCAAGA"	"Exclude_hematopoietic"
"AGGGTGACACGTCTCT"	"Exclude_hematopoietic"
"AGGGTGAGTAGACTGG"	"TPC_1"
"AGGGTGATCCTAAGTG"	"Exclude_hematopoietic"
"AGGGTTTAGCCTAACT"	"LOH, MTAL cell"
"AGGGTTTCACACAGAG"	"Exclude_hematopoietic"
"AGGGTTTCACTTTATC"	"Exclude_hematopoietic"
"AGGTAGGAGAGGGTAA"	"Exclude_hematopoietic"
"AGGTAGGCATTGACCA"	"Exclude_hematopoietic"
"AGGTAGGTCATGCATG"	"Exclude_hematopoietic"
"AGGTAGGTCCGGGACT"	"LOH, MTAL cell"
"AGGTAGGTCGCTACGG"	"Exclude_hematopoietic"
"AGGTCATCAGACCTGC"	"Exclude_hematopoietic"
"AGGTCATCAGAGTCTT"	"LOH, MTAL cell"
"AGGTCATGTGGACTAG"	"Exclude_hematopoietic"
"AGGTCATGTGGGCTTC"	"Exclude_hematopoietic"
"AGGTCTAGTCAATCTG"	"LOH, MTAL cell"
"AGGTCTAGTCTTACAG"	"Exclude_hematopoietic"
"AGGTGTTAGTGCCCGT"	"Exclude_hematopoietic"
"AGGTGTTCAGCACCCA"	"Exclude_hematopoietic"
"AGGTGTTGTGTGTTTG"	"Exclude_endothelial"
"AGGTTACAGGTAAGGA"	"Exclude_hematopoietic"
"AGGTTACAGTAAACGT"	"LOH, MTAL cell"
"AGGTTACTCGAACGGA"	"Exclude_hematopoietic"
"AGGTTGTAGACTACCT"	"Exclude_hematopoietic"
"AGGTTGTCAAGAAATC"	"LOH, MTAL cell"
"AGGTTGTGTCCACTCT"	"Exclude_hematopoietic"
"AGGTTGTTCTCGTTTA"	"Exclude_hematopoietic"
"AGTAACCCACTGTCGG"	"Exclude_hematopoietic"
"AGTAACCGTACTAGCT"	"Exclude_hematopoietic"
"AGTACCAAGAAATCCA"	"Exclude_hematopoietic"
"AGTACCAAGCAATAAC"	"Exclude_hematopoietic"
"AGTACCACAACGTAAA"	"Exclude_hematopoietic"
"AGTACCAGTGTAGGAC"	"Exclude_hematopoietic"
"AGTACCAGTGTTACAC"	"Exclude_hematopoietic"
"AGTACTGCAGAGCCCT"	"Exclude_hematopoietic"
"AGTACTGTCCATTTAC"	"Exclude_hematopoietic"
"AGTACTGTCGGTAACT"	"Exclude_hematopoietic"
"AGTAGCTAGTGAGTGC"	"Exclude_hematopoietic"
"AGTAGCTAGTTTCTTC"	"Exclude_hematopoietic"
"AGTAGCTCAAGTATCC"	"Exclude_hematopoietic"
"AGTAGCTCAGAATGTA"	"LOH, MTAL cell"
"AGTAGCTGTATCGCTA"	"TPC_1"
"AGTAGTCGTACCCGAC"	"Exclude_hematopoietic"
"AGTAGTCGTCTAGTGT"	"Exclude_hematopoietic"
"AGTAGTCTCTTACGTT"	"LOH, MTAL cell"
"AGTCAACCAAAGGGTC"	"LOH, MTAL cell"
"AGTCAACCAGCTTCGG"	"LOH, MTAL cell"
"AGTCAACCATAATCCG"	"Exclude_hematopoietic"
"AGTCAACGTATTGAGA"	"Exclude_hematopoietic"
"AGTCAACTCACCACAA"	"TPC_1"
"AGTCACACAAGACGAC"	"Exclude_hematopoietic"
"AGTCACATCACGACTA"	"Exclude_hematopoietic"
"AGTCACATCATTGTGG"	"Exclude_hematopoietic"
"AGTCATGAGGACGGAG"	"Exclude_hematopoietic"
"AGTCATGAGGCATGGT"	"LOH, MTAL cell"
"AGTCATGCAGCACAGA"	"Exclude_hematopoietic"
"AGTCATGCAGCTACAT"	"LOH, MTAL cell"
"AGTCATGCATTGAAGA"	"TPC_2"
"AGTCATGGTCGACGCT"	"LOH, MTAL cell"
"AGTCATGGTCTGTTAG"	"Exclude_hematopoietic"
"AGTCATGGTGTGCCTG"	"TPC_1"
"AGTCATGGTTACCCTC"	"Exclude_hematopoietic"
"AGTCATGGTTACTCAG"	"Exclude_hematopoietic"
"AGTCATGTCTAAACGC"	"PEC"
"AGTCATGTCTCTCCGA"	"Exclude_hematopoietic"
"AGTCTCCAGGTAGTAT"	"Exclude_hematopoietic"
"AGTCTCCAGTGCGTCC"	"TPC_1"
"AGTCTCCCATAGCTGT"	"Exclude_hematopoietic"
"AGTCTCCGTCCTGTCT"	"Exclude_hematopoietic"
"AGTCTCCGTTTAAGGA"	"Exclude_hematopoietic"
"AGTCTCCTCAGGTAAA"	"TPC_1"
"AGTGACTCAAATCGTC"	"Exclude_hematopoietic"
"AGTGACTCAGTGACCC"	"Exclude_hematopoietic"
"AGTGACTGTACTGAGG"	"Exclude_hematopoietic"
"AGTGACTGTCCGGACT"	"Exclude_hematopoietic"
"AGTGATCAGCGTCTCG"	"Exclude_hematopoietic"
"AGTGATCTCTGCGGCA"	"Exclude_hematopoietic"
"AGTGCCGAGAAGCGGG"	"Exclude_hematopoietic"
"AGTGCCGAGTATTGCC"	"Exclude_hematopoietic"
"AGTGCCGAGTTGGCTT"	"Exclude_hematopoietic"
"AGTGCCGCACGAGGAT"	"Exclude_hematopoietic"
"AGTGCCGGTGCCGTTG"	"Exclude_hematopoietic"
"AGTGTTGAGCTGGCCT"	"Exclude_hematopoietic"
"AGTTAGCAGTCACTAC"	"Exclude_hematopoietic"
"AGTTCCCCAAATCGTC"	"TPC_2"
"AGTTCCCGTGTGATGG"	"Exclude_hematopoietic"
"AGTTCGAAGGTTCTAC"	"Exclude_hematopoietic"
"AGTTCGATCTGGGCCA"	"Exclude_hematopoietic"
"ATACCGAAGTAAGCAT"	"Exclude_hematopoietic"
"ATACCGACAATTTCTC"	"Exclude_hematopoietic"
"ATACCGACACGACGAA"	"Exclude_hematopoietic"
"ATACCTTGTGACACGA"	"Exclude_hematopoietic"
"ATACTTCTCAGCATTG"	"Exclude_hematopoietic"
"ATAGACCTCGATACTG"	"Exclude_hematopoietic"
"ATAGAGAAGTGGGAAA"	"Exclude_hematopoietic"
"ATAGAGACAGGTGACA"	"Exclude_hematopoietic"
"ATAGAGAGTGAATATG"	"LOH, MTAL cell"
"ATAGAGATCAAATGCC"	"Exclude_hematopoietic"
"ATAGGCTGTAGCGATG"	"Exclude_hematopoietic"
"ATAGGCTGTTCGATTG"	"LOH, MTAL cell"
"ATAGGCTTCAGCTGTA"	"LOH, MTAL cell"
"ATAGGCTTCGAGAAAT"	"LOH, MTAL cell"
"ATATCCTTCGTCAAAC"	"Exclude_hematopoietic"
"ATATCCTTCTTAGCCC"	"Exclude_hematopoietic"
"ATCACGAAGTTAGAAC"	"Exclude_hematopoietic"
"ATCACTTCACAAATAG"	"Exclude_hematopoietic"
"ATCACTTGTAACCCTA"	"Exclude_hematopoietic"
"ATCACTTGTGGCCCAT"	"Exclude_hematopoietic"
"ATCACTTTCAACTGGT"	"Exclude_hematopoietic"
"ATCACTTTCTTGGCTC"	"LOH, MTAL cell"
"ATCAGGTCAAGTGCTT"	"Exclude_hematopoietic"
"ATCAGGTGTACACGTT"	"Exclude_hematopoietic"
"ATCAGGTGTGCTCTTC"	"Exclude_endothelial"
"ATCAGGTTCAGTGCGC"	"Exclude_hematopoietic"
"ATCAGGTTCCTAGCTC"	"Exclude_hematopoietic"
"ATCAGGTTCCTTCGAC"	"Exclude_hematopoietic"
"ATCAGGTTCTCGTGGG"	"Exclude_hematopoietic"
"ATCATTCCAATCCTAG"	"Exclude_hematopoietic"
"ATCATTCCATGGCGCT"	"Exclude_hematopoietic"
"ATCATTCGTTATGTCG"	"Exclude_hematopoietic"
"ATCATTCGTTCCCAAA"	"TPC_1"
"ATCCACCCAAACGTGG"	"Exclude_hematopoietic"
"ATCCACCCAGTCGCTG"	"Exclude_hematopoietic"
"ATCCACCTCTAAGCCA"	"Exclude_hematopoietic"
"ATCCATTAGGCCCAAA"	"Exclude_hematopoietic"
"ATCCATTCAGTCAGAG"	"Exclude_hematopoietic"
"ATCCATTTCGTTGTGA"	"Exclude_hematopoietic"
"ATCCCTGGTCCTTTGC"	"Exclude_hematopoietic"
"ATCCCTGGTTCAAGTC"	"Exclude_hematopoietic"
"ATCCCTGTCGTTAGTG"	"Exclude_hematopoietic"
"ATCCGTCAGTACTGGG"	"Exclude_hematopoietic"
"ATCCGTCTCCCGTTGT"	"Exclude_hematopoietic"
"ATCCGTCTCTCTTCAA"	"Exclude_hematopoietic"
"ATCCTATAGTATAGAC"	"Exclude_hematopoietic"
"ATCCTATAGTTCGCAT"	"Exclude_hematopoietic"
"ATCCTATCACAAACGG"	"Exclude_endothelial"
"ATCCTATCACCGGTCA"	"Exclude_hematopoietic"
"ATCCTATGTCTAACTG"	"Exclude_hematopoietic"
"ATCCTATGTTTAGTCG"	"Exclude_hematopoietic"
"ATCCTATTCGCTACAA"	"Exclude_hematopoietic"
"ATCGATGAGAGTGAAG"	"Exclude_hematopoietic"
"ATCGATGCAGACCTGC"	"Exclude_hematopoietic"
"ATCGATGCATTCAGCA"	"Exclude_endothelial"
"ATCGATGGTAACGATA"	"Exclude_hematopoietic"
"ATCGATGGTCCAGTTA"	"Exclude_hematopoietic"
"ATCGATGGTCGAATGG"	"Exclude_hematopoietic"
"ATCGATGGTGATACCT"	"Exclude_hematopoietic"
"ATCGATGTCGCGTGCA"	"Exclude_hematopoietic"
"ATCGCCTAGGAAGTCC"	"Exclude_hematopoietic"
"ATCGCCTAGGTCGTCC"	"Exclude_hematopoietic"
"ATCGCCTAGTACTCGT"	"Exclude_hematopoietic"
"ATCGCCTCAGATCACT"	"Exclude_hematopoietic"
"ATCGCCTCATTCTTCA"	"Exclude_hematopoietic"
"ATCGCCTGTAGACACG"	"Exclude_hematopoietic"
"ATCGCCTGTCTCAGGC"	"Exclude_hematopoietic"
"ATCGCCTGTTTGACAC"	"Exclude_hematopoietic"
"ATCGCCTTCAACTACG"	"Exclude_hematopoietic"
"ATCGGATCACTACTTT"	"Exclude_hematopoietic"
"ATCGGATTCACTCACC"	"Exclude_hematopoietic"
"ATCGGATTCTTCCCGA"	"Exclude_hematopoietic"
"ATCGGCGCAATGGCCC"	"Exclude_hematopoietic"
"ATCGGCGTCGAACGCC"	"Exclude_hematopoietic"
"ATCGTAGAGCTCTGTA"	"Exclude_hematopoietic"
"ATCGTAGCAAGGCCTC"	"TPC_1"
"ATCGTAGCACAGCCTG"	"TPC_1"
"ATCGTAGGTAGCGTAG"	"Exclude_hematopoietic"
"ATCGTCCGTTCAAGTC"	"TPC_1"
"ATCGTCCGTTGTGTAC"	"Exclude_hematopoietic"
"ATCGTCCTCGCTAGCG"	"Exclude_hematopoietic"
"ATCGTCCTCTCCCATG"	"Exclude_hematopoietic"
"ATCGTGAGTACGCTTA"	"Exclude_hematopoietic"
"ATCGTGAGTCACTCAA"	"Exclude_hematopoietic"
"ATCGTGATCGCGAAGA"	"LOH, MTAL cell"
"ATCTCTAAGACCATGG"	"Exclude_hematopoietic"
"ATCTCTAAGAGGTTTA"	"Exclude_hematopoietic"
"ATCTCTAGTGGCTAGA"	"Exclude_hematopoietic"
"ATCTCTATCCCTCGTA"	"Exclude_hematopoietic"
"ATCTTCAAGTAAGCAT"	"Exclude_hematopoietic"
"ATCTTCACAAGCGCAA"	"LOH, MTAL cell"
"ATCTTCAGTGGGTCAA"	"Exclude_hematopoietic"
"ATCTTCAGTTCACGAT"	"Exclude_hematopoietic"
"ATCTTCAGTTGATCGT"	"Exclude_hematopoietic"
"ATGAAAGAGAAGGATG"	"LOH, MTAL cell"
"ATGAAAGAGATGTTGA"	"TPC_1"
"ATGAAAGAGCATAGGC"	"Exclude_endothelial"
"ATGAAAGGTATAGCTC"	"Exclude_hematopoietic"
"ATGAAAGGTGAGATAT"	"Exclude_hematopoietic"
"ATGAAAGGTGGCCTCA"	"PEC"
"ATGACCAAGACGCAGT"	"LOH, MTAL cell"
"ATGACCAAGGACCCAA"	"Exclude_endothelial"
"ATGACCACAAATAGCA"	"Exclude_hematopoietic"
"ATGACCAGTCGTACTA"	"Exclude_hematopoietic"
"ATGACCATCCACGTGG"	"LOH, MTAL cell"
"ATGACCATCGCGGTAC"	"Exclude_endothelial"
"ATGAGGGAGCCGGATA"	"Exclude_hematopoietic"
"ATGAGGGGTGGGTATG"	"Exclude_hematopoietic"
"ATGAGGGTCCGACGGT"	"Exclude_hematopoietic"
"ATGAGTCCAAGCGAAC"	"Exclude_hematopoietic"
"ATGAGTCCAGTATGAA"	"Exclude_hematopoietic"
"ATGAGTCGTATACAGA"	"Exclude_hematopoietic"
"ATGAGTCTCGAGTCTA"	"Exclude_hematopoietic"
"ATGATCGCATACATCG"	"Exclude_hematopoietic"
"ATGATCGGTCAGGTAG"	"Exclude_hematopoietic"
"ATGATCGTCGCGTGAC"	"Exclude_hematopoietic"
"ATGCATGAGAGGCGGA"	"TPC_1"
"ATGCATGAGTTTGAGA"	"Exclude_hematopoietic"
"ATGCATGCAATCACGT"	"LOH, MTAL cell"
"ATGCATGGTGATCATC"	"Exclude_hematopoietic"
"ATGCATGGTTAGAAAC"	"Exclude_hematopoietic"
"ATGCATGGTTGAAGTA"	"LOH, MTAL cell"
"ATGCCTCGTAAGTTAG"	"Exclude_hematopoietic"
"ATGCCTCTCCAGCAAT"	"Exclude_hematopoietic"
"ATGCCTCTCGTTCCCA"	"Exclude_hematopoietic"
"ATGCGATAGAGAATCT"	"Exclude_hematopoietic"
"ATGCGATCACTCTAGA"	"Exclude_hematopoietic"
"ATGCGATTCTGTTCAT"	"TPC_1"
"ATGGAGGCAGTCAGTT"	"Exclude_hematopoietic"
"ATGGAGGTCCCGATCT"	"IC-A"
"ATGGATCAGAAATTGC"	"LOH, MTAL cell"
"ATGGATCAGAGTCTGG"	"Exclude_hematopoietic"
"ATGGATCCACTTACAG"	"Exclude_hematopoietic"
"ATGGATCTCGTCAAAC"	"Exclude_hematopoietic"
"ATGGGAGCAAGTCCCG"	"Exclude_hematopoietic"
"ATGGGAGGTCAAGCGA"	"Exclude_hematopoietic"
"ATGGGAGGTTGACTAC"	"LOH, MTAL cell"
"ATGGGAGTCGATGGAG"	"Exclude_hematopoietic"
"ATGGGTTAGAGCCCAA"	"Exclude_hematopoietic"
"ATGGGTTAGTCTAGCT"	"Exclude_hematopoietic"
"ATGGGTTCATAGCACT"	"Exclude_hematopoietic"
"ATGGGTTGTCATCGCG"	"TPC_2"
"ATGGGTTTCAAGAGTA"	"Exclude_hematopoietic"
"ATGGGTTTCAGCTAGT"	"Exclude_hematopoietic"
"ATGGGTTTCATAGCAC"	"Exclude_hematopoietic"
"ATGGGTTTCTCATTGT"	"Exclude_hematopoietic"
"ATGGTTGCACGCTTAA"	"TPC_2"
"ATGTCCCCAACCCTAA"	"Exclude_hematopoietic"
"ATGTCCCGTACAGTCT"	"Exclude_hematopoietic"
"ATGTCCCGTACTGACT"	"Exclude_hematopoietic"
"ATGTCCCTCAAGAAAC"	"Exclude_hematopoietic"
"ATGTCTTAGAAGCTGC"	"Exclude_hematopoietic"
"ATGTCTTAGCCATTTG"	"Exclude_hematopoietic"
"ATGTCTTGTGGAGAAA"	"Exclude_hematopoietic"
"ATGTCTTTCTCACCCA"	"LOH, MTAL cell"
"ATTACCTGTCATAAAG"	"TPC_1"
"ATTACCTTCTCGTCGT"	"Exclude_hematopoietic"
"ATTACTCAGAAGTATC"	"Exclude_hematopoietic"
"ATTACTCCAATTGCTG"	"Exclude_hematopoietic"
"ATTACTCCACCGTGGT"	"Exclude_hematopoietic"
"ATTACTCCACTGAGTT"	"Exclude_hematopoietic"
"ATTACTCGTCTTGAAC"	"Exclude_hematopoietic"
"ATTATCCAGAGGCTGT"	"Exclude_hematopoietic"
"ATTATCCAGGTTGGAC"	"Exclude_hematopoietic"
"ATTATCCCAAAGCACG"	"LOH, MTAL cell"
"ATTATCCCACTAGTAC"	"Exclude_hematopoietic"
"ATTATCCCATTGAAGA"	"Exclude_hematopoietic"
"ATTATCCGTAATGCTC"	"Exclude_hematopoietic"
"ATTATCCGTTCAGTAC"	"Exclude_hematopoietic"
"ATTATCCTCGCCAACG"	"Exclude_hematopoietic"
"ATTCACTCATAACCCA"	"LOH, MTAL cell"
"ATTCACTCATATGGCT"	"TPC_2"
"ATTCACTCATGGCACC"	"Exclude_hematopoietic"
"ATTCACTGTGACAACG"	"TPC_2"
"ATTCACTTCACAACCA"	"Exclude_hematopoietic"
"ATTCACTTCGGTTCAA"	"Exclude_hematopoietic"
"ATTCAGGAGCAGTCTT"	"Exclude_hematopoietic"
"ATTCAGGCACTGGATT"	"Exclude_hematopoietic"
"ATTCAGGGTAATACCC"	"Exclude_hematopoietic"
"ATTCAGGGTGTTCCTC"	"Exclude_hematopoietic"
"ATTCAGGTCGAATGCT"	"Exclude_hematopoietic"
"ATTCAGGTCTGATGGT"	"LOH, MTAL cell"
"ATTCATCAGTTCTACG"	"Exclude_hematopoietic"
"ATTCATCCAAGTACCT"	"Exclude_hematopoietic"
"ATTCATCCAGTCAGTT"	"Exclude_hematopoietic"
"ATTCATCTCAAGATAG"	"Exclude_hematopoietic"
"ATTCATCTCCTAGAGT"	"Exclude_hematopoietic"
"ATTCCATAGACTCGAG"	"Exclude_hematopoietic"
"ATTCCATAGGTCCGAA"	"TPC_2"
"ATTCCATCAGACATCT"	"Exclude_hematopoietic"
"ATTCCATGTATTGGCT"	"TPC_1"
"ATTCCATTCCCTCGAT"	"LOH, MTAL cell"
"ATTCCATTCTAGCATG"	"LOH, MTAL cell"
"ATTCCCGAGAGGTTAT"	"Exclude_hematopoietic"
"ATTCCCGCACTGCACG"	"Exclude_hematopoietic"
"ATTCCCGCATGACTAC"	"LOH, MTAL cell"
"ATTCCCGGTCACCGAC"	"TPC_1"
"ATTCCCGTCTGCTCTG"	"Exclude_hematopoietic"
"ATTCCTACATCGCCTT"	"Exclude_hematopoietic"
"ATTCCTATCCAAGGGA"	"Exclude_hematopoietic"
"ATTCGTTAGAATGTTG"	"LOH, MTAL cell"
"ATTCGTTCAAGTGTCT"	"Exclude_hematopoietic"
"ATTCGTTGTCAAGCGA"	"LOH, MTAL cell"
"ATTCTACCAAATCAAG"	"Exclude_hematopoietic"
"ATTCTACCAGACGATG"	"Exclude_hematopoietic"
"ATTCTACCAGGACAGT"	"Exclude_hematopoietic"
"ATTCTACTCAAGTCTG"	"LOH, MTAL cell"
"ATTCTTGAGATGCTTC"	"Exclude_hematopoietic"
"ATTCTTGAGCAGGCTA"	"Exclude_hematopoietic"
"ATTCTTGGTAACATAG"	"Exclude_hematopoietic"
"ATTGGGTCAGCGGTTC"	"LOH, MTAL cell"
"ATTGGGTGTAGACACG"	"Exclude_hematopoietic"
"ATTGTTCCAACAACAA"	"TPC_1"
"ATTGTTCCAGCCGTCA"	"Exclude_hematopoietic"
"ATTGTTCGTCCCTCAT"	"Exclude_hematopoietic"
"ATTTACCAGAAGCTCG"	"Exclude_hematopoietic"
"ATTTACCAGTGGTCAG"	"Exclude_hematopoietic"
"ATTTACCCACCAGCCA"	"Exclude_hematopoietic"
"ATTTACCCATGGCACC"	"LOH, MTAL cell"
"ATTTACCTCCAACTGA"	"Exclude_hematopoietic"
"ATTTACCTCTGCATGA"	"TPC_1"
"ATTTCACAGTGGAAGA"	"Exclude_hematopoietic"
"ATTTCACAGTTAGTGA"	"Exclude_hematopoietic"
"ATTTCACCACCTAAAC"	"Exclude_hematopoietic"
"ATTTCACGTAGACAGC"	"Exclude_hematopoietic"
"ATTTCTGAGAGCAGAA"	"TPC_1"
"ATTTCTGGTGCCTATA"	"Exclude_hematopoietic"
"ATTTCTGGTTGAGAGC"	"Exclude_hematopoietic"
"CAAAGAACAGTCGGTC"	"Exclude_hematopoietic"
"CAAAGAATCGAGCTGC"	"TPC_2"
"CAACAACCAAATGCGG"	"Exclude_hematopoietic"
"CAACAACCAATGTTGC"	"Exclude_hematopoietic"
"CAACAACTCGGCATCG"	"Exclude_endothelial"
"CAACAGTAGCCTTTGA"	"Exclude_hematopoietic"
"CAACAGTCAAATAGCA"	"Exclude_hematopoietic"
"CAACAGTCAAGCTCTA"	"Exclude_hematopoietic"
"CAACAGTGTGGATCAG"	"Exclude_hematopoietic"
"CAACAGTGTTTACTGG"	"Exclude_hematopoietic"
"CAACAGTTCCTATTGT"	"PEC"
"CAACCAAAGCTTAAGA"	"Exclude_hematopoietic"
"CAACCTCTCACGGGAA"	"Exclude_hematopoietic"
"CAACGATAGAGGTGCT"	"PEC"
"CAACGATAGCAACTCT"	"Exclude_hematopoietic"
"CAACGATCAAGTCCAT"	"TPC_2"
"CAACGATCACCTATCC"	"Exclude_endothelial"
"CAACGATTCCTTATCA"	"Exclude_hematopoietic"
"CAACGATTCGCATTAG"	"Exclude_hematopoietic"
"CAACGATTCTAGTACG"	"Exclude_hematopoietic"
"CAACGGCAGCTGCCTG"	"Exclude_hematopoietic"
"CAACGGCAGCTGTTAC"	"Exclude_hematopoietic"
"CAACGGCGTACTGACT"	"Exclude_hematopoietic"
"CAACGGCGTGGCTGAA"	"TPC_1"
"CAAGACTAGTAGACCG"	"Exclude_hematopoietic"
"CAAGACTCACCTCGTT"	"TPC_2"
"CAAGACTGTTGGGACA"	"Exclude_hematopoietic"
"CAAGAGGTCTAAACGC"	"Exclude_hematopoietic"
"CAAGCTAAGCAACTCT"	"Exclude_hematopoietic"
"CAAGCTAAGTGCCTCG"	"Exclude_hematopoietic"
"CAAGCTACACACTTAG"	"Exclude_hematopoietic"
"CAAGCTAGTGATACCT"	"Exclude_hematopoietic"
"CAAGCTAGTGTCGATT"	"Exclude_hematopoietic"
"CAAGGGAAGAAGTATC"	"PEC"
"CAAGGGACAACGATTC"	"Exclude_hematopoietic"
"CAAGGGACATCGAGCC"	"Exclude_endothelial"
"CAAGGGAGTCGTTGCG"	"Exclude_hematopoietic"
"CAAGGGAGTTTCGTGA"	"TPC_2"
"CAATACGAGTAACCGG"	"Exclude_hematopoietic"
"CAATACGGTAATGTGA"	"Exclude_hematopoietic"
"CAATACGGTTTGATCG"	"Exclude_hematopoietic"
"CAATCGAAGATAACGT"	"Exclude_hematopoietic"
"CAATCGACAGTCCGTG"	"Exclude_endothelial"
"CAATCGATCCTAACAG"	"LOH, MTAL cell"
"CAATCGATCGACATAC"	"Exclude_hematopoietic"
"CAATGACTCTGGGCAC"	"TPC_2"
"CAATTTCCACCACTGG"	"Exclude_hematopoietic"
"CAATTTCCACTATCCC"	"Exclude_hematopoietic"
"CAATTTCGTGGCTGAA"	"Exclude_endothelial"
"CAATTTCTCAACTCTT"	"Exclude_hematopoietic"
"CAATTTCTCCAAGAGG"	"TPC_2"
"CAATTTCTCGGTTGTA"	"Exclude_hematopoietic"
"CACAACAAGTTTCGAC"	"Exclude_hematopoietic"
"CACAACACAAGCGCTC"	"Exclude_hematopoietic"
"CACAACACAGATCCTA"	"Exclude_hematopoietic"
"CACACAAGTCGTAATC"	"Exclude_hematopoietic"
"CACACAAGTGCGTTTA"	"Exclude_hematopoietic"
"CACACAATCATCGCCT"	"Exclude_hematopoietic"
"CACAGATGTTAAACCC"	"Exclude_hematopoietic"
"CACAGATTCAAAGGAT"	"Exclude_hematopoietic"
"CACAGGCAGGGAGTGG"	"Exclude_hematopoietic"
"CACAGGCGTACGATTC"	"Exclude_hematopoietic"
"CACATGAAGACTTCCA"	"LOH, MTAL cell"
"CACATGAAGCACTAAA"	"Exclude_hematopoietic"
"CACATGATCATATGGC"	"Exclude_hematopoietic"
"CACATGATCGATACAC"	"Exclude_hematopoietic"
"CACATGATCTGTCGCT"	"Exclude_hematopoietic"
"CACCAAAAGAAGCTCG"	"Exclude_endothelial"
"CACCAAAAGGGCAGTT"	"TPC_1"
"CACCAAAAGTAAGAGG"	"Exclude_hematopoietic"
"CACCAAACAAGAGTAT"	"Exclude_hematopoietic"
"CACCAAACAGGCTATT"	"Exclude_hematopoietic"
"CACCAAAGTATCTCTT"	"Exclude_hematopoietic"
"CACCGTTAGACATACA"	"Exclude_hematopoietic"
"CACCGTTGTTTCGTGA"	"Exclude_hematopoietic"
"CACGAATCATACACCA"	"Exclude_hematopoietic"
"CACGAATCATTGACAC"	"Exclude_hematopoietic"
"CACGAATGTAGACAAT"	"Exclude_hematopoietic"
"CACGAATGTTACCCAA"	"Exclude_hematopoietic"
"CACGAATTCTCCGAGG"	"Exclude_endothelial"
"CACGGGTAGTATGACA"	"Exclude_hematopoietic"
"CACGGGTGTCTACAGT"	"Exclude_hematopoietic"
"CACGGGTTCTCGTTTA"	"Exclude_hematopoietic"
"CACGTGGAGCGTCGAA"	"Exclude_hematopoietic"
"CACGTGGAGGCCATAG"	"Exclude_hematopoietic"
"CACGTGGGTACGATGG"	"Exclude_hematopoietic"
"CACGTGGGTGTGAGCA"	"Exclude_hematopoietic"
"CACGTGGTCATCGGGC"	"Exclude_hematopoietic"
"CACGTTCAGCGCCGTT"	"Exclude_hematopoietic"
"CACGTTCGTACAAAGT"	"Exclude_endothelial"
"CACGTTCGTAGACAAT"	"LOH, MTAL cell"
"CACGTTCGTCCAAATC"	"Exclude_hematopoietic"
"CACGTTCGTTCATCGA"	"Exclude_hematopoietic"
"CACTAAGGTGGTTCTA"	"TPC_1"
"CACTAAGTCATCGCTC"	"Exclude_hematopoietic"
"CACTAAGTCGAAACAA"	"IC-A"
"CACTAAGTCTAAGAAG"	"Exclude_hematopoietic"
"CACTAAGTCTACTATC"	"Exclude_hematopoietic"
"CACTGAAAGCTGGCCT"	"Exclude_hematopoietic"
"CACTGAACACTAGAGG"	"Exclude_hematopoietic"
"CACTGAATCAAGAAAC"	"Exclude_hematopoietic"
"CACTGGGAGACGAAGA"	"TPC_2"
"CACTGGGAGCTTCATG"	"Exclude_hematopoietic"
"CACTGGGCAGATCCTA"	"Exclude_endothelial"
"CACTGGGTCGCTGTTC"	"Exclude_hematopoietic"
"CACTGTCAGTAACCGG"	"Exclude_hematopoietic"
"CACTGTCCATGAAGCG"	"Exclude_hematopoietic"
"CACTGTCGTGGCAACA"	"LOH, MTAL cell"
"CACTGTCTCGGAATGG"	"Exclude_hematopoietic"
"CACTGTCTCGTAGGAG"	"Exclude_hematopoietic"
"CACTGTCTCGTTAGTG"	"Exclude_hematopoietic"
"CACTTCGAGGTACATA"	"Exclude_hematopoietic"
"CACTTCGAGTTATGGA"	"Exclude_hematopoietic"
"CAGAGCCAGCACGTCC"	"TPC_1"
"CAGATACGTCCGGCAT"	"LOH, MTAL cell"
"CAGATACTCGGATAAA"	"Exclude_hematopoietic"
"CAGATCAAGACGACGT"	"Exclude_hematopoietic"
"CAGATCAAGGGTTGCA"	"Exclude_hematopoietic"
"CAGATCACAGAAGCTG"	"Exclude_hematopoietic"
"CAGATCATCGTCTCAC"	"Exclude_hematopoietic"
"CAGATTGCACATGGTT"	"Exclude_hematopoietic"
"CAGATTGGTCCCACGA"	"Exclude_hematopoietic"
"CAGATTGGTGTTGACT"	"Exclude_hematopoietic"
"CAGATTGTCACCTCGT"	"Exclude_hematopoietic"
"CAGCAATCAATAGTAG"	"TPC_2"
"CAGCAATCAATGAGCG"	"LOH, MTAL cell"
"CAGCAATGTAGTCTTG"	"Exclude_hematopoietic"
"CAGCAATGTTGACTGT"	"Exclude_hematopoietic"
"CAGCAATTCCAAGCCG"	"Exclude_hematopoietic"
"CAGCACGCAAACGAGC"	"Exclude_hematopoietic"
"CAGCACGCACAATGAA"	"TPC_2"
"CAGCACGGTCACTACA"	"Exclude_hematopoietic"
"CAGCACGGTTGCTAGT"	"Exclude_hematopoietic"
"CAGCACGTCCAACCAA"	"LOH, MTAL cell"
"CAGCACGTCGAGAGCA"	"Exclude_hematopoietic"
"CAGCAGCAGAGAACCC"	"Exclude_hematopoietic"
"CAGCAGCCAGAACTCT"	"TPC_1"
"CAGCAGCTCATAGCAC"	"Exclude_hematopoietic"
"CAGCAGCTCCACACAA"	"Exclude_hematopoietic"
"CAGCCAGGTGCAATAA"	"IC-A"
"CAGCCAGGTGGCACTC"	"LOH, MTAL cell"
"CAGCCAGGTGGGCTTC"	"Exclude_hematopoietic"
"CAGCGTGAGGACTGGT"	"Exclude_hematopoietic"
"CAGCGTGCACGCGGTT"	"Exclude_endothelial"
"CAGCGTGGTAGGTCAG"	"Exclude_hematopoietic"
"CAGCGTGTCCAACCGG"	"Exclude_hematopoietic"
"CAGCGTGTCCTACGGG"	"Exclude_hematopoietic"
"CAGGCCACAATGACCT"	"LOH, MTAL cell"
"CAGGGCTAGGACTTCT"	"Exclude_hematopoietic"
"CAGGGCTAGGCCTAAG"	"LOH, MTAL cell"
"CAGGGCTCAGGACATG"	"Exclude_hematopoietic"
"CAGGGCTGTAACCCGC"	"Exclude_hematopoietic"
"CAGGGCTTCCTCTGCA"	"LOH, MTAL cell"
"CAGGTATTCGCTCATC"	"Exclude_hematopoietic"
"CAGTGCGCAGTTCTAG"	"Exclude_hematopoietic"
"CAGTGCGGTGACAACG"	"Exclude_hematopoietic"
"CAGTTAGAGCCATTGT"	"Exclude_hematopoietic"
"CAGTTAGCAATCCTAG"	"Exclude_hematopoietic"
"CAGTTCCCAATTGAAG"	"Exclude_hematopoietic"
"CAGTTCCGTTACGATC"	"Exclude_hematopoietic"
"CAGTTCCTCTAGTTCT"	"Exclude_hematopoietic"
"CATAAGCGTCTCAAGT"	"Exclude_hematopoietic"
"CATACAGCACCATAAC"	"Exclude_hematopoietic"
"CATACAGTCCTGGTCT"	"TPC_2"
"CATACAGTCTACAGGT"	"Exclude_endothelial"
"CATACCCAGACCATTC"	"LOH, MTAL cell"
"CATACCCAGATACTGA"	"Exclude_hematopoietic"
"CATACCCAGCCGATCC"	"Exclude_hematopoietic"
"CATACCCCATCTTTCA"	"Exclude_endothelial"
"CATACCCGTCAGGCAA"	"Exclude_hematopoietic"
"CATACCCGTGACTAAA"	"Exclude_hematopoietic"
"CATACCCTCGACGATT"	"TPC_1"
"CATACCCTCGAGTGGA"	"Exclude_hematopoietic"
"CATACCCTCTACGGGC"	"Exclude_hematopoietic"
"CATACTTAGTTGCATC"	"Exclude_hematopoietic"
"CATACTTTCTCAGTCC"	"TPC_1"
"CATAGACCACGTAGAG"	"TPC_2"
"CATAGACCATCGATAC"	"LOH, MTAL cell"
"CATCAAGAGATGACAT"	"Exclude_hematopoietic"
"CATCAAGCAGGGAGAG"	"Exclude_hematopoietic"
"CATCAAGGTAACTAAG"	"Exclude_hematopoietic"
"CATCAAGGTGCGTTTA"	"Exclude_hematopoietic"
"CATCAAGTCCGTATGA"	"Exclude_hematopoietic"
"CATCAAGTCCTAGCGG"	"TPC_2"
"CATCCACGTTGGGCCT"	"Exclude_hematopoietic"
"CATCCACTCCGAGCTG"	"Exclude_hematopoietic"
"CATCCCATCGACCCAG"	"Exclude_hematopoietic"
"CATCCGTAGCGGATCA"	"Exclude_hematopoietic"
"CATCCGTCAAACACGG"	"Exclude_hematopoietic"
"CATCCGTGTCGCTGCA"	"Exclude_hematopoietic"
"CATCGCTAGAGAGCGG"	"Exclude_hematopoietic"
"CATCGCTAGTCGCCAC"	"LOH, MTAL cell"
"CATCGCTCAGGTCCGT"	"Exclude_hematopoietic"
"CATCGCTCATGGCCAC"	"Exclude_hematopoietic"
"CATCGCTGTCCCGCAA"	"Exclude_hematopoietic"
"CATCGCTTCCTAACAG"	"Exclude_hematopoietic"
"CATCGGGAGTGCCAGA"	"Exclude_hematopoietic"
"CATCGGGCATCAGTGT"	"LOH, MTAL cell"
"CATCGGGGTCTCTCCA"	"Exclude_hematopoietic"
"CATCGGGTCGCCCAGA"	"Exclude_hematopoietic"
"CATCGTCCAATTCTTC"	"Exclude_hematopoietic"
"CATCGTCCAGGGTTGA"	"Exclude_hematopoietic"
"CATCGTCCATAGAATG"	"Exclude_hematopoietic"
"CATCGTCGTGCATCTA"	"Exclude_hematopoietic"
"CATGAGTAGCAACCAG"	"Exclude_hematopoietic"
"CATGAGTGTCCACTTC"	"Exclude_endothelial"
"CATGAGTGTGTGGTCC"	"Exclude_hematopoietic"
"CATGAGTTCCGTAGGC"	"Exclude_hematopoietic"
"CATGAGTTCGTCGCTT"	"Exclude_hematopoietic"
"CATGAGTTCTCTATAC"	"Exclude_hematopoietic"
"CATGCAAGTATGGGAC"	"Exclude_hematopoietic"
"CATGCAAGTATGTCTG"	"Exclude_hematopoietic"
"CATGCAAGTCCTACAA"	"Exclude_hematopoietic"
"CATGCAATCCAGTGCG"	"Exclude_hematopoietic"
"CATGCAATCGCCAGTG"	"TPC_1"
"CATGCCTAGCCGAATG"	"Exclude_hematopoietic"
"CATGCCTAGCTTTGTG"	"TPC_1"
"CATGCCTCACCAGACC"	"Exclude_hematopoietic"
"CATGCCTGTAAGACCG"	"Exclude_hematopoietic"
"CATGCCTTCCAAAGGG"	"Exclude_hematopoietic"
"CATGCCTTCGCTTACC"	"Exclude_hematopoietic"
"CATGCGGCATAGGAGC"	"Exclude_hematopoietic"
"CATGCGGGTACAACGG"	"Exclude_hematopoietic"
"CATGCGGGTCCGCAGT"	"Exclude_hematopoietic"
"CATGCTCAGCCAGAGT"	"Exclude_hematopoietic"
"CATGCTCCAAAGACTA"	"Exclude_hematopoietic"
"CATGCTCGTATGCGTT"	"Exclude_hematopoietic"
"CATGCTCTCGACATCA"	"Exclude_hematopoietic"
"CATGGATGTATACCTG"	"Exclude_hematopoietic"
"CATGGATGTGTGTCCG"	"Exclude_hematopoietic"
"CATGGATGTTGGCCTG"	"IC-A"
"CATGGATTCAAGTGTC"	"TPC_1"
"CATGGATTCGCCAATA"	"Exclude_hematopoietic"
"CATGGATTCTAGATCG"	"Exclude_hematopoietic"
"CATGGTAAGATACAGT"	"Exclude_hematopoietic"
"CATGGTAAGCCTCAGC"	"Exclude_hematopoietic"
"CATGGTATCAACTGGT"	"Exclude_hematopoietic"
"CATTCATAGGTTGGTG"	"LOH, MTAL cell"
"CATTCATAGTTGAATG"	"Exclude_hematopoietic"
"CATTCATGTCGAGTGA"	"Exclude_hematopoietic"
"CATTCATGTGCGTGCT"	"Exclude_hematopoietic"
"CATTCATGTTGTAGCT"	"Exclude_hematopoietic"
"CATTCCGAGGCAGTCA"	"Exclude_hematopoietic"
"CATTCCGCAGGTCAGA"	"Exclude_endothelial"
"CATTCCGCATTAGGCT"	"Exclude_hematopoietic"
"CATTCCGTCACCGCTT"	"Exclude_hematopoietic"
"CATTCCGTCTAGCAAC"	"Exclude_hematopoietic"
"CATTCTAAGGGATCGT"	"Exclude_hematopoietic"
"CATTCTACAAACTCGT"	"Exclude_hematopoietic"
"CATTCTACACTGTTCC"	"Exclude_hematopoietic"
"CATTCTAGTCGAATGG"	"Exclude_hematopoietic"
"CATTCTAGTGCCCACA"	"Exclude_hematopoietic"
"CATTCTAGTTAAACCC"	"Exclude_endothelial"
"CATTGAGCACACAGCC"	"TPC_1"
"CATTGAGGTACTCAAC"	"TPC_1"
"CATTGAGGTCACTCTC"	"Exclude_hematopoietic"
"CATTGAGGTGGATCAG"	"TPC_2"
"CATTGCCCAAACACGG"	"Exclude_hematopoietic"
"CATTGCCGTCCTCCTA"	"Exclude_hematopoietic"
"CATTGTTAGGTTAGTA"	"Exclude_hematopoietic"
"CATTGTTCATGGAGAC"	"Exclude_hematopoietic"
"CATTGTTGTAAGCGGT"	"LOH, MTAL cell"
"CATTGTTGTCATTCCC"	"Exclude_hematopoietic"
"CATTTCAAGTAAAGCT"	"Exclude_hematopoietic"
"CATTTCACATCTCCCA"	"Exclude_endothelial"
"CATTTCAGTCCATAGT"	"IC-A"
"CCAAGCGCAAGAGTTA"	"Exclude_hematopoietic"
"CCAAGCGCAGATCCAT"	"TPC_1"
"CCAAGCGGTCTCTCCA"	"LOH, MTAL cell"
"CCAAGCGGTTTCGATG"	"Exclude_hematopoietic"
"CCAAGCGTCTTGGATG"	"Exclude_hematopoietic"
"CCAATGAAGCTACAAA"	"TPC_1"
"CCAATGACACGCCACA"	"TPC_2"
"CCAATGATCAGCATTG"	"Exclude_hematopoietic"
"CCAATGATCCTACTGC"	"Exclude_hematopoietic"
"CCAATGATCTTACGGA"	"Exclude_hematopoietic"
"CCAATTTTCATTCGGA"	"TPC_2"
"CCAATTTTCCAGTGTA"	"Exclude_hematopoietic"
"CCACAAACACACTTAG"	"Exclude_hematopoietic"
"CCACAAAGTAATCAAG"	"Exclude_hematopoietic"
"CCACCATGTAGCTCGC"	"Exclude_hematopoietic"
"CCACCATGTCGGTGTC"	"Exclude_hematopoietic"
"CCACCATGTGATACAA"	"Exclude_hematopoietic"
"CCACCATGTGCATACT"	"Exclude_hematopoietic"
"CCACCATGTTCGGCCA"	"Exclude_hematopoietic"
"CCACCATGTTTACCAG"	"Exclude_hematopoietic"
"CCACCATTCCTTATAC"	"Exclude_hematopoietic"
"CCACGAGCAAAGCACG"	"Exclude_hematopoietic"
"CCACGAGCAAGAGTTA"	"Exclude_hematopoietic"
"CCACGAGCACATCCCT"	"Exclude_hematopoietic"
"CCACGAGGTCCCGTGA"	"Exclude_hematopoietic"
"CCACGTTAGGGACCAT"	"TPC_1"
"CCACGTTAGGTCGTCC"	"Exclude_hematopoietic"
"CCACGTTGTCTATGAC"	"Exclude_hematopoietic"
"CCACGTTGTGATGGCA"	"Exclude_hematopoietic"
"CCACTTGAGGTCCCGT"	"Exclude_hematopoietic"
"CCACTTGTCCCTTTGG"	"Exclude_hematopoietic"
"CCATAAGAGGCCTAGA"	"Exclude_hematopoietic"
"CCATAAGTCGTCGCTT"	"Exclude_hematopoietic"
"CCATAAGTCGTTGTGA"	"LOH, MTAL cell"
"CCATCACAGAAGTATC"	"TPC_2"
"CCATCACAGACATCAA"	"LOH, MTAL cell"
"CCATCACAGCCAGACA"	"TPC_2"
"CCATCACAGCGCCTTG"	"Exclude_hematopoietic"
"CCATCACAGCTGGCTC"	"Exclude_hematopoietic"
"CCATCACCATAGAGGC"	"Exclude_hematopoietic"
"CCATCACGTTCAAGGG"	"Exclude_hematopoietic"
"CCATCACTCCCATAAG"	"Exclude_hematopoietic"
"CCATCACTCTTAGTTC"	"LOH, MTAL cell"
"CCCAACTCACCAAAGG"	"Exclude_hematopoietic"
"CCCAACTTCCTATTGT"	"Exclude_hematopoietic"
"CCCATTGAGTACCATC"	"Exclude_hematopoietic"
"CCCATTGGTAAGACCG"	"Exclude_hematopoietic"
"CCCGAAGGTGCAACAG"	"Exclude_hematopoietic"
"CCCGGAAAGGATACCG"	"Exclude_hematopoietic"
"CCCGGAAAGGTCTTTG"	"Exclude_hematopoietic"
"CCCGGAAAGTCCCAAT"	"Exclude_hematopoietic"
"CCCGGAACAAGGCAAC"	"Exclude_hematopoietic"
"CCCGGAACAGCAGGAT"	"Exclude_endothelial"
"CCCGGAACATGGTACT"	"Exclude_hematopoietic"
"CCCGGAATCCGATTAG"	"Exclude_hematopoietic"
"CCCGGAATCCTCTGCA"	"Exclude_hematopoietic"
"CCCTAACAGCTCATAC"	"TPC_2"
"CCCTAACCACTTCCTG"	"Exclude_hematopoietic"
"CCCTAACGTAGACAAT"	"Exclude_hematopoietic"
"CCCTAACGTTGGGATG"	"Exclude_endothelial"
"CCCTAACTCAGTCAGT"	"Exclude_hematopoietic"
"CCCTAACTCCACGGGT"	"Exclude_hematopoietic"
"CCCTCAAAGCGACATG"	"Exclude_hematopoietic"
"CCCTCAACATCCCACT"	"Exclude_hematopoietic"
"CCCTCAAGTAGAGACC"	"Exclude_hematopoietic"
"CCCTCAAGTCCAGCGT"	"Exclude_hematopoietic"
"CCCTCAAGTGGGAGAG"	"Exclude_hematopoietic"
"CCCTCAATCACCGGTG"	"Exclude_hematopoietic"
"CCCTCTCAGAGAGTGA"	"Exclude_hematopoietic"
"CCCTCTCGTAGTTAGA"	"Exclude_endothelial"
"CCCTCTCGTCACTCGG"	"Exclude_hematopoietic"
"CCCTCTCGTCGATGCC"	"TPC_2"
"CCCTCTCTCACCTTAT"	"TPC_2"
"CCCTCTCTCATGAGAA"	"Exclude_hematopoietic"
"CCCTCTCTCGTAACCA"	"Exclude_hematopoietic"
"CCCTGATTCAAACTGC"	"Exclude_hematopoietic"
"CCCTTAGGTCTGGTTA"	"TPC_1"
"CCGAACGAGCAACAAT"	"Exclude_hematopoietic"
"CCGAACGCATAGGAGC"	"Exclude_hematopoietic"
"CCGAACGTCGGCTTCT"	"Exclude_hematopoietic"
"CCGAACGTCTTTGCTA"	"Exclude_hematopoietic"
"CCGATCTAGAGTCACG"	"Exclude_hematopoietic"
"CCGATCTAGCGCCATC"	"TPC_1"
"CCGATCTAGTCCCGGT"	"Exclude_hematopoietic"
"CCGATCTCACTGCATA"	"Exclude_hematopoietic"
"CCGATGGAGCTATCTG"	"Exclude_hematopoietic"
"CCGATGGAGTTCGGTT"	"IC-A"
"CCGATGGCATCTCAAG"	"Exclude_hematopoietic"
"CCGATGGGTGGAACAC"	"Exclude_hematopoietic"
"CCGATGGTCTTTGCTA"	"Exclude_endothelial"
"CCGCAAGAGAGCAACC"	"LOH, MTAL cell"
"CCGCAAGAGATAGCAT"	"Exclude_hematopoietic"
"CCGCAAGAGATCACCT"	"TPC_2"
"CCGCAAGGTCTAGATC"	"Exclude_hematopoietic"
"CCGCAAGTCCCTCGTA"	"Exclude_hematopoietic"
"CCGGACAAGCTAGATA"	"Exclude_hematopoietic"
"CCGGACACACTTACAG"	"Exclude_hematopoietic"
"CCGGACATCCCGAATA"	"LOH, MTAL cell"
"CCGGGTAGTAGGTAGC"	"Exclude_hematopoietic"
"CCGGGTAGTGGTCCGT"	"Exclude_hematopoietic"
"CCGGGTAGTTTCCAAG"	"Exclude_hematopoietic"
"CCGGGTATCCTAGCTC"	"Exclude_hematopoietic"
"CCGGTAGCAAAGGAGA"	"Exclude_hematopoietic"
"CCGGTGACACCAGCGT"	"TPC_2"
"CCGGTGATCGCTAAAC"	"Exclude_hematopoietic"
"CCGTAGGAGACAACAT"	"Exclude_hematopoietic"
"CCGTAGGAGCTGCGAA"	"LOH, MTAL cell"
"CCGTAGGAGTACCATC"	"Exclude_hematopoietic"
"CCGTAGGCACTCATAG"	"Exclude_hematopoietic"
"CCGTAGGGTCGCCACA"	"TPC_1"
"CCGTAGGGTTCGGTCG"	"Exclude_hematopoietic"
"CCGTAGGTCCACAGGC"	"Exclude_hematopoietic"
"CCGTAGGTCTGCCTGT"	"Exclude_hematopoietic"
"CCGTGAGCATTGAGGG"	"Exclude_hematopoietic"
"CCGTGAGGTCCTTGTC"	"Exclude_hematopoietic"
"CCGTTCAAGTCATTGC"	"Exclude_hematopoietic"
"CCGTTCACACATCATG"	"Exclude_hematopoietic"
"CCGTTCACAGCTAACT"	"Exclude_hematopoietic"
"CCGTTCATCTAGCAAC"	"Exclude_endothelial"
"CCTAACCAGTCCCAGC"	"Exclude_hematopoietic"
"CCTAACCTCTTTCGAT"	"Exclude_hematopoietic"
"CCTAAGACAACTGCCG"	"Exclude_hematopoietic"
"CCTAAGACAGAATCGG"	"Exclude_hematopoietic"
"CCTAAGAGTCTGTGTA"	"Exclude_hematopoietic"
"CCTAAGATCATCCTGC"	"Exclude_hematopoietic"
"CCTAAGATCGCCAGTG"	"Exclude_hematopoietic"
"CCTACGTAGATGGCGT"	"TPC_2"
"CCTACGTAGGGTAATT"	"Exclude_hematopoietic"
"CCTACGTCAGCATCTA"	"Exclude_hematopoietic"
"CCTACGTGTTTCTATC"	"LOH, MTAL cell"
"CCTACGTTCCACTGAA"	"Exclude_hematopoietic"
"CCTACGTTCCATTCGC"	"Exclude_hematopoietic"
"CCTACGTTCTGTGCGG"	"Exclude_hematopoietic"
"CCTATCGTCGAGAACG"	"Exclude_hematopoietic"
"CCTATCGTCTGCTTAT"	"PEC"
"CCTCAACCACAGAAGC"	"TPC_1"
"CCTCAACCAGATCCAT"	"TPC_2"
"CCTCAACGTTCTTGCC"	"LOH, MTAL cell"
"CCTCAACTCCGACATA"	"Exclude_hematopoietic"
"CCTCAACTCGGCTCTT"	"Exclude_hematopoietic"
"CCTCACACATTGACTG"	"Exclude_endothelial"
"CCTCACAGTCATTGCA"	"Exclude_hematopoietic"
"CCTCACATCTTCGTAT"	"Exclude_hematopoietic"
"CCTCAGTAGAGTCCGA"	"Exclude_endothelial"
"CCTCAGTCAGAGAATT"	"Exclude_hematopoietic"
"CCTCAGTTCAGCGCAC"	"Exclude_hematopoietic"
"CCTCATGGTAGTACGG"	"LOH, MTAL cell"
"CCTCATGTCGCATTGA"	"TPC_2"
"CCTCCAAGTACTAGCT"	"Exclude_hematopoietic"
"CCTCCAATCCATTCGC"	"Exclude_hematopoietic"
"CCTCCTCGTCTGCCTT"	"Exclude_hematopoietic"
"CCTCCTCGTTTACCAG"	"Exclude_hematopoietic"
"CCTCTAGAGTTACGTC"	"LOH, MTAL cell"
"CCTCTCCAGGGAGGGT"	"LOH, MTAL cell"
"CCTCTCCCAGACCGCT"	"LOH, MTAL cell"
"CCTCTCCCAGCAGAAC"	"LOH, MTAL cell"
"CCTCTCCGTGCGTTTA"	"Exclude_hematopoietic"
"CCTCTCCTCACTCACC"	"LOH, MTAL cell"
"CCTCTCCTCAGAACCT"	"Exclude_hematopoietic"
"CCTGCATAGAAACTCA"	"Exclude_hematopoietic"
"CCTGCATAGGCGTCCT"	"Exclude_hematopoietic"
"CCTGCATAGTCTAGAA"	"Exclude_hematopoietic"
"CCTGCATCACCGTACG"	"Exclude_hematopoietic"
"CCTGCATCACTGTCGG"	"Exclude_hematopoietic"
"CCTGCATCATGACAGG"	"LOH, MTAL cell"
"CCTGCATGTATCGCTA"	"Exclude_hematopoietic"
"CCTGCATGTCACTAGT"	"Exclude_hematopoietic"
"CCTGCATTCCACGTAA"	"Exclude_hematopoietic"
"CCTGCATTCCGGACGT"	"Exclude_hematopoietic"
"CCTGTTGAGCTAGTTC"	"LOH, MTAL cell"
"CCTGTTGAGGTCGTAG"	"TPC_2"
"CCTGTTGCACGCCAGT"	"Exclude_hematopoietic"
"CCTGTTGGTATGAAGT"	"LOH, MTAL cell"
"CCTGTTGGTGACACGA"	"TPC_2"
"CCTTCAGTCCCGGTAG"	"LOH, MTAL cell"
"CCTTGTGAGCCTAGGA"	"Exclude_hematopoietic"
"CCTTGTGCAAGACGAC"	"Exclude_hematopoietic"
"CCTTGTGCACAGCTTA"	"Exclude_hematopoietic"
"CCTTGTGCAGATTCGT"	"Exclude_hematopoietic"
"CCTTTGGTCTCCATAT"	"Exclude_hematopoietic"
"CGAAGGAAGCCAACCC"	"Exclude_hematopoietic"
"CGAAGGACAACACAAA"	"Exclude_hematopoietic"
"CGAAGGATCAGATTGC"	"Exclude_hematopoietic"
"CGAAGGATCTTAGCAG"	"Exclude_hematopoietic"
"CGAAGTTAGGCCCGTT"	"Exclude_hematopoietic"
"CGAAGTTGTAGTTCCA"	"Exclude_hematopoietic"
"CGAAGTTTCTGAGCAT"	"LOH, MTAL cell"
"CGAATTGTCTCAGGCG"	"Exclude_hematopoietic"
"CGAATTGTCTGAACGT"	"Exclude_hematopoietic"
"CGACAGCAGCAACCAG"	"Exclude_hematopoietic"
"CGACAGCTCGAAGAAT"	"TPC_2"
"CGAGAAGAGCAAACAT"	"TPC_1"
"CGAGAAGAGCTAATCC"	"Exclude_endothelial"
"CGAGAAGCAACAGCTT"	"Exclude_hematopoietic"
"CGAGAAGGTAATCAGA"	"Exclude_hematopoietic"
"CGAGAAGGTATGCTAC"	"Exclude_hematopoietic"
"CGAGAAGGTTTCGGCG"	"Exclude_hematopoietic"
"CGAGGAAAGTAACGAT"	"LOH, MTAL cell"
"CGAGGAACAGTAGAAT"	"Exclude_hematopoietic"
"CGAGGCTAGGTAGTAT"	"Exclude_hematopoietic"
"CGAGGCTCACGCACCA"	"Exclude_hematopoietic"
"CGAGGCTCAGCGACAA"	"LOH, MTAL cell"
"CGAGGCTCAGTACTAC"	"TPC_1"
"CGAGGCTTCTCGCTCA"	"Exclude_hematopoietic"
"CGAGTGCCAACGGTAG"	"TPC_2"
"CGAGTTAAGCCTCACG"	"Exclude_hematopoietic"
"CGAGTTACACACGGAA"	"Exclude_hematopoietic"
"CGATCGGAGCACTGGA"	"LOH, MTAL cell"
"CGATCGGCAGGCATGA"	"Exclude_hematopoietic"
"CGATCGGTCCTCATAT"	"Exclude_hematopoietic"
"CGATGCGAGCATGATA"	"TPC_2"
"CGATGCGAGCCGATAG"	"Exclude_hematopoietic"
"CGATGCGAGTGCAGCA"	"Exclude_hematopoietic"
"CGATGCGGTGAGATAT"	"Exclude_hematopoietic"
"CGATGCGTCAGCTAGT"	"Exclude_hematopoietic"
"CGATGGCGTGGCACTC"	"LOH, MTAL cell"
"CGCAGGTGTGGCTCTG"	"Exclude_hematopoietic"
"CGCAGGTTCCATCTAT"	"Exclude_hematopoietic"
"CGCAGGTTCGCGCTGA"	"LOH, MTAL cell"
"CGCAGGTTCGGTTGTA"	"Exclude_hematopoietic"
"CGCATAAAGAAGATCT"	"Exclude_hematopoietic"
"CGCATAACAAAGAACT"	"Exclude_hematopoietic"
"CGCATGGCAACTGATC"	"Exclude_hematopoietic"
"CGCATGGCACCGGTCA"	"Exclude_hematopoietic"
"CGCATGGCATCAGCAT"	"Exclude_hematopoietic"
"CGCATGGGTACGCTTA"	"Exclude_hematopoietic"
"CGCATGGGTGTAAATG"	"Exclude_hematopoietic"
"CGCCAGATCTCTGACC"	"Exclude_hematopoietic"
"CGCCAGATCTTTGGAG"	"Exclude_endothelial"
"CGCCATTCACCTGCAG"	"Exclude_hematopoietic"
"CGCCATTGTGGCTTGC"	"Exclude_hematopoietic"
"CGCGTGAAGAAGCTGC"	"Exclude_endothelial"
"CGCGTGAGTTGGGATG"	"PEC"
"CGGAACCAGACCTTTG"	"Exclude_hematopoietic"
"CGGAACCCAGTGGGTA"	"Exclude_hematopoietic"
"CGGAACCTCGAGAAGC"	"Exclude_hematopoietic"
"CGGACACCATAACCCA"	"Exclude_hematopoietic"
"CGGACACGTGGGCTTC"	"Exclude_endothelial"
"CGGACACGTTAAGCAA"	"Exclude_hematopoietic"
"CGGAGAAAGCAATAAC"	"LOH, MTAL cell"
"CGGAGAACAGGAATAT"	"Exclude_hematopoietic"
"CGGAGAACATGTAACC"	"Exclude_hematopoietic"
"CGGAGAATCAACCCGG"	"Exclude_hematopoietic"
"CGGCAGTCACACAGAG"	"Exclude_hematopoietic"
"CGGCAGTGTTAAGGGC"	"Exclude_hematopoietic"
"CGGGACTAGGATTCCT"	"Exclude_hematopoietic"
"CGGGACTAGTGCAAAT"	"LOH, MTAL cell"
"CGGGACTCAGTATTCG"	"LOH, MTAL cell"
"CGGGACTTCGGAGTAG"	"Exclude_hematopoietic"
"CGGGCATAGCCAAGGT"	"Exclude_hematopoietic"
"CGGGCATAGCGACTTT"	"Exclude_hematopoietic"
"CGGGCATCATGGTACT"	"LOH, MTAL cell"
"CGGGCATTCACTGTTT"	"Exclude_hematopoietic"
"CGGGTCACAATATCCG"	"LOH, MTAL cell"
"CGGGTCACATGTTCGA"	"Exclude_hematopoietic"
"CGGGTGTCACCAGCGT"	"Exclude_hematopoietic"
"CGGGTGTTCTAGTGAC"	"Exclude_hematopoietic"
"CGGTCAGAGCATGAAT"	"Exclude_hematopoietic"
"CGGTCAGAGCTTAAGA"	"Exclude_hematopoietic"
"CGGTCAGAGGATACCG"	"Exclude_hematopoietic"
"CGGTCAGTCGATCCCT"	"LOH, MTAL cell"
"CGTAAGTAGCCATTTG"	"Exclude_hematopoietic"
"CGTAAGTCATTGTCGA"	"Exclude_hematopoietic"
"CGTAAGTGTGAATGAT"	"Exclude_hematopoietic"
"CGTAAGTGTGGTCTAT"	"Exclude_hematopoietic"
"CGTAAGTTCTGACGCG"	"LOH, MTAL cell"
"CGTAATGCATAGGCGA"	"Exclude_endothelial"
"CGTAATGGTTGGACTT"	"Exclude_hematopoietic"
"CGTAATGTCCGTATGA"	"LOH, MTAL cell"
"CGTAGTAGTGACGTCC"	"Exclude_hematopoietic"
"CGTAGTAGTGCTGATT"	"Exclude_hematopoietic"
"CGTAGTATCCGCTTAC"	"Exclude_hematopoietic"
"CGTAGTATCGTAGAGG"	"Exclude_hematopoietic"
"CGTAGTATCTTCGGAA"	"Exclude_hematopoietic"
"CGTCAAAAGGTGCTTT"	"Exclude_hematopoietic"
"CGTCAAAGTGATTCAC"	"Exclude_hematopoietic"
"CGTCAAATCCCGAGAC"	"Exclude_hematopoietic"
"CGTCAAATCGCTTAAG"	"Exclude_hematopoietic"
"CGTCCATGTCGACTGC"	"Exclude_hematopoietic"
"CGTCCATTCCCGTGAG"	"Exclude_hematopoietic"
"CGTCCATTCTGCGGGT"	"Exclude_hematopoietic"
"CGTGAATAGATGGTCG"	"PEC"
"CGTGAATAGGTCATAA"	"Exclude_hematopoietic"
"CGTGAATCAAACGGCA"	"LOH, MTAL cell"
"CGTGAATGTGTAAATG"	"Exclude_hematopoietic"
"CGTGAATGTTCCGCAG"	"Exclude_hematopoietic"
"CGTGAATTCGAGAAGC"	"Exclude_hematopoietic"
"CGTGAATTCGGCTGAC"	"Exclude_hematopoietic"
"CGTGATACAATGGCAG"	"TPC_1"
"CGTGATACAGAGTGTG"	"Exclude_hematopoietic"
"CGTGATAGTAATGCGG"	"Exclude_hematopoietic"
"CGTGATATCCACCTCA"	"Exclude_hematopoietic"
"CGTGATATCCAGCAAT"	"Exclude_hematopoietic"
"CGTGCTTAGTAGTCCT"	"PEC"
"CGTGCTTCAAACGGCA"	"Exclude_hematopoietic"
"CGTGCTTGTCCGGTCA"	"Exclude_hematopoietic"
"CGTGTCTCACTATGTG"	"Exclude_hematopoietic"
"CGTGTCTTCAAGCCAT"	"Exclude_hematopoietic"
"CGTGTCTTCTGTTCAT"	"Exclude_hematopoietic"
"CGTTAGACAATAGGAT"	"Exclude_hematopoietic"
"CGTTAGACAATCCTTT"	"Exclude_hematopoietic"
"CGTTAGAGTATGAGGC"	"LOH, MTAL cell"
"CGTTCTGTCAAGTGGG"	"Exclude_hematopoietic"
"CGTTGGGCAATGAACA"	"Exclude_hematopoietic"
"CTAACCCAGAGGTGCT"	"LOH, MTAL cell"
"CTAACCCTCGGACGTC"	"Exclude_hematopoietic"
"CTAACTTAGCTGAAGC"	"Exclude_hematopoietic"
"CTAACTTCATGTGCCG"	"Exclude_hematopoietic"
"CTAACTTGTCTCACAA"	"Exclude_hematopoietic"
"CTAACTTTCCCGTTGT"	"Exclude_hematopoietic"
"CTAAGTGAGACCAGCA"	"Exclude_hematopoietic"
"CTAAGTGCACTACCGG"	"Exclude_hematopoietic"
"CTAAGTGGTAGTTCCA"	"LOH, MTAL cell"
"CTAAGTGGTCGTCGGT"	"Exclude_hematopoietic"
"CTAAGTGGTCTGTCCT"	"Exclude_hematopoietic"
"CTAAGTGTCAAAGGAT"	"Exclude_hematopoietic"
"CTAAGTGTCATCGCAA"	"LOH, MTAL cell"
"CTAAGTGTCTGAGAAA"	"Exclude_hematopoietic"
"CTACAGAAGATGGCGT"	"Exclude_endothelial"
"CTACAGAAGGGCATGT"	"Exclude_hematopoietic"
"CTACAGACACATCCCT"	"Exclude_hematopoietic"
"CTACAGATCGTCGGGT"	"Exclude_hematopoietic"
"CTACATTAGCATGATA"	"Exclude_hematopoietic"
"CTACATTCAACGCATT"	"LOH, MTAL cell"
"CTACATTCAAGACTGG"	"TPC_1"
"CTACCCACATAACGGG"	"Exclude_hematopoietic"
"CTACCTGCACCAGGTC"	"Exclude_hematopoietic"
"CTACCTGCACCGGCTA"	"Exclude_hematopoietic"
"CTACCTGTCACCATGA"	"IC-A"
"CTACGGGTCCTCACGT"	"Exclude_hematopoietic"
"CTACTATGTACTAAGA"	"Exclude_hematopoietic"
"CTACTATGTTAGAGTA"	"Exclude_hematopoietic"
"CTACTATTCCACTGAA"	"Exclude_hematopoietic"
"CTAGACAAGCAATTAG"	"LOH, MTAL cell"
"CTAGACAAGGGACACT"	"Exclude_hematopoietic"
"CTAGACACAAATGATG"	"IC-A"
"CTAGACAGTCCGAAAG"	"LOH, MTAL cell"
"CTAGACATCCTTACCG"	"Exclude_hematopoietic"
"CTAGACATCGCTCTCA"	"LOH, MTAL cell"
"CTAGACATCGTAGGAG"	"Exclude_hematopoietic"
"CTAGACATCTGCCTGT"	"TPC_1"
"CTAGGTAAGCTCCACG"	"Exclude_hematopoietic"
"CTAGGTACACAGCGCT"	"Exclude_hematopoietic"
"CTAGGTACATTGTAGC"	"Exclude_hematopoietic"
"CTAGGTAGTAGAATGT"	"Exclude_hematopoietic"
"CTAGGTAGTTCTCGTC"	"LOH, MTAL cell"
"CTAGGTATCCATTTCA"	"Exclude_hematopoietic"
"CTATAGGAGCAGTCTT"	"Exclude_hematopoietic"
"CTATAGGCAACAGTGG"	"Exclude_hematopoietic"
"CTATCCGAGGTAGATT"	"Exclude_endothelial"
"CTATCCGCAGAGTTCT"	"LOH, MTAL cell"
"CTATCCGCAGCGCGTT"	"LOH, MTAL cell"
"CTATCCGTCGATACGT"	"Exclude_hematopoietic"
"CTATCTAAGACAACTA"	"Exclude_hematopoietic"
"CTATCTAAGGAGCAAA"	"PEC"
"CTATCTACAGACAAGC"	"LOH, MTAL cell"
"CTATCTAGTATGTCAC"	"LOH, MTAL cell"
"CTATCTATCAACTGAC"	"Exclude_hematopoietic"
"CTATCTATCGCCAGTG"	"Exclude_hematopoietic"
"CTCAACCCAAAGGGCT"	"Exclude_hematopoietic"
"CTCAACCGTATTTCCT"	"Exclude_hematopoietic"
"CTCAACCTCATTGCGA"	"LOH, MTAL cell"
"CTCAAGAAGACCCTTA"	"Exclude_hematopoietic"
"CTCAAGACAATCTAGC"	"Exclude_hematopoietic"
"CTCAAGAGTGTTCGTA"	"LOH, MTAL cell"
"CTCAATTAGAGCAACC"	"TPC_1"
"CTCAATTCAATTCGTG"	"Exclude_endothelial"
"CTCAATTTCTTGATTC"	"Exclude_hematopoietic"
"CTCACTGAGATGAACT"	"Exclude_hematopoietic"
"CTCACTGGTCGTGTTA"	"TPC_1"
"CTCACTGGTTGTGTTG"	"Exclude_hematopoietic"
"CTCACTGTCGCATGAT"	"Exclude_hematopoietic"
"CTCACTGTCGGCTATA"	"Exclude_hematopoietic"
"CTCAGAAAGCAAGGAA"	"Exclude_hematopoietic"
"CTCAGAAGTACATACC"	"TPC_2"
"CTCAGAAGTATACCTG"	"Exclude_hematopoietic"
"CTCAGAAGTCATCGCG"	"Exclude_hematopoietic"
"CTCAGAAGTCTACACA"	"Exclude_hematopoietic"
"CTCAGAAGTGGCGCTT"	"Exclude_hematopoietic"
"CTCAGAATCGAGTACT"	"Exclude_hematopoietic"
"CTCAGGGCACACCTTC"	"Exclude_hematopoietic"
"CTCAGGGCACGTCTCT"	"LOH, MTAL cell"
"CTCAGGGCAGAGTGTG"	"Exclude_hematopoietic"
"CTCAGGGGTACGTACT"	"Exclude_hematopoietic"
"CTCAGGGTCCCTAGGG"	"Exclude_hematopoietic"
"CTCAGTCAGTACCGGA"	"Exclude_hematopoietic"
"CTCAGTCCAGAAACCG"	"Exclude_hematopoietic"
"CTCAGTCTCGGACTTA"	"Exclude_hematopoietic"
"CTCATCGCAACCAACT"	"LOH, MTAL cell"
"CTCATCGCAAGACGGT"	"TPC_1"
"CTCATGCAGACCGTTT"	"Exclude_hematopoietic"
"CTCATGCCACAAGTTC"	"Exclude_hematopoietic"
"CTCATTAAGCCGTAAG"	"Exclude_hematopoietic"
"CTCATTACAAGAAACT"	"Exclude_hematopoietic"
"CTCATTAGTAGAGCTG"	"Exclude_hematopoietic"
"CTCATTAGTAGGACCA"	"Exclude_hematopoietic"
"CTCCAACAGCCTATCA"	"Exclude_hematopoietic"
"CTCCAACGTAGGCTCC"	"Exclude_hematopoietic"
"CTCCAACGTGTCGCTG"	"Exclude_hematopoietic"
"CTCCAACGTTTCGTGA"	"Exclude_hematopoietic"
"CTCCAACTCGAGAAGC"	"Exclude_hematopoietic"
"CTCCACAAGGGTCTTT"	"LOH, MTAL cell"
"CTCCACACAGCCGTCA"	"Exclude_hematopoietic"
"CTCCACACATGCAGGA"	"Exclude_hematopoietic"
"CTCCACAGTCCAAAGG"	"Exclude_hematopoietic"
"CTCCACAGTTATCCAG"	"Exclude_hematopoietic"
"CTCCATGAGAGATCGC"	"Exclude_hematopoietic"
"CTCCATGGTGGTCAAG"	"LOH, MTAL cell"
"CTCCCAACACCCTGTT"	"Exclude_hematopoietic"
"CTCCCAACAGGTTACT"	"Exclude_hematopoietic"
"CTCCCAACATGGGATG"	"LOH, MTAL cell"
"CTCCCTCAGAGTGTGC"	"Exclude_hematopoietic"
"CTCCCTCCACAGACGA"	"Exclude_hematopoietic"
"CTCCCTCGTACCCGAC"	"Exclude_hematopoietic"
"CTCCCTCGTCGCATGC"	"Exclude_hematopoietic"
"CTCCCTCGTTCTCACC"	"Exclude_hematopoietic"
"CTCCGATCAATACGAA"	"LOH, MTAL cell"
"CTCCGATCATAACAGA"	"Exclude_hematopoietic"
"CTCCGATGTGCGAGTA"	"Exclude_hematopoietic"
"CTCCTCCCATGACTAC"	"Exclude_hematopoietic"
"CTCCTCCGTTAAGGAT"	"Exclude_hematopoietic"
"CTCCTCCGTTAGCGGA"	"Exclude_hematopoietic"
"CTCCTCCTCGTGCGAC"	"Exclude_hematopoietic"
"CTCCTCCTCGTTCTGC"	"Exclude_hematopoietic"
"CTCCTTTAGGTTGCCC"	"LOH, MTAL cell"
"CTCCTTTGTCTACAAC"	"Exclude_hematopoietic"
"CTCGAGGAGATAACAC"	"Exclude_hematopoietic"
"CTCGAGGAGCGTTACT"	"Exclude_hematopoietic"
"CTCGAGGAGGATATAC"	"LOH, MTAL cell"
"CTCGAGGAGGATGGCT"	"TPC_1"
"CTCGAGGGTGCGCTCA"	"Exclude_hematopoietic"
"CTCGAGGGTTCTATCT"	"Exclude_hematopoietic"
"CTCTCAGAGTGCCCGT"	"Exclude_hematopoietic"
"CTCTCAGAGTGCTCAT"	"Exclude_hematopoietic"
"CTCTCAGGTACACGCC"	"Exclude_hematopoietic"
"CTCTCAGGTACGATTC"	"Exclude_hematopoietic"
"CTCTCGAAGTGCCTCG"	"LOH, MTAL cell"
"CTCTCGACACAAGCCC"	"LOH, MTAL cell"
"CTCTCGATCCTACGAA"	"TPC_2"
"CTCTCGATCTGGGTCG"	"LOH, MTAL cell"
"CTCTGGTAGGATTCCT"	"TPC_1"
"CTCTGGTAGGCTCTAT"	"Exclude_hematopoietic"
"CTCTGGTAGTAGAATC"	"Exclude_hematopoietic"
"CTCTGGTCACCCTCTA"	"Exclude_hematopoietic"
"CTCTGGTGTTGAATCC"	"Exclude_hematopoietic"
"CTCTGGTTCAAGGAGC"	"Exclude_hematopoietic"
"CTGAATGAGCGTATGG"	"Exclude_hematopoietic"
"CTGAATGAGGTCCAGA"	"Exclude_hematopoietic"
"CTGAATGAGGTTGGTG"	"Exclude_hematopoietic"
"CTGAATGCATTGACCA"	"Exclude_hematopoietic"
"CTGAGCGAGTTCGGTT"	"LOH, MTAL cell"
"CTGAGCGTCCTTATAC"	"Exclude_hematopoietic"
"CTGAGGCAGAGGATCC"	"Exclude_hematopoietic"
"CTGAGGCCACCCTTGT"	"Exclude_hematopoietic"
"CTGAGGCGTACCTAGT"	"LOH, MTAL cell"
"CTGAGGCGTCGATTAC"	"IC-A"
"CTGAGGCTCCCGAAAT"	"LOH, MTAL cell"
"CTGATCCGTAGACTGG"	"Exclude_hematopoietic"
"CTGATCCTCTTTCTAG"	"TPC_2"
"CTGCAGGGTCGCGTCA"	"Exclude_hematopoietic"
"CTGCAGGTCAGACCGC"	"Exclude_hematopoietic"
"CTGCATCGTAACAGTA"	"LOH, MTAL cell"
"CTGCATCTCGTAACTG"	"Exclude_hematopoietic"
"CTGCCATCAGAGTCAG"	"Exclude_hematopoietic"
"CTGCCATCATCTATCT"	"Exclude_hematopoietic"
"CTGCCATGTACTCCCT"	"Exclude_hematopoietic"
"CTGCCATTCGACCTAA"	"TPC_2"
"CTGCCATTCGGAAACG"	"Exclude_endothelial"
"CTGCCTACATCGAGCC"	"Exclude_hematopoietic"
"CTGCGAGAGCATCGAG"	"TPC_2"
"CTGCGAGAGGCGATAC"	"Exclude_hematopoietic"
"CTGCGAGAGTTTCTTC"	"Exclude_hematopoietic"
"CTGCGAGCAAGGTCGA"	"Exclude_hematopoietic"
"CTGCGAGGTCATAAAG"	"Exclude_hematopoietic"
"CTGCGAGGTCGCCTAG"	"LOH, MTAL cell"
"CTGCTCAAGCGTTAGG"	"LOH, MTAL cell"
"CTGCTCAAGCTAAATG"	"Exclude_hematopoietic"
"CTGCTCACAGATTTCG"	"Exclude_hematopoietic"
"CTGCTCACATGCAGGA"	"Exclude_hematopoietic"
"CTGCTCATCATAGCAC"	"Exclude_hematopoietic"
"CTGCTCATCCTCGCAT"	"LOH, MTAL cell"
"CTGGACGCAGGCTTGC"	"Exclude_hematopoietic"
"CTGGACGGTAGTGTGG"	"Exclude_hematopoietic"
"CTGGCAGAGCCGCTTG"	"LOH, MTAL cell"
"CTGGCAGCAAGCCATT"	"TPC_2"
"CTGGCAGTCACGACTA"	"Exclude_hematopoietic"
"CTGGTCTCAATAGTCC"	"Exclude_hematopoietic"
"CTGGTCTCACGGGTAA"	"Exclude_endothelial"
"CTGGTCTTCGCATGAT"	"Exclude_hematopoietic"
"CTGTACCTCTACTGAG"	"Exclude_endothelial"
"CTGTACCTCTGGGCAC"	"Exclude_hematopoietic"
"CTGTAGAGTGAGGATC"	"Exclude_hematopoietic"
"CTGTAGATCCTGCTAC"	"TPC_1"
"CTGTATTAGCGCCGTT"	"Exclude_hematopoietic"
"CTGTATTCACCTGAAT"	"Exclude_hematopoietic"
"CTGTATTGTTTACCAG"	"Exclude_hematopoietic"
"CTGTATTTCTCACCCA"	"Exclude_hematopoietic"
"CTGTCGTAGCTGAAAT"	"Exclude_hematopoietic"
"CTGTCGTCAGGTCAGA"	"Exclude_hematopoietic"
"CTGTCGTCAGTCACGC"	"IC-A"
"CTGTCGTGTCACAGAG"	"Exclude_hematopoietic"
"CTGTCGTGTGCGCTCA"	"IC-A"
"CTGTCGTGTTGTCCCT"	"Exclude_hematopoietic"
"CTGTGAACAATTTCGG"	"Exclude_hematopoietic"
"CTGTGAAGTGGTAATA"	"Exclude_hematopoietic"
"CTGTGAATCTCGTGAA"	"Exclude_hematopoietic"
"CTGTGGGAGTGACCTT"	"Exclude_hematopoietic"
"CTGTGGGCATTCATCT"	"Exclude_hematopoietic"
"CTGTGGGGTGCCGGTT"	"Exclude_hematopoietic"
"CTGTGGGTCCGAGAAG"	"TPC_1"
"CTGTGGGTCGACCATA"	"Exclude_hematopoietic"
"CTGTGGGTCGCTCCTA"	"Exclude_hematopoietic"
"CTTACCGAGTTACGAA"	"Exclude_hematopoietic"
"CTTACCGGTCGATTCA"	"Exclude_hematopoietic"
"CTTAGGACACTCTAGA"	"Exclude_hematopoietic"
"CTTAGGAGTGCGACAA"	"Exclude_hematopoietic"
"CTTAGGAGTGTCGATT"	"Exclude_endothelial"
"CTTAGGATCTGGGTCG"	"Exclude_hematopoietic"
"CTTAGGATCTTCGATT"	"Exclude_hematopoietic"
"CTTCAATCAACCTAAC"	"LOH, MTAL cell"
"CTTCCGACACTCAGAT"	"Exclude_hematopoietic"
"CTTCCGACAGATAAAC"	"Exclude_hematopoietic"
"CTTCCGACATCAGTCA"	"Exclude_endothelial"
"CTTCCGAGTTACGATC"	"PEC"
"CTTCCTTCACAAATCC"	"TPC_1"
"CTTCCTTTCGCTCTCA"	"Exclude_hematopoietic"
"CTTCGGTAGCAAGTGC"	"Exclude_hematopoietic"
"CTTCGGTCACCGTGCA"	"LOH, MTAL cell"
"CTTCGGTGTCGAAGCA"	"Exclude_hematopoietic"
"CTTCGGTGTCTTACAG"	"Exclude_hematopoietic"
"CTTCTAAAGTCATCCA"	"Exclude_hematopoietic"
"CTTCTAACACAAGCAG"	"LOH, MTAL cell"
"CTTCTAACACCCAAGC"	"Exclude_hematopoietic"
"CTTCTAAGTACAAAGT"	"TPC_2"
"CTTCTAAGTTGGCCTG"	"LOH, MTAL cell"
"CTTCTAATCCTCATAT"	"Exclude_hematopoietic"
"CTTCTCTAGCAGCCTC"	"Exclude_hematopoietic"
"CTTCTCTTCCTCTAAT"	"Exclude_hematopoietic"
"CTTGAGAAGGAAGTAG"	"Exclude_hematopoietic"
"CTTGAGAAGTGGTTCT"	"LOH, MTAL cell"
"CTTGATTAGCATGCGA"	"Exclude_hematopoietic"
"CTTGATTAGGTACAGC"	"LOH, MTAL cell"
"CTTGATTAGGTGATAT"	"LOH, MTAL cell"
"CTTGATTAGTAGCCAG"	"LOH, MTAL cell"
"CTTGATTAGTCGCCCA"	"Exclude_hematopoietic"
"CTTGATTGTACGGCAA"	"Exclude_hematopoietic"
"CTTGATTTCACTCCGT"	"Exclude_hematopoietic"
"CTTTCAAAGCCAGTAG"	"Exclude_hematopoietic"
"CTTTCAAAGGGCAATC"	"Exclude_hematopoietic"
"CTTTCAACACCAGGTC"	"Exclude_hematopoietic"
"CTTTCAAGTGAACTAA"	"Exclude_hematopoietic"
"CTTTCGGCACTCTCGT"	"LOH, MTAL cell"
"CTTTCGGGTACCCAGC"	"LOH, MTAL cell"
"CTTTCGGGTACCCGAC"	"LOH, MTAL cell"
"CTTTCGGGTCAAAGTA"	"LOH, MTAL cell"
"CTTTCGGGTGCGGTAA"	"LOH, MTAL cell"
"CTTTCGGTCCGGACTG"	"Exclude_hematopoietic"
"GAAACCTGTGATTCAC"	"Exclude_hematopoietic"
"GAAACCTTCACCTACC"	"Exclude_hematopoietic"
"GAAACCTTCGCGGTAC"	"Exclude_hematopoietic"
"GAAATGAAGACATAGT"	"Exclude_hematopoietic"
"GAAATGAAGAGTTGCG"	"Exclude_hematopoietic"
"GAAATGAAGGCGTTAG"	"Exclude_hematopoietic"
"GAAATGACACCCTGTT"	"Exclude_hematopoietic"
"GAAATGATCAAAGCCT"	"Exclude_hematopoietic"
"GAAATGATCTTCTAAC"	"Exclude_hematopoietic"
"GAACACTAGACTAAGT"	"Exclude_hematopoietic"
"GAACACTCAACACGTT"	"Exclude_endothelial"
"GAACACTCAACCGTAT"	"TPC_2"
"GAACACTCAAGCCTGC"	"Exclude_hematopoietic"
"GAACACTCACTAGAGG"	"Exclude_hematopoietic"
"GAACACTGTAACGGTG"	"LOH, MTAL cell"
"GAACGTTAGAACGCGT"	"Exclude_hematopoietic"
"GAACGTTAGTCAGCGA"	"TPC_2"
"GAACGTTCACGGCCAT"	"Exclude_hematopoietic"
"GAACGTTTCCTGTTGC"	"Exclude_hematopoietic"
"GAACGTTTCGCCTCTA"	"Exclude_hematopoietic"
"GAACTGTAGAGCAGAA"	"Exclude_hematopoietic"
"GAACTGTAGTCACGAG"	"Exclude_hematopoietic"
"GAACTGTAGTGCCCGT"	"Exclude_hematopoietic"
"GAACTGTCATACAGCT"	"Exclude_hematopoietic"
"GAACTGTGTCTTGCTC"	"Exclude_hematopoietic"
"GAACTGTGTTCAACGT"	"LOH, MTAL cell"
"GAACTGTTCGTTGTAG"	"Exclude_hematopoietic"
"GAAGCCCAGCACTAGG"	"Exclude_hematopoietic"
"GAAGCCCAGCGCAATG"	"Exclude_hematopoietic"
"GAAGCCCAGTCTTCGA"	"Exclude_hematopoietic"
"GAAGCCCTCCATTCGC"	"Exclude_hematopoietic"
"GAAGCGACAAAGAGTT"	"Exclude_hematopoietic"
"GAAGCGACAGCCCACA"	"Exclude_hematopoietic"
"GAAGCGAGTATACAGA"	"LOH, MTAL cell"
"GAAGGACAGTTGCATC"	"Exclude_hematopoietic"
"GAAGGACGTGGCTGAA"	"LOH, MTAL cell"
"GAAGGACTCCATAAGC"	"Exclude_hematopoietic"
"GAAGGACTCTGAGGTT"	"Exclude_hematopoietic"
"GAAGGGTAGCAGCCTC"	"TPC_2"
"GAAGGGTCATTGACAC"	"Exclude_hematopoietic"
"GAAGGGTTCACCTCAC"	"LOH, MTAL cell"
"GAAGGGTTCCACGTAA"	"Exclude_hematopoietic"
"GAAGTAAAGGGCAGAG"	"Exclude_hematopoietic"
"GAAGTAAGTTTCCCAC"	"Exclude_hematopoietic"
"GAAGTAATCAGCTTGA"	"Exclude_hematopoietic"
"GAAGTAATCTAGCCTC"	"LOH, MTAL cell"
"GAATAGACAGCGCTTG"	"LOH, MTAL cell"
"GAATAGACAGGCACTC"	"Exclude_hematopoietic"
"GAATAGAGTTTCACTT"	"LOH, MTAL cell"
"GAATCACCATAGAATG"	"TPC_1"
"GACACGCAGAAACTCA"	"Exclude_hematopoietic"
"GACACGCTCGGCATCG"	"LOH, MTAL cell"
"GACACGCTCTGCGAGC"	"Exclude_hematopoietic"
"GACAGCCAGATACGAT"	"Exclude_hematopoietic"
"GACAGCCAGTCCGCGT"	"Exclude_hematopoietic"
"GACAGCCCAAATACAG"	"TPC_2"
"GACAGCCCAGCAGATG"	"Exclude_hematopoietic"
"GACAGCCGTTTACACG"	"TPC_2"
"GACAGCCTCACGGGAA"	"Exclude_endothelial"
"GACAGCCTCCAACACA"	"Exclude_hematopoietic"
"GACCAATGTTTGATCG"	"TPC_1"
"GACCAATTCCACACCT"	"Exclude_hematopoietic"
"GACCAATTCTATCCAT"	"TPC_1"
"GACCCAGGTCAACCAT"	"TPC_2"
"GACCCAGGTGCATTTG"	"TPC_2"
"GACCCAGGTTACGCCG"	"Exclude_hematopoietic"
"GACCCAGGTTGGTGTT"	"Exclude_hematopoietic"
"GACCCAGTCATCGGGC"	"Exclude_hematopoietic"
"GACCCAGTCTAAGCCA"	"Exclude_hematopoietic"
"GACCCTTCATAGAAAC"	"PEC"
"GACCCTTTCCCAGTGG"	"LOH, MTAL cell"
"GACCGTGCAGGCTATT"	"Exclude_hematopoietic"
"GACCGTGCATTGCTTT"	"LOH, MTAL cell"
"GACCGTGGTCATTGCA"	"Exclude_hematopoietic"
"GACCTTCCATAGCTGT"	"Exclude_hematopoietic"
"GACCTTCGTATTTCTC"	"LOH, MTAL cell"
"GACCTTCTCGACCACG"	"TPC_1"
"GACCTTCTCTGGCCAG"	"Exclude_endothelial"
"GACGCTGAGAGAGTTT"	"TPC_1"
"GACGCTGAGATCGCCC"	"Exclude_hematopoietic"
"GACGCTGCAACCACGC"	"Exclude_hematopoietic"
"GACGCTGGTCTATGAC"	"Exclude_hematopoietic"
"GACGTTACAGACCATT"	"TPC_1"
"GACGTTAGTGGACAGT"	"Exclude_hematopoietic"
"GACGTTATCAGCGTCG"	"Exclude_hematopoietic"
"GACGTTATCGGTGTTA"	"Exclude_hematopoietic"
"GACTATGGTATTGAGA"	"Exclude_hematopoietic"
"GACTCAAAGAGCAGTC"	"Exclude_hematopoietic"
"GACTCAAAGCTCGCAC"	"Exclude_hematopoietic"
"GACTCAACACCTGCGA"	"Exclude_hematopoietic"
"GACTCAATCTACCACC"	"Exclude_hematopoietic"
"GACTCTCCATTATGCG"	"LOH, MTAL cell"
"GACTCTCTCATGACAC"	"TPC_1"
"GACTGATAGCCTGCCA"	"Exclude_hematopoietic"
"GACTGATGTTGCCTAA"	"LOH, MTAL cell"
"GACTGATTCATGCATG"	"Exclude_hematopoietic"
"GACTGATTCGCCTAGG"	"Exclude_hematopoietic"
"GACTTCCAGGGCAATC"	"Exclude_hematopoietic"
"GACTTCCCACTAACGT"	"TPC_2"
"GACTTCCGTCAAGGCA"	"Exclude_hematopoietic"
"GACTTCCGTCATAGTC"	"Exclude_hematopoietic"
"GACTTCCTCAAGTCTG"	"LOH, MTAL cell"
"GACTTCCTCAGAGTTC"	"Exclude_hematopoietic"
"GACTTCCTCTTTGATC"	"Exclude_hematopoietic"
"GAGAAATAGCGCTGAA"	"Exclude_hematopoietic"
"GAGAAATCAGGAACCA"	"Exclude_hematopoietic"
"GAGAAATGTTCCGGTG"	"Exclude_endothelial"
"GAGAAATTCGGTCATA"	"LOH, MTAL cell"
"GAGAAATTCTTGTGCC"	"Exclude_hematopoietic"
"GAGACCCTCAACTACG"	"Exclude_hematopoietic"
"GAGACTTGTTCGGCGT"	"Exclude_hematopoietic"
"GAGAGGTAGGATTCAA"	"Exclude_hematopoietic"
"GAGAGGTCAAGTACCT"	"Exclude_hematopoietic"
"GAGAGGTCAGGTGAGT"	"Exclude_hematopoietic"
"GAGATGGAGACGATAT"	"LOH, MTAL cell"
"GAGATGGCACACTGGC"	"Exclude_hematopoietic"
"GAGATGGCATTATGCG"	"Exclude_hematopoietic"
"GAGATGGGTCTCTCAC"	"TPC_1"
"GAGATGGGTGGATGAC"	"LOH, MTAL cell"
"GAGCCTGAGACGTCGA"	"Exclude_hematopoietic"
"GAGCCTGAGGCATCTT"	"Exclude_hematopoietic"
"GAGCCTGCAATCTCGA"	"Exclude_hematopoietic"
"GAGCCTGCAGGTCAAG"	"Exclude_hematopoietic"
"GAGCCTGCATATCGGT"	"LOH, MTAL cell"
"GAGCCTGCATCCCACT"	"Exclude_hematopoietic"
"GAGCCTGCATTCGGGC"	"LOH, MTAL cell"
"GAGCTGCAGAAGTCAT"	"LOH, MTAL cell"
"GAGCTGCAGCGCATCC"	"Exclude_hematopoietic"
"GAGGCAAAGAAGCCAC"	"Exclude_hematopoietic"
"GAGGCAAAGTGGTCAG"	"Exclude_hematopoietic"
"GAGGCAAAGTTCTACG"	"Exclude_hematopoietic"
"GAGGCAATCTCGTCGT"	"Exclude_hematopoietic"
"GAGGCCTAGTCATGAA"	"Exclude_hematopoietic"
"GAGGCCTTCATTTGGG"	"Exclude_hematopoietic"
"GAGGCCTTCGCTCCTA"	"Exclude_hematopoietic"
"GAGGGATAGCAAGGAA"	"Exclude_hematopoietic"
"GAGGGATGTGTCGATT"	"TPC_2"
"GAGGGTACAACGCCCA"	"Exclude_hematopoietic"
"GAGGGTATCCAACCGG"	"Exclude_hematopoietic"
"GAGGGTATCGTTCATT"	"Exclude_hematopoietic"
"GAGTCATAGCTAAGTA"	"Exclude_hematopoietic"
"GAGTCATTCTGCTCTG"	"Exclude_hematopoietic"
"GAGTCTAGTTGCCAAT"	"Exclude_hematopoietic"
"GAGTGAGAGCTTAGTC"	"Exclude_hematopoietic"
"GAGTGAGAGGGAACAA"	"Exclude_hematopoietic"
"GAGTGAGGTCGCAGTC"	"Exclude_hematopoietic"
"GAGTGTTCATCGAACT"	"TPC_2"
"GAGTTACAGTGCGTCC"	"Exclude_hematopoietic"
"GAGTTACCAGTTGTTG"	"Exclude_hematopoietic"
"GAGTTACCATGCGGTC"	"LOH, MTAL cell"
"GAGTTGTAGATTACCC"	"Exclude_hematopoietic"
"GAGTTGTAGCTAATGA"	"PEC"
"GAGTTGTGTCGATGCC"	"TPC_1"
"GAGTTGTGTGGATCAG"	"Exclude_hematopoietic"
"GAGTTTGAGGCTGAAC"	"Exclude_hematopoietic"
"GAGTTTGTCAACCGAT"	"Exclude_hematopoietic"
"GAGTTTGTCCTACCGT"	"IC-A"
"GAGTTTGTCGGACAAG"	"LOH, MTAL cell"
"GAGTTTGTCGTAGGGA"	"LOH, MTAL cell"
"GATAGAACAATTCTCT"	"Exclude_hematopoietic"
"GATAGAAGTACCTGTA"	"TPC_1"
"GATAGCTAGTTCCGTA"	"Exclude_hematopoietic"
"GATAGCTGTAACAGTA"	"Exclude_hematopoietic"
"GATAGCTGTTCCCAAA"	"Exclude_hematopoietic"
"GATCACACATCGGCCA"	"Exclude_hematopoietic"
"GATCACATCATTTCGT"	"Exclude_hematopoietic"
"GATCACATCTTCTCAA"	"TPC_1"
"GATCAGTCACAGAGAC"	"Exclude_hematopoietic"
"GATCAGTTCACTTCTA"	"Exclude_hematopoietic"
"GATCATGAGGCTCTAT"	"Exclude_hematopoietic"
"GATCATGCAAAGGAGA"	"LOH, MTAL cell"
"GATCATGCAGCTGAAG"	"Exclude_hematopoietic"
"GATCATGGTCTACAAC"	"Exclude_hematopoietic"
"GATCATGTCTAGAGCT"	"Exclude_hematopoietic"
"GATCCCTAGATGGGCT"	"Exclude_hematopoietic"
"GATCCCTAGCGTATGG"	"Exclude_hematopoietic"
"GATCCCTAGGCGATAC"	"Exclude_hematopoietic"
"GATCCCTCACGGCGTT"	"TPC_1"
"GATCGTACATGCAGCC"	"Exclude_hematopoietic"
"GATCGTAGTCAATCTG"	"Exclude_hematopoietic"
"GATGACTCAAATGCTC"	"Exclude_hematopoietic"
"GATGACTGTGTTTGCA"	"Exclude_hematopoietic"
"GATGACTGTTACACTG"	"Exclude_hematopoietic"
"GATGACTTCCTTCTGG"	"Exclude_hematopoietic"
"GATGAGGAGGGATGTC"	"Exclude_hematopoietic"
"GATGAGGTCGGTTGTA"	"Exclude_hematopoietic"
"GATGATCAGGAAAGGT"	"Exclude_hematopoietic"
"GATGATCCAACAAGTA"	"Exclude_endothelial"
"GATGCTAAGGGTTAGC"	"Exclude_hematopoietic"
"GATGCTACATTCATCT"	"Exclude_hematopoietic"
"GATGCTAGTCGTGCCA"	"TPC_2"
"GATGCTAGTGTTCCTC"	"Exclude_hematopoietic"
"GATGCTATCATGACAC"	"Exclude_hematopoietic"
"GATGGAGGTAGGCAAC"	"Exclude_endothelial"
"GATGGAGTCACCTTAT"	"TPC_2"
"GATGTTGTCCTTTAGT"	"TPC_2"
"GATTCGAAGGCTCTAT"	"Exclude_hematopoietic"
"GATTCGAAGTCAAGCG"	"Exclude_hematopoietic"
"GATTCGAGTAGGTAGC"	"Exclude_hematopoietic"
"GATTCGATCTAGAACC"	"Exclude_hematopoietic"
"GATTCTTCACCGTGGT"	"Exclude_hematopoietic"
"GATTCTTCATCGATAC"	"Exclude_hematopoietic"
"GATTCTTTCGCCGAAC"	"LOH, MTAL cell"
"GATTGGTAGAGCATCG"	"Exclude_hematopoietic"
"GATTGGTAGAGTTGCG"	"Exclude_hematopoietic"
"GATTGGTAGCCGTTAT"	"LOH, MTAL cell"
"GATTGGTAGGTAGGCT"	"Exclude_hematopoietic"
"GATTGGTCACTCTAGA"	"Exclude_hematopoietic"
"GATTGGTCATAGCTGT"	"Exclude_hematopoietic"
"GATTGGTTCGCAGTTA"	"Exclude_hematopoietic"
"GATTGGTTCGCCGTGA"	"Exclude_hematopoietic"
"GATTTCTAGCTGAGCA"	"Exclude_hematopoietic"
"GATTTCTCAAGGTCTT"	"Exclude_hematopoietic"
"GATTTCTCACCTCAGG"	"LOH, MTAL cell"
"GATTTCTGTTTGGAGG"	"TPC_1"
"GCAACATAGGGACAGG"	"TPC_2"
"GCAACATTCGAGCCTG"	"LOH, MTAL cell"
"GCAACCGAGTCATCGT"	"Exclude_hematopoietic"
"GCAACCGCACACAGCC"	"LOH, MTAL cell"
"GCAACCGGTCGCTGCA"	"Exclude_hematopoietic"
"GCAACCGTCATTGCGA"	"Exclude_hematopoietic"
"GCACATAAGATAGTCA"	"LOH, MTAL cell"
"GCACATAAGTCTCCTC"	"Exclude_hematopoietic"
"GCACATACACCCAACG"	"Exclude_hematopoietic"
"GCACGGTAGAAACTCA"	"Exclude_hematopoietic"
"GCACGGTAGAACAGGA"	"Exclude_endothelial"
"GCACGGTAGCGACTTT"	"Exclude_hematopoietic"
"GCACGGTAGGTAGGCT"	"Exclude_hematopoietic"
"GCACGGTCATTGAAAG"	"Exclude_hematopoietic"
"GCACGGTGTATGATCC"	"Exclude_hematopoietic"
"GCACGGTTCGTACACA"	"LOH, MTAL cell"
"GCACGGTTCTTGTTAC"	"LOH, MTAL cell"
"GCACGTGCAAATCAGA"	"Exclude_hematopoietic"
"GCACGTGCAGATGCGA"	"Exclude_hematopoietic"
"GCACGTGGTCAAGCCC"	"Exclude_hematopoietic"
"GCACGTGGTCCATCTC"	"LOH, MTAL cell"
"GCACGTGGTGAGTCAG"	"Exclude_hematopoietic"
"GCACTAAAGGCGAAGG"	"TPC_2"
"GCACTAAAGGGCAGTT"	"Exclude_hematopoietic"
"GCACTAACATCCAATG"	"LOH, MTAL cell"
"GCACTAATCGCTAAAC"	"Exclude_hematopoietic"
"GCAGCCATCTCTATGT"	"Exclude_hematopoietic"
"GCAGCTGCAAACTCGT"	"Exclude_hematopoietic"
"GCAGCTGTCGAGAAGC"	"Exclude_hematopoietic"
"GCAGCTGTCTGCACCT"	"Exclude_hematopoietic"
"GCAGGCTAGTCACTAC"	"LOH, MTAL cell"
"GCAGGCTCAATAACCC"	"Exclude_hematopoietic"
"GCAGGCTCACCGTGGT"	"LOH, MTAL cell"
"GCAGGCTCAGCAGTAG"	"PEC"
"GCAGGCTCAGCGCGTT"	"Exclude_hematopoietic"
"GCAGGCTGTGAATTAG"	"PEC"
"GCAGGCTTCAGGGATG"	"Exclude_hematopoietic"
"GCAGGCTTCGTTGCCT"	"Exclude_hematopoietic"
"GCAGGCTTCTCATGCC"	"Exclude_hematopoietic"
"GCAGTTAAGAGTCCGA"	"Exclude_hematopoietic"
"GCAGTTAAGCGTGTTT"	"Exclude_hematopoietic"
"GCAGTTACAGATTCGT"	"Exclude_hematopoietic"
"GCAGTTAGTCGTGGTC"	"Exclude_hematopoietic"
"GCATCGGCAGGCTATT"	"Exclude_hematopoietic"
"GCATCGGGTTGGGTTT"	"Exclude_hematopoietic"
"GCATCGGTCTCATTTG"	"TPC_1"
"GCATCTCCACTACAGT"	"TPC_2"
"GCATCTCCATCGATCA"	"LOH, MTAL cell"
"GCATCTCCATGGCACC"	"Exclude_hematopoietic"
"GCATCTCGTGTCTTCC"	"Exclude_hematopoietic"
"GCATCTCTCCTACACC"	"Exclude_hematopoietic"
"GCATCTCTCGTAACAC"	"Exclude_hematopoietic"
"GCATCTCTCGTACCTC"	"Exclude_hematopoietic"
"GCATGATAGCTTCATG"	"LOH, MTAL cell"
"GCATGATGTGGCACTC"	"TPC_1"
"GCCAACGAGAATAACC"	"Exclude_endothelial"
"GCCAACGAGGTGCGAT"	"Exclude_hematopoietic"
"GCCAACGAGGTTCCGC"	"Exclude_hematopoietic"
"GCCAACGAGTACTCGT"	"Exclude_hematopoietic"
"GCCAACGTCACAGAGG"	"Exclude_hematopoietic"
"GCCAACGTCCTACCAC"	"Exclude_hematopoietic"
"GCCAACGTCTCGACGG"	"TPC_2"
"GCCAGCACAGTTAGGG"	"Exclude_hematopoietic"
"GCCAGCAGTTGTCATG"	"Exclude_hematopoietic"
"GCCAGCATCCGTGGTG"	"Exclude_hematopoietic"
"GCCAGGTGTTCACGAT"	"Exclude_hematopoietic"
"GCCAGTGAGAGTCACG"	"IC-A"
"GCCAGTGAGGCCCACT"	"LOH, MTAL cell"
"GCCAGTGCACAATGAA"	"Exclude_hematopoietic"
"GCCAGTGCATCCTTCG"	"Exclude_hematopoietic"
"GCCAGTGCATGTCTAG"	"Exclude_hematopoietic"
"GCCAGTGTCCACTGAA"	"Exclude_hematopoietic"
"GCCAGTGTCCATAGGT"	"Exclude_endothelial"
"GCCATGGAGAAGATCT"	"Exclude_hematopoietic"
"GCCATGGCAACCGGAA"	"Exclude_hematopoietic"
"GCCATGGCAGACCTAT"	"TPC_2"
"GCCATGGGTATTTCGG"	"Exclude_endothelial"
"GCCATTCAGAGTGTTA"	"LOH, MTAL cell"
"GCCATTCGTCCAAATC"	"Exclude_hematopoietic"
"GCCCAGACAAATGGCG"	"LOH, MTAL cell"
"GCCCAGATCTGATTCT"	"Exclude_hematopoietic"
"GCCCGAAAGGAAAGTG"	"Exclude_hematopoietic"
"GCCCGAACAAGCTGTT"	"Exclude_hematopoietic"
"GCCCGAACATAATGAG"	"Exclude_hematopoietic"
"GCCCGAACATGATCTG"	"Exclude_hematopoietic"
"GCCCGAATCGGAAACG"	"Exclude_endothelial"
"GCCGATGAGTAAATGC"	"Exclude_hematopoietic"
"GCCGATGCAACATCGT"	"Exclude_hematopoietic"
"GCCGATGCATATGAAG"	"Exclude_hematopoietic"
"GCCGATGCATCGCTGG"	"LOH, MTAL cell"
"GCCGATGGTAACTTCG"	"LOH, MTAL cell"
"GCCGATGGTCCAGGTC"	"Exclude_hematopoietic"
"GCCGATGTCCTTTGAT"	"Exclude_hematopoietic"
"GCCGTGAAGAGTTGAT"	"IC-A"
"GCCGTGAAGCGGGTAT"	"Exclude_hematopoietic"
"GCCGTGAAGGACAAGA"	"Exclude_hematopoietic"
"GCCGTGACAATCGAAA"	"Exclude_hematopoietic"
"GCCGTGACACTAGTAC"	"IC-A"
"GCCGTGAGTTCTCTCG"	"Exclude_hematopoietic"
"GCCGTGATCTCTCTAA"	"Exclude_hematopoietic"
"GCCTGTTAGGGATGTC"	"PEC"
"GCCTGTTGTACTTGTG"	"Exclude_hematopoietic"
"GCCTGTTGTCTTTATC"	"Exclude_hematopoietic"
"GCCTGTTTCAATCAGC"	"Exclude_hematopoietic"
"GCCTGTTTCGTGCTCT"	"TPC_1"
"GCGAGAAAGAACAAGG"	"Exclude_endothelial"
"GCGAGAAAGATTTGCC"	"Exclude_hematopoietic"
"GCGAGAAGTCCTACGG"	"Exclude_hematopoietic"
"GCGAGAAGTGATTAGA"	"PEC"
"GCGAGAATCAGTGTTG"	"Exclude_endothelial"
"GCGATCGTCAAGTCGT"	"TPC_1"
"GCGGAAAAGGATACAT"	"Exclude_hematopoietic"
"GCGGAAACACCAAATC"	"LOH, MTAL cell"
"GCGGAAACAGCTATAC"	"Exclude_hematopoietic"
"GCGGAAACATCAGCTA"	"Exclude_hematopoietic"
"GCGGAAAGTATCGCGC"	"Exclude_hematopoietic"
"GCGGAAAGTTCATCTT"	"Exclude_hematopoietic"
"GCGGATCAGGCAGCTA"	"Exclude_endothelial"
"GCGGATCCAAGGGCAT"	"Exclude_hematopoietic"
"GCGGATCCACTGCACG"	"Exclude_hematopoietic"
"GCGGATCCATCGCTAA"	"Exclude_hematopoietic"
"GCGGATCGTGAGATAT"	"LOH, MTAL cell"
"GCGTGCACACGTCATA"	"Exclude_hematopoietic"
"GCGTTTCTCCAGTGCG"	"LOH, MTAL cell"
"GCTACAACAACGATTC"	"Exclude_hematopoietic"
"GCTACAAGTTCTCAGA"	"Exclude_hematopoietic"
"GCTACCTAGACAGCTG"	"Exclude_hematopoietic"
"GCTACCTAGGTCATCT"	"Exclude_hematopoietic"
"GCTACCTAGGTCCTGC"	"Exclude_hematopoietic"
"GCTACCTCAGCGTACC"	"Exclude_hematopoietic"
"GCTACCTGTATAGCTC"	"Exclude_hematopoietic"
"GCTACCTGTTGCGTAT"	"Exclude_hematopoietic"
"GCTACCTTCGGACTTA"	"LOH, MTAL cell"
"GCTCAAAAGCATCAAA"	"Exclude_hematopoietic"
"GCTCAAACAGACGATG"	"Exclude_hematopoietic"
"GCTCAAAGTAGTCTGT"	"Exclude_hematopoietic"
"GCTCAAATCGGTCATA"	"LOH, MTAL cell"
"GCTCAAATCTCTGACC"	"TPC_2"
"GCTGAATAGCACTAAA"	"Exclude_hematopoietic"
"GCTGAATAGCCACCGT"	"TPC_1"
"GCTGAATCAGAGGGTT"	"Exclude_hematopoietic"
"GCTGAATGTGGCACTC"	"Exclude_hematopoietic"
"GCTGAATGTTCATCGA"	"TPC_1"
"GCTGAATTCTGAGTCA"	"Exclude_hematopoietic"
"GCTGCAGAGGGCGAGA"	"Exclude_hematopoietic"
"GCTGCAGCAATTCGTG"	"LOH, MTAL cell"
"GCTGCAGTCCGCAACG"	"Exclude_hematopoietic"
"GCTGCAGTCGAGTCTA"	"LOH, MTAL cell"
"GCTTCACAGTAACCGG"	"Exclude_hematopoietic"
"GCTTGGGAGGGAGGCA"	"Exclude_hematopoietic"
"GCTTGGGAGTCGCCCA"	"LOH, MTAL cell"
"GCTTGGGGTGCAATGG"	"TPC_2"
"GCTTGGGTCATCACCC"	"Exclude_hematopoietic"
"GCTTGGGTCTGTCGTC"	"LOH, MTAL cell"
"GCTTTCGAGCAGCGAT"	"Exclude_hematopoietic"
"GCTTTCGAGCCTCTCT"	"Exclude_hematopoietic"
"GCTTTCGCAGCATGCC"	"Exclude_hematopoietic"
"GCTTTCGCAGTCTTCC"	"Exclude_hematopoietic"
"GCTTTCGGTAGGTCAG"	"Exclude_hematopoietic"
"GGAACCCAGAGCCTGA"	"TPC_1"
"GGAACCCAGCTCCGAC"	"TPC_1"
"GGAACCCCAGTCTCTC"	"TPC_1"
"GGAACCCCATATGAAG"	"Exclude_hematopoietic"
"GGAAGTGGTGCAGATG"	"Exclude_hematopoietic"
"GGAAGTGGTGGGCTTC"	"TPC_2"
"GGAAGTGTCATTGGTG"	"Exclude_hematopoietic"
"GGAAGTGTCGTCCTTG"	"Exclude_hematopoietic"
"GGAATCTAGCACCGTC"	"Exclude_hematopoietic"
"GGAATCTCACAGAGCA"	"Exclude_hematopoietic"
"GGAATCTCATCGATCA"	"TPC_1"
"GGAATCTGTATCACCA"	"Exclude_hematopoietic"
"GGAATCTTCCCTCATG"	"Exclude_hematopoietic"
"GGAATCTTCTGGCTGG"	"Exclude_hematopoietic"
"GGAATGGTCACCCTCA"	"Exclude_hematopoietic"
"GGACGTCAGTGGAATT"	"Exclude_hematopoietic"
"GGACGTCCAATCGCCG"	"Exclude_hematopoietic"
"GGACGTCCAATGACCT"	"Exclude_hematopoietic"
"GGACGTCCATCCCACT"	"Exclude_hematopoietic"
"GGACGTCGTACGTTCA"	"LOH, MTAL cell"
"GGACGTCTCGCAATGT"	"Exclude_hematopoietic"
"GGAGAACAGTCTAACC"	"Exclude_hematopoietic"
"GGAGAACCACCGAATT"	"Exclude_hematopoietic"
"GGAGAACCAGTTCTAG"	"Exclude_hematopoietic"
"GGAGAACGTCTCACGG"	"Exclude_hematopoietic"
"GGAGAACTCTCTCGAC"	"TPC_1"
"GGAGAACTCTGTCAGA"	"Exclude_hematopoietic"
"GGAGATGAGCCGAACA"	"Exclude_hematopoietic"
"GGAGATGCAGACAATA"	"Exclude_hematopoietic"
"GGAGATGTCAAGCCCG"	"LOH, MTAL cell"
"GGAGATGTCGACCAAT"	"Exclude_hematopoietic"
"GGAGCAATCTACGCAA"	"Exclude_hematopoietic"
"GGAGGATAGCTTAGTC"	"Exclude_hematopoietic"
"GGAGGATAGGGTGGGA"	"Exclude_hematopoietic"
"GGAGGATGTGGGATTG"	"TPC_2"
"GGAGGTAAGACTTGTC"	"Exclude_hematopoietic"
"GGAGGTACACCGGCTA"	"Exclude_hematopoietic"
"GGAGGTACACTCCGGA"	"Exclude_hematopoietic"
"GGAGGTACAGGAGGAG"	"Exclude_hematopoietic"
"GGATCTACAAATCCCA"	"Exclude_hematopoietic"
"GGATCTACATGCACTA"	"Exclude_hematopoietic"
"GGATCTAGTACGAGCA"	"Exclude_hematopoietic"
"GGATCTAGTTTGGAAA"	"Exclude_hematopoietic"
"GGATCTATCGAATCCA"	"Exclude_hematopoietic"
"GGATGTTCAATACCTG"	"Exclude_hematopoietic"
"GGATGTTTCATGGCCG"	"Exclude_hematopoietic"
"GGATGTTTCATTCCTA"	"TPC_2"
"GGATGTTTCCCATAGA"	"Exclude_hematopoietic"
"GGATGTTTCGCGAAGA"	"Exclude_endothelial"
"GGCACGTCATCCAATG"	"LOH, MTAL cell"
"GGCAGTCAGGCTAACG"	"Exclude_hematopoietic"
"GGCAGTCCAACGGGTA"	"TPC_2"
"GGCAGTCGTACAACGG"	"LOH, MTAL cell"
"GGCAGTCGTACCAGAG"	"Exclude_hematopoietic"
"GGCAGTCGTCTACAAC"	"Exclude_hematopoietic"
"GGCAGTCTCACATACG"	"Exclude_hematopoietic"
"GGCAGTCTCTGTTCAT"	"Exclude_hematopoietic"
"GGCGTCACAACATACC"	"TPC_1"
"GGCGTCAGTGTTACAC"	"Exclude_hematopoietic"
"GGCTGTGAGCTTCATG"	"Exclude_hematopoietic"
"GGCTGTGAGGCAGCTA"	"Exclude_hematopoietic"
"GGCTGTGGTACAGTCT"	"Exclude_hematopoietic"
"GGCTGTGTCCAACCAA"	"Exclude_hematopoietic"
"GGCTGTGTCTCGGTAA"	"TPC_1"
"GGCTTGGTCTAGACCA"	"Exclude_hematopoietic"
"GGCTTTCGTAGCTTTG"	"TPC_1"
"GGCTTTCGTCATGACT"	"Exclude_hematopoietic"
"GGGAAGTAGATACCAA"	"TPC_2"
"GGGAAGTTCATTGAGC"	"Exclude_endothelial"
"GGGACAAAGCACTCCG"	"Exclude_hematopoietic"
"GGGACAAAGTTGAAGT"	"LOH, MTAL cell"
"GGGACAAGTCAGGTGA"	"Exclude_hematopoietic"
"GGGACAAGTCTGATAC"	"TPC_2"
"GGGACAATCCAATCTT"	"Exclude_hematopoietic"
"GGGACCTCATGTGACT"	"TPC_1"
"GGGACCTTCCACATAG"	"Exclude_hematopoietic"
"GGGACTCAGCTAATCC"	"Exclude_hematopoietic"
"GGGACTCAGTATGCAA"	"TPC_1"
"GGGACTCGTCCTGAAT"	"Exclude_hematopoietic"
"GGGACTCTCAGGAAAT"	"TPC_1"
"GGGACTCTCCGAGAAG"	"TPC_1"
"GGGAGATCACGATTCA"	"Exclude_hematopoietic"
"GGGAGATCAGCACAAG"	"TPC_1"
"GGGAGATCATCCGGCA"	"Exclude_hematopoietic"
"GGGAGATTCCGACATA"	"Exclude_hematopoietic"
"GGGAGATTCTACACTT"	"Exclude_endothelial"
"GGGAGTAGTCTTCTAT"	"Exclude_hematopoietic"
"GGGAGTATCGTTCTCG"	"Exclude_hematopoietic"
"GGGATCCAGCGATGAC"	"LOH, MTAL cell"
"GGGATGAAGGCCTGCT"	"Exclude_hematopoietic"
"GGGATGAAGTTAGTAG"	"Exclude_hematopoietic"
"GGGATGACAAATCAGA"	"Exclude_hematopoietic"
"GGGATGACACCCATAA"	"Exclude_hematopoietic"
"GGGATGACAGCGTAGA"	"Exclude_hematopoietic"
"GGGCCATGTAACATGA"	"LOH, MTAL cell"
"GGGCCATGTCGGCCTA"	"Exclude_hematopoietic"
"GGGCGTTAGCTCTTCC"	"Exclude_hematopoietic"
"GGGCGTTCAAGGATGC"	"Exclude_hematopoietic"
"GGGCGTTCAGTTCCAA"	"Exclude_hematopoietic"
"GGGCGTTGTCCATAGT"	"Exclude_hematopoietic"
"GGGCGTTTCGCTGCGA"	"TPC_1"
"GGGCGTTTCGGACTGC"	"Exclude_endothelial"
"GGGCGTTTCGGTCGGT"	"Exclude_hematopoietic"
"GGGCGTTTCTTGTGCC"	"Exclude_hematopoietic"
"GGGCTACAGCCTAGGA"	"Exclude_hematopoietic"
"GGGCTACGTGAGGAAA"	"TPC_2"
"GGGCTACTCCATCAGA"	"Exclude_hematopoietic"
"GGGCTACTCGTCTACC"	"Exclude_hematopoietic"
"GGGCTACTCTCCAAGA"	"TPC_1"
"GGGCTCAAGGCCTAAG"	"Exclude_hematopoietic"
"GGGCTCATCCACTGGG"	"Exclude_hematopoietic"
"GGGTAGAAGCTTCGTA"	"Exclude_hematopoietic"
"GGGTAGAAGTAACGTA"	"Exclude_hematopoietic"
"GGGTAGACACCAACAT"	"TPC_1"
"GGGTAGAGTTAAAGTG"	"Exclude_hematopoietic"
"GGGTATTAGCTCTGTA"	"Exclude_hematopoietic"
"GGGTATTAGGGTAATT"	"Exclude_hematopoietic"
"GGGTATTTCTCCATAT"	"Exclude_hematopoietic"
"GGGTCACAGTAAATGC"	"IC-A"
"GGGTCACAGTCACGAG"	"Exclude_hematopoietic"
"GGGTCACCACTTCCTG"	"Exclude_hematopoietic"
"GGGTCACCAGCTGGTC"	"Exclude_hematopoietic"
"GGGTCACGTACAAACA"	"Exclude_hematopoietic"
"GGGTCACGTACGTACT"	"Exclude_hematopoietic"
"GGGTCACTCCAACTAG"	"Exclude_hematopoietic"
"GGGTCACTCCTGCTAC"	"TPC_2"
"GGGTCTGCACTCAGAT"	"Exclude_endothelial"
"GGGTCTGGTGGCAACA"	"Exclude_hematopoietic"
"GGGTCTGTCCGGCAAC"	"Exclude_hematopoietic"
"GGGTGAAGTACTGCCG"	"Exclude_hematopoietic"
"GGGTGTCGTAGGCTCC"	"TPC_1"
"GGGTTATAGCATGAAT"	"LOH, MTAL cell"
"GGGTTATAGTAATACG"	"Exclude_hematopoietic"
"GGGTTATCACGACAAG"	"Exclude_hematopoietic"
"GGGTTATCATAATGCC"	"LOH, MTAL cell"
"GGGTTATTCCTGGCTT"	"Exclude_hematopoietic"
"GGGTTTAAGCGTGCTC"	"Exclude_hematopoietic"
"GGGTTTACAGAGGCTA"	"Exclude_hematopoietic"
"GGGTTTACAGGTTCAT"	"LOH, MTAL cell"
"GGGTTTACATGCGTGC"	"Exclude_hematopoietic"
"GGGTTTATCCCAGCGA"	"LOH, MTAL cell"
"GGGTTTATCGGAGTGA"	"LOH, MTAL cell"
"GGTAACTAGAGAGCAA"	"Exclude_hematopoietic"
"GGTAACTAGCTGACCC"	"TPC_1"
"GGTAATCAGCACTGGA"	"TPC_1"
"GGTAATCAGCAGCCTC"	"Exclude_hematopoietic"
"GGTAATCAGTAACGAT"	"Exclude_hematopoietic"
"GGTAATCAGTATCCTG"	"LOH, MTAL cell"
"GGTAATCCACGAAAGC"	"Exclude_hematopoietic"
"GGTAATCCAGTTCACA"	"Exclude_hematopoietic"
"GGTAATCGTCGGTGAA"	"Exclude_hematopoietic"
"GGTAATCTCCAACCAA"	"Exclude_hematopoietic"
"GGTAGAGAGCCGATTT"	"Exclude_hematopoietic"
"GGTAGAGCAGAGGAAA"	"Exclude_hematopoietic"
"GGTCACGAGCCTCCAG"	"Exclude_hematopoietic"
"GGTCACGCACTGCGAC"	"Exclude_hematopoietic"
"GGTCACGTCTGAGGCC"	"Exclude_hematopoietic"
"GGTCTGGCAGCGCTTG"	"Exclude_hematopoietic"
"GGTCTGGCATCTAGAC"	"Exclude_hematopoietic"
"GGTCTGGGTAGCTGCC"	"Exclude_hematopoietic"
"GGTCTGGTCCGGTAAT"	"Exclude_hematopoietic"
"GGTCTGGTCTCCACTG"	"Exclude_hematopoietic"
"GGTGAAGAGCTATCCA"	"Exclude_hematopoietic"
"GGTGAAGAGCTGTCCG"	"Exclude_hematopoietic"
"GGTGAAGCACTAACGT"	"TPC_1"
"GGTGAAGGTTCGGACC"	"Exclude_hematopoietic"
"GGTGATTCACAAAGTA"	"Exclude_hematopoietic"
"GGTGATTGTGACTAAA"	"Exclude_hematopoietic"
"GGTGATTGTTCTGACA"	"Exclude_hematopoietic"
"GGTGATTTCCCTATTA"	"Exclude_hematopoietic"
"GGTGGCTAGCCAACCC"	"LOH, MTAL cell"
"GGTGGCTGTGACTATC"	"LOH, MTAL cell"
"GGTGGCTTCTCCGAGG"	"Exclude_hematopoietic"
"GGTGTCGAGCCTCCAG"	"Exclude_hematopoietic"
"GGTGTCGCACCAGCTG"	"Exclude_hematopoietic"
"GGTGTCGCAGCCGTTG"	"TPC_1"
"GGTGTCGCATGAATAG"	"Exclude_hematopoietic"
"GGTGTCGCATGTTCAG"	"Exclude_hematopoietic"
"GGTGTCGGTAGTACGG"	"Exclude_hematopoietic"
"GGTGTTAAGAGATGCC"	"Exclude_hematopoietic"
"GGTGTTAAGGAGAGTA"	"Exclude_hematopoietic"
"GGTGTTAAGTCGTTAC"	"Exclude_hematopoietic"
"GGTGTTAAGTTGCTCA"	"TPC_1"
"GGTGTTAGTATTCCTT"	"LOH, MTAL cell"
"GGTGTTATCGCAATGT"	"Exclude_hematopoietic"
"GGTGTTATCTTAGCCC"	"Exclude_hematopoietic"
"GGTTAACCACTCCGAG"	"LOH, MTAL cell"
"GGTTCTCCACATGACT"	"Exclude_hematopoietic"
"GGTTCTCCATTGACTG"	"Exclude_hematopoietic"
"GGTTCTCGTAGGGAGG"	"TPC_2"
"GGTTCTCTCATTATCC"	"Exclude_hematopoietic"
"GGTTCTCTCCGTTGGG"	"LOH, MTAL cell"
"GGTTCTCTCCTATTTG"	"Exclude_hematopoietic"
"GGTTGTATCATCGACA"	"TPC_2"
"GGTTGTATCTAGACCA"	"Exclude_hematopoietic"
"GTAACACAGAAGTGTT"	"Exclude_endothelial"
"GTAACACCAAAGGCGT"	"Exclude_hematopoietic"
"GTAACACCAATTAGGA"	"LOH, MTAL cell"
"GTAACACGTCCACTCT"	"Exclude_hematopoietic"
"GTAACACTCTGTCCCA"	"Exclude_hematopoietic"
"GTAACCAAGAACCGCA"	"Exclude_hematopoietic"
"GTAACCAAGACTGTTC"	"Exclude_hematopoietic"
"GTAACCAAGTGTTCAC"	"Exclude_hematopoietic"
"GTAACCAGTACGCTTA"	"TPC_1"
"GTAAGTCAGCCATGCC"	"TPC_1"
"GTAAGTCGTGGTCTCG"	"Exclude_hematopoietic"
"GTAAGTCTCTCTCAAT"	"Exclude_hematopoietic"
"GTAATCGCATTGAGCT"	"Exclude_hematopoietic"
"GTAATCGGTATGGGAC"	"Exclude_hematopoietic"
"GTAATCGTCGAGTACT"	"TPC_1"
"GTAATGCAGTTACTCG"	"Exclude_hematopoietic"
"GTAATGCGTATGGTAA"	"Exclude_hematopoietic"
"GTAATGCGTGTCGCTG"	"Exclude_hematopoietic"
"GTAATGCGTTCGAACT"	"Exclude_hematopoietic"
"GTAATGCGTTGCAAGG"	"LOH, MTAL cell"
"GTAATGCTCTGATGGT"	"IC-A"
"GTACAACAGAGGTGCT"	"Exclude_hematopoietic"
"GTACAACAGTAAATGC"	"Exclude_hematopoietic"
"GTACAACCAGGTGAGT"	"Exclude_hematopoietic"
"GTACAACGTCTGATAC"	"Exclude_hematopoietic"
"GTACAACGTTGTGCAT"	"Exclude_hematopoietic"
"GTACAACTCTACGGTA"	"Exclude_hematopoietic"
"GTACAGTAGAAGGATG"	"Exclude_hematopoietic"
"GTACAGTCACTGCATA"	"LOH, MTAL cell"
"GTACAGTCATGGCACC"	"Exclude_hematopoietic"
"GTACAGTTCCTGGTCT"	"Exclude_hematopoietic"
"GTACAGTTCCTTATCA"	"Exclude_hematopoietic"
"GTACAGTTCGTCGGGT"	"LOH, MTAL cell"
"GTAGAAACATTGAAGA"	"Exclude_hematopoietic"
"GTAGAAATCCTCCACA"	"TPC_1"
"GTAGAAATCTATCGCC"	"Exclude_hematopoietic"
"GTAGAAATCTCCAATT"	"Exclude_hematopoietic"
"GTAGAGGGTATACCCA"	"Exclude_hematopoietic"
"GTAGAGGTCACCTACC"	"Exclude_hematopoietic"
"GTAGATCCAATCCTTT"	"Exclude_hematopoietic"
"GTAGATCGTACTTGTG"	"Exclude_hematopoietic"
"GTAGATCGTAGATTGA"	"Exclude_hematopoietic"
"GTAGATCGTGTGATGG"	"LOH, MTAL cell"
"GTAGATCTCTGGACTA"	"Exclude_hematopoietic"
"GTAGCTACAACCCTAA"	"Exclude_hematopoietic"
"GTAGGAGAGGCCTTCG"	"Exclude_hematopoietic"
"GTAGGAGTCAGATGCT"	"TPC_2"
"GTAGGAGTCCCAATAG"	"Exclude_hematopoietic"
"GTAGGTTAGACTTCGT"	"Exclude_hematopoietic"
"GTAGGTTCACTGTTCC"	"Exclude_hematopoietic"
"GTAGGTTCATTCTGTT"	"Exclude_hematopoietic"
"GTAGTACAGAACCGCA"	"TPC_2"
"GTAGTACAGACGCCAA"	"Exclude_hematopoietic"
"GTAGTACAGAGTTCGG"	"Exclude_hematopoietic"
"GTAGTACAGTCGGCAA"	"TPC_1"
"GTAGTACCACTGTGAT"	"Exclude_hematopoietic"
"GTAGTACGTCGTACTA"	"Exclude_hematopoietic"
"GTAGTACGTCTAGTGT"	"Exclude_hematopoietic"
"GTAGTACTCCAATCCC"	"LOH, MTAL cell"
"GTAGTACTCGACGAGA"	"Exclude_hematopoietic"
"GTAGTACTCGCCCAGA"	"Exclude_hematopoietic"
"GTAGTACTCGTTGCCT"	"TPC_2"
"GTATTGGAGGATGAGA"	"Exclude_hematopoietic"
"GTATTGGCAATACCCA"	"Exclude_hematopoietic"
"GTATTGGGTCGTTGCG"	"Exclude_hematopoietic"
"GTATTGGTCGTCACCT"	"Exclude_hematopoietic"
"GTCAAACGTACGAGCA"	"Exclude_hematopoietic"
"GTCAAGTGTATCGCAT"	"Exclude_hematopoietic"
"GTCAAGTGTTGATCGT"	"TPC_2"
"GTCAAGTTCTCAAAGC"	"Exclude_hematopoietic"
"GTCACGGAGGATACCG"	"Exclude_hematopoietic"
"GTCACTCAGGGACACT"	"Exclude_hematopoietic"
"GTCACTCTCCGATCGG"	"LOH, MTAL cell"
"GTCAGCGAGTAAGAGG"	"TPC_2"
"GTCATCCAGACCCTTA"	"TPC_2"
"GTCATCCAGACTCTTG"	"Exclude_hematopoietic"
"GTCATCCAGGGACACT"	"TPC_2"
"GTCATCCCAAATAAGC"	"Exclude_hematopoietic"
"GTCATCCCACGCCAGT"	"Exclude_hematopoietic"
"GTCATCCGTATCGAAA"	"Exclude_hematopoietic"
"GTCATCCTCATAGCAC"	"Exclude_hematopoietic"
"GTCATGATCGAACGCC"	"Exclude_endothelial"
"GTCATTTGTGTTAGCT"	"Exclude_hematopoietic"
"GTCATTTTCAAGTAAG"	"Exclude_hematopoietic"
"GTCCACTAGGAACGCT"	"Exclude_hematopoietic"
"GTCCACTAGGACAGCT"	"Exclude_hematopoietic"
"GTCCCATGTACTGCGC"	"Exclude_hematopoietic"
"GTCCCATGTGGGCTCT"	"LOH, MTAL cell"
"GTCCCATGTTCAAAGA"	"Exclude_hematopoietic"
"GTCCCATTCCGAGTGC"	"Exclude_hematopoietic"
"GTCCCATTCTACCCAC"	"LOH, MTAL cell"
"GTCCTCAAGAGAGGTA"	"LOH, MTAL cell"
"GTCCTCAGTAGAATAC"	"Exclude_hematopoietic"
"GTCGAATAGATAGTGT"	"LOH, MTAL cell"
"GTCGAATAGTGTACAA"	"LOH, MTAL cell"
"GTCGAATGTTTATGCG"	"Exclude_hematopoietic"
"GTCGCGAAGCTGAAGC"	"Exclude_hematopoietic"
"GTCGCGAAGGCAGGGA"	"Exclude_hematopoietic"
"GTCGCGACAGACAATA"	"Exclude_hematopoietic"
"GTCGCGACATAACTCG"	"LOH, MTAL cell"
"GTCGCGAGTCCTATAG"	"Exclude_hematopoietic"
"GTCGTAAAGAATTTGG"	"LOH, MTAL cell"
"GTCGTAAAGATGAACT"	"TPC_2"
"GTCGTAACACCGGTCA"	"Exclude_hematopoietic"
"GTCGTAACAGAGTTCT"	"LOH, MTAL cell"
"GTCGTAAGTCGAAACG"	"Exclude_hematopoietic"
"GTCGTAATCATCACCC"	"TPC_1"
"GTCGTAATCATTACTC"	"Exclude_hematopoietic"
"GTCGTAATCGGCATAT"	"Exclude_hematopoietic"
"GTCGTTCCAGTAACAA"	"Exclude_hematopoietic"
"GTCGTTCGTGAACCGA"	"TPC_2"
"GTCGTTCGTGGAACCA"	"TPC_1"
"GTCGTTCGTTTCGTTT"	"Exclude_hematopoietic"
"GTCTACCAGACAGTCG"	"PEC"
"GTCTACCAGCTTTGTG"	"TPC_1"
"GTCTACCAGGCTTCCG"	"Exclude_hematopoietic"
"GTCTACCGTCATGGCC"	"Exclude_hematopoietic"
"GTCTACCGTCTTGCTC"	"Exclude_hematopoietic"
"GTCTACCGTGACAGCA"	"Exclude_hematopoietic"
"GTCTACCTCCGATAGT"	"Exclude_hematopoietic"
"GTCTACCTCGCAATGT"	"Exclude_hematopoietic"
"GTCTACCTCGCATGAT"	"TPC_2"
"GTCTACCTCGTCCTCA"	"TPC_2"
"GTCTAGAGTCTCCCTA"	"Exclude_hematopoietic"
"GTCTAGATCACTGTCC"	"Exclude_hematopoietic"
"GTCTCACCAGCAGTAG"	"Exclude_hematopoietic"
"GTCTCACGTACGAAAT"	"Exclude_hematopoietic"
"GTCTCACGTGTAAATG"	"Exclude_hematopoietic"
"GTCTCACTCCAGGACC"	"Exclude_hematopoietic"
"GTCTGTCAGGGCATGT"	"Exclude_hematopoietic"
"GTCTGTCGTGCTATTG"	"LOH, MTAL cell"
"GTCTGTCTCGCAGAGA"	"Exclude_hematopoietic"
"GTCTGTCTCGCTGCGA"	"Exclude_hematopoietic"
"GTCTGTCTCGTTAGAC"	"Exclude_hematopoietic"
"GTCTTTAAGAAGCCTG"	"Exclude_hematopoietic"
"GTCTTTAGTCTCGGGT"	"LOH, MTAL cell"
"GTGACGCAGACCTTTG"	"Exclude_hematopoietic"
"GTGACGCCAAATGGCG"	"Exclude_hematopoietic"
"GTGACGCCACGCCACA"	"Exclude_hematopoietic"
"GTGACGCCATGCCGCA"	"LOH, MTAL cell"
"GTGACGCGTAGCTTGT"	"Exclude_hematopoietic"
"GTGAGCCAGAAGTGTT"	"Exclude_hematopoietic"
"GTGAGCCAGCAAGGAA"	"Exclude_hematopoietic"
"GTGAGCCAGTCCCTAA"	"Exclude_hematopoietic"
"GTGAGCCAGTTACGTC"	"TPC_1"
"GTGAGCCCAGCCGTCA"	"Exclude_hematopoietic"
"GTGAGCCCAGGTACGA"	"LOH, MTAL cell"
"GTGAGCCGTGTTTGCA"	"Exclude_hematopoietic"
"GTGAGGATCAGGGTAG"	"Exclude_hematopoietic"
"GTGAGGATCTGTCCGT"	"Exclude_hematopoietic"
"GTGAGTTAGGACAGCT"	"Exclude_hematopoietic"
"GTGAGTTGTAGCACGA"	"Exclude_hematopoietic"
"GTGAGTTGTTGCAACT"	"LOH, MTAL cell"
"GTGATGTAGGTACAAT"	"Exclude_hematopoietic"
"GTGATGTCATGAATCC"	"Exclude_hematopoietic"
"GTGATGTGTGTTAAAG"	"TPC_1"
"GTGATGTTCGTTAGTG"	"Exclude_hematopoietic"
"GTGATGTTCTGGGCCA"	"LOH, MTAL cell"
"GTGCACGAGCCTCAGC"	"Exclude_hematopoietic"
"GTGCACGAGCTGACAG"	"Exclude_hematopoietic"
"GTGCACGCAACCGCTG"	"TPC_1"
"GTGCACGGTAGAGACC"	"Exclude_hematopoietic"
"GTGCACGTCACCCATC"	"Exclude_endothelial"
"GTGCAGCCACATGTTG"	"Exclude_hematopoietic"
"GTGCAGCCACTTGTCC"	"Exclude_hematopoietic"
"GTGCAGCTCTAGACCA"	"TPC_2"
"GTGCGTGGTCAGGTAG"	"Exclude_hematopoietic"
"GTGCGTGGTTCGGCGT"	"LOH, MTAL cell"
"GTGCGTGTCACACCCT"	"Exclude_hematopoietic"
"GTGCGTGTCCCGATCT"	"Exclude_hematopoietic"
"GTGCGTGTCCTAGAGT"	"Exclude_hematopoietic"
"GTGCTGGAGCCGGATA"	"Exclude_hematopoietic"
"GTGCTGGGTAGAGACC"	"Exclude_hematopoietic"
"GTGCTGGTCTGCATAG"	"Exclude_hematopoietic"
"GTGCTTCAGATTAGCA"	"Exclude_hematopoietic"
"GTGCTTCAGATTAGTG"	"TPC_2"
"GTGCTTCAGCCATATC"	"Exclude_hematopoietic"
"GTGCTTCCAAGTCGTT"	"Exclude_hematopoietic"
"GTGCTTCCACCTGATA"	"Exclude_hematopoietic"
"GTGCTTCCATCACGGC"	"Exclude_hematopoietic"
"GTGCTTCCATGGCTGC"	"Exclude_hematopoietic"
"GTGCTTCGTTAGGCTT"	"Exclude_hematopoietic"
"GTGCTTCTCTGAGAAA"	"PEC"
"GTGGAAGAGGTAAGGA"	"TPC_1"
"GTGGAAGTCGACGCGT"	"Exclude_hematopoietic"
"GTGGAAGTCGCATGAT"	"Exclude_hematopoietic"
"GTGGAGACAACCCGCA"	"Exclude_hematopoietic"
"GTGGAGACAAGAGTGC"	"Exclude_hematopoietic"
"GTGGAGACACCTGAAT"	"Exclude_hematopoietic"
"GTGGAGAGTGATACCT"	"Exclude_hematopoietic"
"GTGGCGTCACTCTCGT"	"Exclude_hematopoietic"
"GTGGCGTGTCTTACAG"	"Exclude_hematopoietic"
"GTGGCGTGTTTGCCGG"	"Exclude_hematopoietic"
"GTGGGAAAGATCGACG"	"Exclude_hematopoietic"
"GTGGGAACAAATGGCG"	"Exclude_hematopoietic"
"GTGGGAACAGAGGAAA"	"Exclude_endothelial"
"GTGGGAAGTCGAGTGA"	"Exclude_hematopoietic"
"GTGGGAATCTCCAAGA"	"Exclude_hematopoietic"
"GTGGTTAGTAACCAGG"	"Exclude_hematopoietic"
"GTGTAACAGAAGCGGG"	"Exclude_hematopoietic"
"GTGTAACAGTATTAGG"	"Exclude_hematopoietic"
"GTGTAACCACTCCACT"	"Exclude_hematopoietic"
"GTGTAACCATCCCGTT"	"LOH, MTAL cell"
"GTGTAACGTACGGTTT"	"Exclude_hematopoietic"
"GTGTAACTCTCGACCT"	"Exclude_hematopoietic"
"GTGTCCTAGAGTTGTA"	"Exclude_hematopoietic"
"GTGTCCTAGCTACGTT"	"Exclude_hematopoietic"
"GTGTCCTTCTCCTGTG"	"Exclude_hematopoietic"
"GTGTGATAGCCGTCGT"	"Exclude_hematopoietic"
"GTGTGATGTATACCCA"	"Exclude_hematopoietic"
"GTGTGATGTTCTTGCC"	"Exclude_hematopoietic"
"GTGTGATTCAGCGGAA"	"Exclude_hematopoietic"
"GTGTGATTCATGGATC"	"Exclude_hematopoietic"
"GTGTGGCTCACAATGC"	"TPC_1"
"GTGTGGCTCCACATAG"	"LOH, MTAL cell"
"GTGTTAGAGCTCCACG"	"Exclude_hematopoietic"
"GTGTTAGCAGTTAGGG"	"LOH, MTAL cell"
"GTGTTCCAGGTAACTA"	"TPC_2"
"GTGTTCCCAGAGTTCT"	"IC-A"
"GTTACAGAGGGAGATA"	"Exclude_hematopoietic"
"GTTACAGCATCACAGT"	"Exclude_hematopoietic"
"GTTACCCAGCGTATAA"	"Exclude_hematopoietic"
"GTTACCCAGTTTGGCT"	"Exclude_hematopoietic"
"GTTACCCCAAGGTCAG"	"LOH, MTAL cell"
"GTTACCCGTATGTGTC"	"IC-A"
"GTTACCCGTGGTCCGT"	"Exclude_hematopoietic"
"GTTACGAAGTAAGGGA"	"TPC_1"
"GTTACGAAGTTTCTTC"	"PEC"
"GTTACGACAGAACCGA"	"TPC_1"
"GTTACGACAGTCAGTT"	"LOH, MTAL cell"
"GTTACGACATCCTAAG"	"Exclude_hematopoietic"
"GTTACGATCGGACAAG"	"Exclude_hematopoietic"
"GTTAGACAGCCTGCCA"	"Exclude_hematopoietic"
"GTTAGACAGGGTTAAT"	"Exclude_hematopoietic"
"GTTAGACAGTAGAGTT"	"Exclude_endothelial"
"GTTAGACTCAATGTCG"	"TPC_1"
"GTTAGACTCCATACAG"	"Exclude_hematopoietic"
"GTTAGTGAGCGGGTAT"	"Exclude_hematopoietic"
"GTTAGTGCAATCTGCA"	"Exclude_hematopoietic"
"GTTAGTGCATAGTCAC"	"Exclude_hematopoietic"
"GTTAGTGCATTCTCTA"	"Exclude_hematopoietic"
"GTTATGGAGCACCGTC"	"Exclude_hematopoietic"
"GTTATGGAGCCAGACA"	"IC-A"
"GTTATGGAGCGACTTT"	"Exclude_hematopoietic"
"GTTATGGCACACCGAC"	"Exclude_hematopoietic"
"GTTATGGCACGCGTGT"	"Exclude_hematopoietic"
"GTTATGGCAGTATACC"	"Exclude_hematopoietic"
"GTTCATTAGCATAGGC"	"Exclude_hematopoietic"
"GTTCATTCAATTTCTC"	"Exclude_hematopoietic"
"GTTCATTCATCTCGTC"	"Exclude_hematopoietic"
"GTTCATTTCCAATGCA"	"TPC_2"
"GTTCCGTGTATGGGAC"	"Exclude_hematopoietic"
"GTTCCGTGTGTCACAT"	"Exclude_hematopoietic"
"GTTCGCTCACGACAAG"	"Exclude_hematopoietic"
"GTTCGCTGTCTATGAC"	"Exclude_hematopoietic"
"GTTCGCTGTGAATTAG"	"Exclude_hematopoietic"
"GTTCTATCACCGCTAG"	"Exclude_hematopoietic"
"GTTCTATTCCTGGTCT"	"Exclude_hematopoietic"
"GTTGAACCAACACAAA"	"Exclude_hematopoietic"
"GTTGAACTCCCGAACG"	"Exclude_hematopoietic"
"GTTGAACTCCTGCCAT"	"Exclude_hematopoietic"
"GTTGCGGGTACGCTTA"	"Exclude_hematopoietic"
"GTTGCGGGTCACTCTC"	"Exclude_hematopoietic"
"GTTGCGGGTCGAACGA"	"Exclude_hematopoietic"
"GTTGCGGTCGCCAATA"	"Exclude_hematopoietic"
"GTTGCGGTCGTCTCAC"	"Exclude_hematopoietic"
"GTTGCGGTCGTGGGAA"	"Exclude_endothelial"
"GTTGCTCAGCCAACCC"	"Exclude_hematopoietic"
"GTTGCTCAGGCCTAAG"	"LOH, MTAL cell"
"GTTGCTCGTCGAATTC"	"TPC_1"
"GTTGCTCTCAAGCTTG"	"TPC_2"
"GTTGCTCTCACTTATC"	"LOH, MTAL cell"
"GTTGCTCTCATGCCCT"	"Exclude_hematopoietic"
"GTTGCTCTCGGCCTTT"	"Exclude_hematopoietic"
"GTTGCTCTCTGGTGGC"	"Exclude_hematopoietic"
"GTTGTAGAGGGATCGT"	"Exclude_hematopoietic"
"GTTGTAGCACATGAAA"	"Exclude_hematopoietic"
"GTTGTAGCACCGGTCA"	"Exclude_hematopoietic"
"GTTGTAGCATCATCTT"	"TPC_2"
"GTTGTAGGTACGGGAT"	"Exclude_hematopoietic"
"GTTGTAGGTGTGGACA"	"Exclude_hematopoietic"
"GTTGTAGTCATGGAGG"	"Exclude_hematopoietic"
"GTTGTAGTCTTTCGAT"	"IC-A"
"GTTGTCCAGAAACTCA"	"Exclude_hematopoietic"
"GTTGTCCAGCTCCCTT"	"Exclude_hematopoietic"
"GTTGTCCAGGTCCCTG"	"Exclude_hematopoietic"
"GTTGTCCAGTCTAACC"	"Exclude_hematopoietic"
"GTTGTCCCATGACGGA"	"IC-A"
"GTTGTCCGTATTTCCT"	"LOH, MTAL cell"
"GTTGTCCTCTGGGCAC"	"Exclude_hematopoietic"
"GTTGTGATCCGCATAA"	"Exclude_hematopoietic"
"GTTTACTAGGTTCACT"	"Exclude_hematopoietic"
"GTTTACTGTAACCCGC"	"Exclude_hematopoietic"
"GTTTACTGTATCCTTT"	"Exclude_hematopoietic"
"GTTTGGAAGCCGGAAT"	"TPC_2"
"GTTTGGAAGTACTGTC"	"LOH, MTAL cell"
"GTTTGGACAAATGCTC"	"LOH, MTAL cell"
"GTTTGGACACCCTCTA"	"Exclude_hematopoietic"
"GTTTGGACAGTGGTGA"	"Exclude_hematopoietic"
"GTTTGGACATGAGTAA"	"Exclude_hematopoietic"
"GTTTGGATCTACTATC"	"LOH, MTAL cell"
"TAACACGCAAGTTGGG"	"LOH, MTAL cell"
"TAACACGCATTCTTCA"	"Exclude_hematopoietic"
"TAACACGGTGAGTCAG"	"Exclude_hematopoietic"
"TAACACGTCCTTCTGG"	"Exclude_hematopoietic"
"TAACACGTCGCCGTGA"	"Exclude_hematopoietic"
"TAACACGTCTTCGTGC"	"TPC_1"
"TAACCAGAGGGCTGAT"	"Exclude_endothelial"
"TAACCAGCAAACTAAG"	"Exclude_hematopoietic"
"TAACCAGCAGCTCCTT"	"Exclude_hematopoietic"
"TAACCAGCATCCGTTC"	"Exclude_hematopoietic"
"TAACGACAGCACCTGC"	"Exclude_hematopoietic"
"TAACTTCAGGGACCAT"	"Exclude_hematopoietic"
"TAACTTCCACTGGATT"	"TPC_2"
"TAACTTCCATTGCTTT"	"Exclude_hematopoietic"
"TAACTTCGTCGAATTC"	"Exclude_hematopoietic"
"TAACTTCGTTCTCGCT"	"Exclude_hematopoietic"
"TAACTTCTCGGCCTTT"	"Exclude_hematopoietic"
"TAAGCACAGCCTGTGC"	"LOH, MTAL cell"
"TAAGCACAGGATGTTA"	"Exclude_hematopoietic"
"TAAGCACGTATTGCCA"	"LOH, MTAL cell"
"TAAGCCACACTCTGCT"	"Exclude_hematopoietic"
"TAAGCCAGTTGGGCCT"	"TPC_2"
"TAAGCCATCTACGGTA"	"Exclude_hematopoietic"
"TAAGCGTAGCACTCGC"	"Exclude_hematopoietic"
"TAAGCGTAGTCTAGAA"	"Exclude_hematopoietic"
"TAAGCGTTCACTTGGA"	"Exclude_hematopoietic"
"TAAGCGTTCCACGGGT"	"Exclude_hematopoietic"
"TAAGTCGAGCAAGTGC"	"Exclude_hematopoietic"
"TAAGTCGAGGAAAGAC"	"TPC_1"
"TAAGTCGGTCCACTCT"	"Exclude_hematopoietic"
"TAATCTCAGGGTATAT"	"LOH, MTAL cell"
"TAATCTCTCGCGTTTC"	"Exclude_hematopoietic"
"TAATTCCAGGTCGACA"	"Exclude_hematopoietic"
"TAATTCCCAATGGCAG"	"TPC_1"
"TAATTCCGTAGACAAT"	"Exclude_hematopoietic"
"TACAACGCAAATAGCA"	"TPC_1"
"TACAACGCACGACAAG"	"Exclude_hematopoietic"
"TACAACGTCCTGTTAT"	"Exclude_hematopoietic"
"TACAACGTCGCCTCTA"	"Exclude_hematopoietic"
"TACACCCAGGCTGGAT"	"Exclude_hematopoietic"
"TACACCCAGGCTTTCA"	"Exclude_hematopoietic"
"TACACCCCAATCAGCT"	"Exclude_hematopoietic"
"TACACCCTCTCCTGAC"	"Exclude_hematopoietic"
"TACAGGTAGGTCCTGC"	"Exclude_hematopoietic"
"TACAGGTGTTCTTCAT"	"Exclude_hematopoietic"
"TACATTCCACGCACCA"	"LOH, MTAL cell"
"TACATTCGTGTGAATA"	"LOH, MTAL cell"
"TACCCACGTTCCTAGA"	"LOH, MTAL cell"
"TACCCACTCAAGCTGT"	"LOH, MTAL cell"
"TACCCGTCATATCTGG"	"LOH, MTAL cell"
"TACCCGTTCAGATGCT"	"Exclude_hematopoietic"
"TACCGAAAGCTTGTGT"	"Exclude_hematopoietic"
"TACCGAAGTCGAAACG"	"Exclude_hematopoietic"
"TACCGGGAGGTTCAGG"	"Exclude_hematopoietic"
"TACCGGGCATGGGTTT"	"Exclude_hematopoietic"
"TACCGGGTCACCATCC"	"Exclude_hematopoietic"
"TACCGGGTCGCGTGCA"	"Exclude_hematopoietic"
"TACCTCGCAGTTACCA"	"TPC_2"
"TACCTCGGTAGTAAGT"	"Exclude_hematopoietic"
"TACCTCGGTGAGTAGC"	"Exclude_hematopoietic"
"TACCTGCGTAGTCGTT"	"Exclude_hematopoietic"
"TACGCTCAGTTTCGGT"	"Exclude_hematopoietic"
"TACGCTCCAAGTGCAG"	"Exclude_hematopoietic"
"TACGCTCCATTGGGAG"	"Exclude_hematopoietic"
"TACGCTCGTCACTGAT"	"TPC_2"
"TACGGGCCATTGTCGA"	"Exclude_hematopoietic"
"TACGGGCTCATTGCTT"	"Exclude_hematopoietic"
"TACGGGCTCCTGGGAC"	"Exclude_endothelial"
"TACGGGCTCTGCATAG"	"Exclude_endothelial"
"TACGGTACAAATCGTC"	"Exclude_hematopoietic"
"TACGGTATCCGCAACG"	"LOH, MTAL cell"
"TACGTCCAGCGCGTTC"	"Exclude_hematopoietic"
"TACGTCCAGGTGCATG"	"LOH, MTAL cell"
"TACGTCCCACTCAAGT"	"Exclude_hematopoietic"
"TACGTCCCAGACTCTA"	"Exclude_hematopoietic"
"TACGTCCCAGAGGACT"	"Exclude_hematopoietic"
"TACGTCCGTAGACTGG"	"Exclude_hematopoietic"
"TACGTCCTCAAGGCTT"	"Exclude_endothelial"
"TACGTCCTCATATGGC"	"Exclude_hematopoietic"
"TACTGCCAGCGTGTTT"	"LOH, MTAL cell"
"TACTGCCGTCACTTCC"	"LOH, MTAL cell"
"TACTGCCTCTTCCTAA"	"LOH, MTAL cell"
"TACTTACAGATTGAGT"	"Exclude_hematopoietic"
"TACTTACAGCCTCTTC"	"LOH, MTAL cell"
"TACTTACCATGGCGCT"	"Exclude_hematopoietic"
"TACTTACTCAACTGGT"	"Exclude_hematopoietic"
"TACTTACTCTAAGGAA"	"Exclude_hematopoietic"
"TACTTCAAGGCCTTCG"	"TPC_2"
"TACTTCAAGTCTTCGA"	"LOH, MTAL cell"
"TACTTCACATTAGGCT"	"IC-A"
"TACTTCAGTGCAATGG"	"Exclude_hematopoietic"
"TACTTCAGTGGTCAAG"	"LOH, MTAL cell"
"TACTTCATCGTGCAGC"	"Exclude_hematopoietic"
"TACTTCATCTCGGTCT"	"TPC_1"
"TACTTCATCTGTCCGT"	"Exclude_hematopoietic"
"TACTTGTAGAGGGTAA"	"LOH, MTAL cell"
"TACTTGTAGGTCCGAA"	"Exclude_hematopoietic"
"TACTTGTCATCGATGT"	"LOH, MTAL cell"
"TACTTGTCATGAAGGC"	"LOH, MTAL cell"
"TACTTGTGTACTGCCG"	"Exclude_hematopoietic"
"TACTTGTTCCAGCACG"	"TPC_2"
"TAGACCAAGCCATGCC"	"Exclude_hematopoietic"
"TAGACCACAAGCCATT"	"Exclude_endothelial"
"TAGACCACAAGTGGCA"	"Exclude_hematopoietic"
"TAGACCAGTCGAAGCA"	"Exclude_hematopoietic"
"TAGACCATCACCGGGT"	"Exclude_hematopoietic"
"TAGACTGGTACGTACT"	"LOH, MTAL cell"
"TAGACTGGTTACCCTC"	"Exclude_hematopoietic"
"TAGACTGGTTGCGAAG"	"Exclude_hematopoietic"
"TAGATCGCAATTCTTC"	"LOH, MTAL cell"
"TAGATCGTCCGTGTCT"	"Exclude_hematopoietic"
"TAGATCGTCCTTACCG"	"Exclude_hematopoietic"
"TAGATCGTCGCTTTAT"	"Exclude_hematopoietic"
"TAGCACAAGAGCAGTC"	"Exclude_hematopoietic"
"TAGCACAAGTGCAGCA"	"LOH, MTAL cell"
"TAGCACACAGACACCC"	"Exclude_hematopoietic"
"TAGCACACATCATGAC"	"Exclude_hematopoietic"
"TAGGAGGCAGGATCTT"	"Exclude_hematopoietic"
"TAGGAGGGTGCCTAAT"	"Exclude_hematopoietic"
"TAGGGTTAGAGAGCCT"	"Exclude_hematopoietic"
"TAGGGTTAGGGCAGAG"	"LOH, MTAL cell"
"TAGGGTTCAGCCATTA"	"Exclude_hematopoietic"
"TAGGGTTGTGCCCTTT"	"Exclude_hematopoietic"
"TAGGGTTTCATCCCGT"	"Exclude_hematopoietic"
"TAGGGTTTCTATCACT"	"IC-A"
"TAGGTACGTAGACTGG"	"Exclude_hematopoietic"
"TAGGTTGAGTAAATGC"	"Exclude_hematopoietic"
"TAGGTTGCATGGGATG"	"Exclude_hematopoietic"
"TAGGTTGGTGGATCAG"	"Exclude_hematopoietic"
"TAGGTTGGTGTTCCAA"	"TPC_1"
"TAGGTTGTCCGCTGTT"	"Exclude_endothelial"
"TAGGTTGTCTTCGTAT"	"Exclude_hematopoietic"
"TAGTGCAAGAGAGGTA"	"Exclude_hematopoietic"
"TAGTGCACACGTGAGA"	"Exclude_hematopoietic"
"TAGTGCAGTACACGCC"	"TPC_1"
"TATACCTAGGGCAGGA"	"Exclude_hematopoietic"
"TATACCTAGTTGCTCA"	"Exclude_hematopoietic"
"TATACCTGTTTCCCAC"	"Exclude_hematopoietic"
"TATACCTTCGATACAC"	"Exclude_hematopoietic"
"TATACCTTCTTTCAGT"	"Exclude_hematopoietic"
"TATATCCAGACTCATC"	"Exclude_hematopoietic"
"TATATCCAGTCACTGT"	"Exclude_hematopoietic"
"TATATCCGTCGGAACA"	"Exclude_hematopoietic"
"TATATCCGTTTGTGGT"	"Exclude_hematopoietic"
"TATATCCTCGAGGCAA"	"Exclude_hematopoietic"
"TATCAGGTCGTCAACA"	"TPC_2"
"TATCCTAAGCCTCACG"	"Exclude_hematopoietic"
"TATCCTACACTATGTG"	"Exclude_hematopoietic"
"TATCCTAGTTATTCTC"	"Exclude_hematopoietic"
"TATCCTATCCTCGATC"	"TPC_2"
"TATCGCCAGCATTGTC"	"Exclude_hematopoietic"
"TATCGCCCAAGAATAC"	"Exclude_hematopoietic"
"TATCGCCCAGACCAAG"	"Exclude_hematopoietic"
"TATCGCCTCCTCACGT"	"TPC_1"
"TATCTGTCAAACACGG"	"Exclude_hematopoietic"
"TATCTGTCAAATGGCG"	"Exclude_hematopoietic"
"TATCTGTGTTCTAAGC"	"Exclude_hematopoietic"
"TATCTGTTCCAACCAA"	"Exclude_hematopoietic"
"TATCTGTTCTCGCTCA"	"Exclude_hematopoietic"
"TATCTGTTCTTCGTAT"	"Exclude_hematopoietic"
"TATCTTGCAGAGTAAT"	"Exclude_hematopoietic"
"TATCTTGGTGCATGTT"	"Exclude_hematopoietic"
"TATGTTCCACATTCTT"	"Exclude_hematopoietic"
"TATGTTCGTGAGACCA"	"Exclude_hematopoietic"
"TATGTTCTCTCGCTTG"	"Exclude_hematopoietic"
"TATTCCAAGATAGTCA"	"Exclude_hematopoietic"
"TATTCCAAGGTTCCAT"	"Exclude_hematopoietic"
"TATTCCAGTCACTGAT"	"Exclude_hematopoietic"
"TATTCCATCTGCCTCA"	"TPC_1"
"TATTGCTCAAGCGGAT"	"TPC_1"
"TATTGCTTCTTCTGGC"	"Exclude_hematopoietic"
"TATTTCGAGCTGAGTG"	"Exclude_hematopoietic"
"TATTTCGCAAGATGGC"	"Exclude_hematopoietic"
"TATTTCGGTCGGTAAG"	"Exclude_hematopoietic"
"TATTTCGGTCTGTGCG"	"TPC_1"
"TATTTCGGTGCCGTAC"	"Exclude_hematopoietic"
"TCAAGACCATTGACTG"	"Exclude_hematopoietic"
"TCAAGTGAGTACCATC"	"TPC_1"
"TCAAGTGCAGCAGGAT"	"Exclude_hematopoietic"
"TCAATCTCATCTATCT"	"LOH, MTAL cell"
"TCAATCTCATGAATCC"	"LOH, MTAL cell"
"TCAATTCAGGGCCAAT"	"LOH, MTAL cell"
"TCAATTCTCCAGGACC"	"LOH, MTAL cell"
"TCAATTCTCTTTCCAA"	"TPC_2"
"TCACAAGAGCTAGCCC"	"Exclude_hematopoietic"
"TCACAAGAGGTGTGAC"	"Exclude_hematopoietic"
"TCACAAGCACTCGATA"	"Exclude_hematopoietic"
"TCACAAGGTAACAGGC"	"Exclude_hematopoietic"
"TCACAAGTCGCTGCGA"	"Exclude_hematopoietic"
"TCACACCCATCAGCAT"	"Exclude_hematopoietic"
"TCACACCTCGTGCTCT"	"Exclude_hematopoietic"
"TCACATTCAGCATCTA"	"LOH, MTAL cell"
"TCACATTGTACCTAGT"	"Exclude_hematopoietic"
"TCACATTTCGCACGAC"	"Exclude_hematopoietic"
"TCACGCTAGGAGATAG"	"LOH, MTAL cell"
"TCACGCTCAGTCTTCC"	"Exclude_hematopoietic"
"TCACGCTTCGGCAGTC"	"Exclude_hematopoietic"
"TCACGGGAGCCATATC"	"Exclude_hematopoietic"
"TCACGGGAGGCTTTCA"	"Exclude_hematopoietic"
"TCACGGGAGTATTAGG"	"Exclude_hematopoietic"
"TCACGGGCATCAGCGC"	"Exclude_hematopoietic"
"TCACGGGGTCAGTCTA"	"Exclude_hematopoietic"
"TCACTATCAACCCTCT"	"LOH, MTAL cell"
"TCACTATGTAATGATG"	"Exclude_endothelial"
"TCACTCGAGATGCTTC"	"Exclude_hematopoietic"
"TCACTCGCAACCAGAG"	"Exclude_hematopoietic"
"TCACTCGCAATTCTTC"	"Exclude_hematopoietic"
"TCACTCGCACCACATA"	"Exclude_hematopoietic"
"TCACTCGGTAGGGAGG"	"Exclude_hematopoietic"
"TCACTCGGTCACGTGC"	"Exclude_hematopoietic"
"TCACTCGTCATCGTAG"	"Exclude_hematopoietic"
"TCACTCGTCCCTAGGG"	"Exclude_hematopoietic"
"TCAGCAAAGGCCTTGC"	"Exclude_hematopoietic"
"TCAGCAAGTCTTCATT"	"Exclude_hematopoietic"
"TCAGCAAGTTAACCTG"	"Exclude_hematopoietic"
"TCAGCAATCTGTGCTC"	"Exclude_hematopoietic"
"TCAGCCTAGAGATCGC"	"Exclude_hematopoietic"
"TCAGCCTAGATGCCGA"	"Exclude_hematopoietic"
"TCAGCCTAGGTACATA"	"Exclude_hematopoietic"
"TCAGCCTAGGTTCCAT"	"Exclude_hematopoietic"
"TCAGCCTCATAATCGC"	"Exclude_hematopoietic"
"TCAGCCTGTGGAATGC"	"LOH, MTAL cell"
"TCAGCCTTCGCATAGT"	"Exclude_hematopoietic"
"TCAGGGCAGATCACCT"	"TPC_1"
"TCAGGGCCACGTGTGC"	"Exclude_hematopoietic"
"TCAGGGCGTAGAGGAA"	"LOH, MTAL cell"
"TCAGGGCGTTTCGTAG"	"LOH, MTAL cell"
"TCAGGTAAGCCTATTG"	"Exclude_hematopoietic"
"TCAGGTAAGGCTTCCG"	"LOH, MTAL cell"
"TCAGGTAGTTAGGACG"	"Exclude_hematopoietic"
"TCAGGTATCGGTCTGG"	"Exclude_hematopoietic"
"TCAGTCCCAACCCGCA"	"Exclude_hematopoietic"
"TCAGTCCCAACGATCT"	"Exclude_hematopoietic"
"TCAGTCCCAGCGAACA"	"Exclude_hematopoietic"
"TCAGTCCCATCATTGG"	"Exclude_hematopoietic"
"TCAGTCCGTCACCGCA"	"LOH, MTAL cell"
"TCAGTCCGTGTCATGT"	"Exclude_hematopoietic"
"TCAGTCCGTTGCCGCA"	"TPC_2"
"TCAGTCCGTTGGTAGG"	"Exclude_hematopoietic"
"TCAGTGAGTCAGGTAG"	"TPC_2"
"TCAGTTTAGCCTATTG"	"Exclude_hematopoietic"
"TCAGTTTAGCGAGAAA"	"Exclude_hematopoietic"
"TCAGTTTAGGCTGTAG"	"Exclude_hematopoietic"
"TCAGTTTAGTGGAAGA"	"TPC_2"
"TCAGTTTGTATCATGC"	"Exclude_hematopoietic"
"TCATACTAGGCTGGAT"	"Exclude_hematopoietic"
"TCATACTCATGGCCCA"	"LOH, MTAL cell"
"TCATACTGTGACAGGT"	"TPC_2"
"TCATATCAGATCCGAG"	"PEC"
"TCATATCCAGTAACAA"	"Exclude_hematopoietic"
"TCATATCGTCGTTATG"	"Exclude_hematopoietic"
"TCATATCTCGGACTGC"	"Exclude_hematopoietic"
"TCATCATAGGGATCGT"	"Exclude_hematopoietic"
"TCATCATCACTCGATA"	"Exclude_hematopoietic"
"TCATCATGTTGGCCGT"	"Exclude_hematopoietic"
"TCATCATTCAAGAAAC"	"Exclude_hematopoietic"
"TCATCCGAGCGCCCAT"	"Exclude_hematopoietic"
"TCATCCGAGCGCTGAA"	"Exclude_hematopoietic"
"TCATCCGCACAATGCT"	"Exclude_hematopoietic"
"TCATCCGTCCGATAAC"	"Exclude_hematopoietic"
"TCATGAGGTTGCCATA"	"TPC_2"
"TCATGCCTCTGTGCGG"	"Exclude_hematopoietic"
"TCATGGAGTCGCCTAG"	"LOH, MTAL cell"
"TCATGTTAGCTCTTCC"	"Exclude_hematopoietic"
"TCATGTTAGGATCACG"	"TPC_2"
"TCATGTTCACGAAAGC"	"Exclude_hematopoietic"
"TCATGTTGTGTTGAGG"	"Exclude_hematopoietic"
"TCATGTTTCCGGCAGT"	"LOH, MTAL cell"
"TCATTACAGAGCGACT"	"LOH, MTAL cell"
"TCATTACAGGCTAACG"	"TPC_1"
"TCATTACCACGTCATA"	"Exclude_hematopoietic"
"TCATTACCATGAGAAT"	"Exclude_hematopoietic"
"TCATTACGTCTGTGAT"	"Exclude_hematopoietic"
"TCATTACTCAATCCAG"	"Exclude_hematopoietic"
"TCATTGTCAATGTCAC"	"Exclude_hematopoietic"
"TCATTGTTCTACAGGT"	"LOH, MTAL cell"
"TCATTGTTCTCGTTTA"	"Exclude_hematopoietic"
"TCCACCAGTCGAGCAA"	"Exclude_hematopoietic"
"TCCACCATCCTCTAAT"	"Exclude_hematopoietic"
"TCCACCATCGATACGT"	"Exclude_hematopoietic"
"TCCACCATCTTAAGGC"	"Exclude_hematopoietic"
"TCCACGTAGACATAAC"	"Exclude_hematopoietic"
"TCCACGTCAACCGTGC"	"Exclude_hematopoietic"
"TCCACGTCATACTTTC"	"Exclude_hematopoietic"
"TCCACGTCATCTGCGG"	"Exclude_hematopoietic"
"TCCACGTGTCCTTGTC"	"Exclude_hematopoietic"
"TCCAGAAAGGCCTGAA"	"Exclude_hematopoietic"
"TCCAGAAAGTCGAATA"	"LOH, MTAL cell"
"TCCAGAACAAATGCTC"	"Exclude_hematopoietic"
"TCCAGAACAAGTGCAG"	"Exclude_hematopoietic"
"TCCAGAAGTATTCCTT"	"LOH, MTAL cell"
"TCCAGAAGTTTAGTCG"	"Exclude_hematopoietic"
"TCCATCGAGAATCTAG"	"Exclude_hematopoietic"
"TCCATCGAGAGGTTTA"	"Exclude_hematopoietic"
"TCCATCGAGTATGATG"	"Exclude_hematopoietic"
"TCCATCGGTCATGCAT"	"TPC_1"
"TCCATCGTCAGCGGAA"	"Exclude_hematopoietic"
"TCCATCGTCCCGTGTT"	"Exclude_hematopoietic"
"TCCATCGTCCTCACCA"	"Exclude_hematopoietic"
"TCCATCGTCCTCGCAT"	"Exclude_hematopoietic"
"TCCATGCAGGAACGTC"	"Exclude_hematopoietic"
"TCCATGCCAAAGAACT"	"Exclude_endothelial"
"TCCATGCCACACAGCC"	"Exclude_hematopoietic"
"TCCATGCGTATCGAAA"	"Exclude_hematopoietic"
"TCCATGCTCGTAGGGA"	"Exclude_hematopoietic"
"TCCATGCTCGTGTCAA"	"TPC_1"
"TCCCACAAGAGTGGCT"	"Exclude_hematopoietic"
"TCCCACAAGTATTGCC"	"Exclude_hematopoietic"
"TCCCACATCACCTTAT"	"Exclude_hematopoietic"
"TCCCACATCTATTGTC"	"Exclude_hematopoietic"
"TCCCAGTAGTCACTGT"	"Exclude_hematopoietic"
"TCCCAGTCAGCTGCCA"	"Exclude_hematopoietic"
"TCCCAGTTCGATACAC"	"Exclude_hematopoietic"
"TCCCATGAGGACAGCT"	"Exclude_hematopoietic"
"TCCCATGGTGTGCCTG"	"Exclude_hematopoietic"
"TCCCATGTCCGGCAGT"	"LOH, MTAL cell"
"TCCCATGTCGTCCTCA"	"Exclude_hematopoietic"
"TCCGAAAAGAATTCAG"	"PEC"
"TCCGAAATCAGACATC"	"Exclude_hematopoietic"
"TCCGAAATCCAAGCCG"	"TPC_1"
"TCCGAAATCGACATAC"	"Exclude_hematopoietic"
"TCCGAAATCTACACAG"	"Exclude_hematopoietic"
"TCCGATCGTGCAAGAC"	"Exclude_hematopoietic"
"TCCGGGAAGGTCATTC"	"Exclude_hematopoietic"
"TCCGGGACATCGTCCT"	"Exclude_hematopoietic"
"TCCGGGAGTTCTCACC"	"Exclude_hematopoietic"
"TCCGTGTTCAATGTCG"	"Exclude_hematopoietic"
"TCCGTGTTCCACAAGT"	"Exclude_hematopoietic"
"TCCTAATCAGCACGAA"	"Exclude_hematopoietic"
"TCCTAATCATTGTGCA"	"LOH, MTAL cell"
"TCCTAATGTCATTCCC"	"Exclude_hematopoietic"
"TCCTAATTCATTTCCA"	"TPC_1"
"TCCTAATTCGCTTACC"	"TPC_1"
"TCCTCCCCACCATATG"	"Exclude_hematopoietic"
"TCCTCCCCACGATTCA"	"TPC_2"
"TCCTCCCGTGCCGGTT"	"Exclude_hematopoietic"
"TCCTCCCGTTCGGTAT"	"Exclude_hematopoietic"
"TCCTCCCTCCGTGTAA"	"Exclude_hematopoietic"
"TCCTCCCTCGATTCCC"	"Exclude_hematopoietic"
"TCCTCGAAGCCTATCA"	"Exclude_hematopoietic"
"TCCTCGAGTGATGAAT"	"Exclude_hematopoietic"
"TCCTCTTAGCCTTCTC"	"Exclude_hematopoietic"
"TCCTCTTAGGAGTCTG"	"LOH, MTAL cell"
"TCCTCTTCAATACGCT"	"LOH, MTAL cell"
"TCCTCTTCACCATATG"	"LOH, MTAL cell"
"TCCTCTTCATATCTCT"	"Exclude_hematopoietic"
"TCCTGCACAACTGAAA"	"LOH, MTAL cell"
"TCCTGCACAGACCAGA"	"LOH, MTAL cell"
"TCCTGCAGTTGAGTCT"	"Exclude_hematopoietic"
"TCCTTCTAGACGACGT"	"Exclude_hematopoietic"
"TCCTTTCCACATGACT"	"TPC_1"
"TCCTTTCCAGCTGCCA"	"Exclude_hematopoietic"
"TCGAACAAGCGTGTCC"	"Exclude_hematopoietic"
"TCGAACAAGGAGCAAA"	"Exclude_hematopoietic"
"TCGAACATCACCTGGG"	"Exclude_hematopoietic"
"TCGAACATCAGCAATC"	"Exclude_hematopoietic"
"TCGAACATCTGTGCTC"	"TPC_2"
"TCGAAGTAGCATGCAG"	"PEC"
"TCGAAGTCACCAAAGG"	"LOH, MTAL cell"
"TCGAAGTCATCGCTGG"	"Exclude_hematopoietic"
"TCGACCTAGGCTATCT"	"Exclude_hematopoietic"
"TCGACCTAGTCACAGG"	"Exclude_hematopoietic"
"TCGACCTCATAACTCG"	"Exclude_hematopoietic"
"TCGACCTGTCAGGCAA"	"Exclude_hematopoietic"
"TCGACCTGTCGTGATT"	"LOH, MTAL cell"
"TCGACCTGTGGCTTAT"	"Exclude_hematopoietic"
"TCGACGGCAACCAGAG"	"TPC_1"
"TCGACGGCAACGTATC"	"Exclude_hematopoietic"
"TCGACGGCAAGGCGTA"	"Exclude_hematopoietic"
"TCGACGGTCTAGACAC"	"LOH, MTAL cell"
"TCGATTTAGTAAACGT"	"LOH, MTAL cell"
"TCGATTTAGTGTAGTA"	"Exclude_hematopoietic"
"TCGATTTGTTGGTAGG"	"Exclude_hematopoietic"
"TCGATTTTCAGGGATG"	"Exclude_hematopoietic"
"TCGATTTTCCGTTGGG"	"LOH, MTAL cell"
"TCGCACTAGCAACCAG"	"Exclude_hematopoietic"
"TCGCACTAGCAAGGAA"	"LOH, MTAL cell"
"TCGCACTCACTGCATA"	"TPC_2"
"TCGCACTCATGCCATA"	"Exclude_hematopoietic"
"TCGCACTGTACTCGAT"	"Exclude_hematopoietic"
"TCGCACTTCACCTGGG"	"Exclude_hematopoietic"
"TCGCACTTCTCTGAGA"	"TPC_1"
"TCGCAGGAGACAAGCC"	"Exclude_hematopoietic"
"TCGCAGGAGCTAAATG"	"Exclude_hematopoietic"
"TCGCAGGAGGCGAAGG"	"Exclude_hematopoietic"
"TCGCAGGCAGCAGTTT"	"Exclude_hematopoietic"
"TCGCAGGGTGGTCTTA"	"Exclude_hematopoietic"
"TCGCAGGTCCGATGTA"	"Exclude_hematopoietic"
"TCGCAGGTCCGCTGTT"	"Exclude_hematopoietic"
"TCGCAGGTCGCGGACT"	"Exclude_hematopoietic"
"TCGCAGGTCTCATTTG"	"Exclude_hematopoietic"
"TCGCAGGTCTTGGAAC"	"Exclude_hematopoietic"
"TCGCTCAAGTTGGGAC"	"Exclude_hematopoietic"
"TCGCTCACAAGCAGGT"	"LOH, MTAL cell"
"TCGCTCACAGCAGTGA"	"Exclude_hematopoietic"
"TCGCTCATCACCGGTG"	"Exclude_hematopoietic"
"TCGCTCATCATGAAAG"	"Exclude_hematopoietic"
"TCGCTCATCCGTCACT"	"Exclude_hematopoietic"
"TCGCTTGCAGCAGATG"	"TPC_1"
"TCGCTTGGTCGCGTTG"	"IC-A"
"TCGGATACACTCCGGA"	"Exclude_hematopoietic"
"TCGGATACATCGCTCT"	"Exclude_hematopoietic"
"TCGGATAGTCCTGAAT"	"PEC"
"TCGGATAGTCTAGTGT"	"Exclude_hematopoietic"
"TCGGGACAGGGCCAAT"	"Exclude_hematopoietic"
"TCGGGACGTCTCCTGT"	"Exclude_hematopoietic"
"TCGGGACTCTACGCGG"	"Exclude_hematopoietic"
"TCGGGCACAACGGTAG"	"Exclude_hematopoietic"
"TCGGGCATCACTTGTT"	"Exclude_hematopoietic"
"TCGGGTGCAAGCTGTT"	"Exclude_hematopoietic"
"TCGGGTGTCCAGTTCC"	"LOH, MTAL cell"
"TCGGTCTCACATTCTT"	"Exclude_endothelial"
"TCGGTCTCACCTCGTT"	"Exclude_hematopoietic"
"TCGGTCTGTTGAGTCT"	"Exclude_hematopoietic"
"TCGGTCTGTTTGTTCT"	"Exclude_hematopoietic"
"TCGGTCTTCCACAAGT"	"Exclude_hematopoietic"
"TCGTAGAAGGCCTAAG"	"Exclude_hematopoietic"
"TCGTAGACAGGCTATT"	"Exclude_hematopoietic"
"TCGTAGAGTCCAAGAG"	"Exclude_hematopoietic"
"TCGTAGATCATGGATC"	"Exclude_hematopoietic"
"TCGTAGATCGACCAAT"	"Exclude_hematopoietic"
"TCGTCCAAGTGTACCT"	"Exclude_hematopoietic"
"TCGTCCACACTGCATA"	"Exclude_hematopoietic"
"TCGTCCACAGGTGTGA"	"Exclude_hematopoietic"
"TCGTCCACATGGTACT"	"TPC_2"
"TCGTCCAGTCTACAAC"	"Exclude_hematopoietic"
"TCGTCCATCACTACGA"	"Exclude_hematopoietic"
"TCGTCCATCAGTCAGT"	"Exclude_hematopoietic"
"TCGTCCATCATTGTTC"	"TPC_2"
"TCGTGCTAGTGCCAGA"	"Exclude_hematopoietic"
"TCGTGCTCACCCTTGT"	"Exclude_hematopoietic"
"TCGTGGGAGCCATTCA"	"Exclude_hematopoietic"
"TCGTGGGAGTAGACCG"	"TPC_2"
"TCGTGGGCAATTGCAC"	"Exclude_hematopoietic"
"TCGTGGGTCACTGAAC"	"Exclude_hematopoietic"
"TCTAACTAGACGATAT"	"Exclude_hematopoietic"
"TCTAACTCAGGCTACC"	"Exclude_hematopoietic"
"TCTAACTGTAAGACCG"	"Exclude_hematopoietic"
"TCTAACTGTAGTTCCA"	"Exclude_hematopoietic"
"TCTAACTGTATGGAAT"	"Exclude_hematopoietic"
"TCTAACTGTCATACCA"	"Exclude_hematopoietic"
"TCTAACTGTCTGTCAA"	"Exclude_hematopoietic"
"TCTACATAGCTTACGT"	"Exclude_hematopoietic"
"TCTACATCAACCGTAT"	"Exclude_hematopoietic"
"TCTACATCAGCAGACA"	"LOH, MTAL cell"
"TCTACATGTGAATATG"	"TPC_2"
"TCTACCGAGAATAACC"	"Exclude_hematopoietic"
"TCTACCGAGATGCTAA"	"Exclude_hematopoietic"
"TCTACCGCATCGTTCC"	"Exclude_hematopoietic"
"TCTACCGGTGAAGCTG"	"TPC_2"
"TCTATACAGAATAGTC"	"Exclude_hematopoietic"
"TCTATACAGCTTTCCC"	"Exclude_hematopoietic"
"TCTATACAGGAGTACC"	"Exclude_hematopoietic"
"TCTATACCACACAGAG"	"TPC_1"
"TCTATACCACTTGGCG"	"Exclude_hematopoietic"
"TCTATACGTATACCTG"	"Exclude_hematopoietic"
"TCTATACTCATGCGGC"	"TPC_2"
"TCTATACTCATTGCCC"	"Exclude_hematopoietic"
"TCTATACTCGGTGCAC"	"Exclude_hematopoietic"
"TCTATACTCGTGACTA"	"Exclude_hematopoietic"
"TCTATCAGTTTCGCTC"	"Exclude_hematopoietic"
"TCTCACGAGCTTAGTC"	"Exclude_hematopoietic"
"TCTCACGAGGAGGCAG"	"Exclude_endothelial"
"TCTCACGAGGGAGGCA"	"LOH, MTAL cell"
"TCTCACGAGTCTGCAT"	"TPC_2"
"TCTCACGCACTGATTG"	"LOH, MTAL cell"
"TCTCACGGTACCAATC"	"TPC_2"
"TCTCACGGTAGTACGG"	"Exclude_hematopoietic"
"TCTCACGGTATAGGAT"	"Exclude_hematopoietic"
"TCTCACGGTTCCAGGC"	"Exclude_hematopoietic"
"TCTCAGCAGTCTACCA"	"TPC_2"
"TCTCAGCCAGCCGTTG"	"Exclude_hematopoietic"
"TCTCAGCCAGTCCGTG"	"Exclude_hematopoietic"
"TCTCAGCCAGTTGTCA"	"Exclude_hematopoietic"
"TCTCAGCGTATCGAAA"	"LOH, MTAL cell"
"TCTCAGCGTCAACACT"	"Exclude_hematopoietic"
"TCTCAGCTCTTGCAGA"	"Exclude_hematopoietic"
"TCTCCGAGTGCTGCAC"	"Exclude_hematopoietic"
"TCTCCGAGTTAGGCTT"	"Exclude_hematopoietic"
"TCTCCGATCTCAGAAC"	"LOH, MTAL cell"
"TCTCTGGAGACTAAGT"	"Exclude_hematopoietic"
"TCTCTGGAGCGTATGG"	"Exclude_hematopoietic"
"TCTCTGGAGGCATCGA"	"Exclude_hematopoietic"
"TCTCTGGCAAATCAGA"	"Exclude_hematopoietic"
"TCTCTGGCAGGGAATC"	"LOH, MTAL cell"
"TCTCTGGTCCTAGCGG"	"Exclude_hematopoietic"
"TCTGCCAAGCAGATAT"	"Exclude_hematopoietic"
"TCTGCCACAACCGACC"	"Exclude_hematopoietic"
"TCTGCCACAGCACGAA"	"LOH, MTAL cell"
"TCTGGCTCAAAGACGC"	"LOH, MTAL cell"
"TCTGGCTCAAATGCGG"	"Exclude_hematopoietic"
"TCTGGCTCAGGCAATG"	"LOH, MTAL cell"
"TCTGGCTGTGTGCTTA"	"LOH, MTAL cell"
"TCTGTCGAGATGAATC"	"Exclude_hematopoietic"
"TCTGTCGCAGCTGTTA"	"Exclude_hematopoietic"
"TCTGTCGGTCTTGCTC"	"Exclude_hematopoietic"
"TCTGTCGGTGCTGTCG"	"TPC_2"
"TCTGTCGTCATTATCC"	"Exclude_hematopoietic"
"TCTGTCGTCCCTCTTT"	"TPC_2"
"TCTTAGTAGGGTATAT"	"Exclude_hematopoietic"
"TCTTAGTAGTTAGAAC"	"Exclude_hematopoietic"
"TCTTCCTAGGAACGTC"	"Exclude_hematopoietic"
"TCTTCCTAGGAGTATT"	"Exclude_hematopoietic"
"TCTTCCTCAGGTGTTT"	"Exclude_hematopoietic"
"TCTTCCTGTAGTTACC"	"TPC_1"
"TCTTCCTGTCAATGGG"	"Exclude_hematopoietic"
"TCTTCCTTCGCAATGT"	"Exclude_hematopoietic"
"TCTTGCGCATCGAGCC"	"Exclude_hematopoietic"
"TCTTGCGGTACCAATC"	"TPC_2"
"TCTTGCGGTTCTCCTG"	"Exclude_hematopoietic"
"TCTTGCGTCGCAGATT"	"Exclude_hematopoietic"
"TCTTTGAAGGCGATAC"	"Exclude_hematopoietic"
"TCTTTGACACACGCCA"	"Exclude_hematopoietic"
"TCTTTGAGTCGACTTA"	"Exclude_hematopoietic"
"TCTTTGAGTCTACGTA"	"Exclude_hematopoietic"
"TCTTTGATCGGAGTGA"	"Exclude_hematopoietic"
"TGAACGTAGGCAATGC"	"Exclude_hematopoietic"
"TGAACGTTCTATCGCC"	"Exclude_hematopoietic"
"TGAATCGAGACTACGG"	"LOH, MTAL cell"
"TGAATCGAGCCTTTGA"	"LOH, MTAL cell"
"TGAATCGCACAGCCTG"	"Exclude_hematopoietic"
"TGAATCGCAGGAATCG"	"Exclude_hematopoietic"
"TGAATCGTCACTTGTT"	"Exclude_hematopoietic"
"TGAATGCGTGGACCTC"	"Exclude_hematopoietic"
"TGAATGCTCGGTCTGG"	"Exclude_hematopoietic"
"TGACAGTAGACCATTC"	"TPC_2"
"TGACAGTCAGGCTTGC"	"LOH, MTAL cell"
"TGACAGTCATCAGCTA"	"Exclude_endothelial"
"TGACAGTTCATCACAG"	"Exclude_hematopoietic"
"TGACCCTAGAGAGTGA"	"Exclude_hematopoietic"
"TGACCCTAGCTAAATG"	"Exclude_hematopoietic"
"TGACCCTAGCTCCGAC"	"Exclude_hematopoietic"
"TGACCCTAGTTCCTGA"	"Exclude_hematopoietic"
"TGACCCTAGTTGCCCG"	"Exclude_hematopoietic"
"TGACCCTCATGGAATA"	"Exclude_hematopoietic"
"TGACCCTGTGTCCTAA"	"Exclude_hematopoietic"
"TGACCCTGTTAACCTG"	"Exclude_hematopoietic"
"TGACGCGCAATCGAAA"	"Exclude_hematopoietic"
"TGACGCGCAGGAGGAG"	"LOH, MTAL cell"
"TGACGCGTCACTCCGT"	"TPC_2"
"TGACTCCAGACATAGT"	"Exclude_hematopoietic"
"TGACTCCGTATAATGG"	"Exclude_hematopoietic"
"TGACTCCGTCTGATAC"	"TPC_2"
"TGAGACTAGCAGGGAG"	"LOH, MTAL cell"
"TGAGACTAGCCTCTGG"	"TPC_2"
"TGAGACTAGGAACATT"	"Exclude_hematopoietic"
"TGAGACTAGTACAGCG"	"Exclude_hematopoietic"
"TGAGACTCATAGGAGC"	"TPC_2"
"TGAGCATCAAGCTCTA"	"LOH, MTAL cell"
"TGAGCATCATATCTGG"	"Exclude_hematopoietic"
"TGAGCATCATTACGGT"	"Exclude_hematopoietic"
"TGAGCATTCAAGCCGC"	"Exclude_hematopoietic"
"TGAGCGCGTAGCGTAG"	"Exclude_hematopoietic"
"TGAGCGCTCAAGCGTT"	"Exclude_hematopoietic"
"TGAGGAGCAAATACGA"	"TPC_1"
"TGAGGGAAGTGAGCCA"	"Exclude_hematopoietic"
"TGAGGTTAGCGTCTGC"	"Exclude_hematopoietic"
"TGAGGTTAGGGATCTG"	"Exclude_hematopoietic"
"TGAGGTTCAACATACC"	"Exclude_endothelial"
"TGAGGTTGTCCTTGTC"	"Exclude_hematopoietic"
"TGAGTCACATTGCAAC"	"Exclude_hematopoietic"
"TGAGTCAGTCTGTGGC"	"Exclude_hematopoietic"
"TGAGTCATCCTGCTAC"	"Exclude_hematopoietic"
"TGAGTCATCTTGAGCA"	"Exclude_hematopoietic"
"TGATCAGCAGCAGGAT"	"Exclude_hematopoietic"
"TGATCAGTCCCTTGTG"	"Exclude_hematopoietic"
"TGATCTTAGACGGTCA"	"Exclude_hematopoietic"
"TGATCTTAGCCTTTGA"	"LOH, MTAL cell"
"TGATCTTAGTTGAAGT"	"Exclude_hematopoietic"
"TGATCTTGTTGCACGC"	"LOH, MTAL cell"
"TGATCTTTCACCTGTC"	"Exclude_hematopoietic"
"TGATGCACACGTCATA"	"Exclude_hematopoietic"
"TGATGCATCCGACGGT"	"IC-A"
"TGATGGTAGTGGTTAA"	"Exclude_hematopoietic"
"TGATGGTCAAGTCCCG"	"TPC_1"
"TGATGGTTCAAATAGG"	"LOH, MTAL cell"
"TGATTCTCAACCACGC"	"Exclude_hematopoietic"
"TGATTCTCAGTGTATC"	"Exclude_hematopoietic"
"TGATTTCGTGCGGATA"	"Exclude_hematopoietic"
"TGATTTCGTGTCCTAA"	"Exclude_hematopoietic"
"TGATTTCGTTCCGCGA"	"Exclude_hematopoietic"
"TGATTTCTCAATCGGT"	"LOH, MTAL cell"
"TGCACGGAGATCCTAC"	"Exclude_hematopoietic"
"TGCACGGTCAGACCTA"	"Exclude_hematopoietic"
"TGCACGGTCCTGCTAC"	"Exclude_hematopoietic"
"TGCAGATAGACATAAC"	"Exclude_endothelial"
"TGCAGATAGTCACTAC"	"Exclude_hematopoietic"
"TGCAGATCAATTGAAG"	"Exclude_hematopoietic"
"TGCAGATCAGTCAGCC"	"Exclude_hematopoietic"
"TGCAGATTCGCGATCG"	"Exclude_hematopoietic"
"TGCAGGCCAAAGACGC"	"Exclude_hematopoietic"
"TGCAGGCGTCGAATGG"	"Exclude_hematopoietic"
"TGCAGTAAGCATTTCG"	"Exclude_hematopoietic"
"TGCAGTAAGGGTGAGG"	"Exclude_hematopoietic"
"TGCAGTAAGTAGCTCT"	"TPC_2"
"TGCAGTACAACTCGTA"	"Exclude_hematopoietic"
"TGCAGTATCGCACTCT"	"LOH, MTAL cell"
"TGCATCCGTAGAGGAA"	"LOH, MTAL cell"
"TGCATCCTCGGACTGC"	"Exclude_hematopoietic"
"TGCATGAAGAGCATAT"	"Exclude_hematopoietic"
"TGCATGAAGAGTTGCG"	"Exclude_hematopoietic"
"TGCATGAAGCCTTGAT"	"Exclude_hematopoietic"
"TGCATGATCAGGCGAA"	"Exclude_hematopoietic"
"TGCATGATCGAGTACT"	"Exclude_hematopoietic"
"TGCCGAGGTCGTGATT"	"Exclude_hematopoietic"
"TGCCGAGGTTGAAGTA"	"Exclude_hematopoietic"
"TGCGACGAGTCGAGGT"	"Exclude_hematopoietic"
"TGCGACGCACAACGTT"	"Exclude_hematopoietic"
"TGCGACGCATCTGTTT"	"Exclude_hematopoietic"
"TGCGATAAGACTCTTG"	"Exclude_hematopoietic"
"TGCGATAAGATACAGT"	"Exclude_hematopoietic"
"TGCGATAAGTGTAGTA"	"Exclude_hematopoietic"
"TGCGATAGTCCTATAG"	"TPC_1"
"TGCGATAGTCGTTGGC"	"Exclude_hematopoietic"
"TGCGGCACACGCACCA"	"Exclude_hematopoietic"
"TGCGGCACACGGCGTT"	"Exclude_hematopoietic"
"TGCGGCACAGTAGAGC"	"Exclude_hematopoietic"
"TGCGGGTGTATAGGAT"	"Exclude_hematopoietic"
"TGCGGGTGTGCAAGAC"	"Exclude_hematopoietic"
"TGCGGGTTCAATCTTC"	"LOH, MTAL cell"
"TGCGGGTTCCTGGCTT"	"TPC_1"
"TGCGGGTTCGTGACTA"	"Exclude_hematopoietic"
"TGCTCCAAGAGAGTTT"	"Exclude_hematopoietic"
"TGCTCCAAGCTATCCA"	"LOH, MTAL cell"
"TGCTCCAAGCTCGGCT"	"Exclude_hematopoietic"
"TGCTCCACAAAGTATG"	"Exclude_hematopoietic"
"TGCTCCACACATGTTG"	"Exclude_hematopoietic"
"TGCTCCAGTCAAGGCA"	"Exclude_hematopoietic"
"TGCTCGTCACGCTGCA"	"Exclude_hematopoietic"
"TGCTCGTCACTGGACC"	"Exclude_hematopoietic"
"TGCTCGTGTATTTCCT"	"Exclude_hematopoietic"
"TGCTCGTGTGAGATTA"	"TPC_1"
"TGCTGAAAGCTGACCC"	"Exclude_hematopoietic"
"TGCTGAAAGTTTCAGC"	"LOH, MTAL cell"
"TGCTTCGCAAGACGAC"	"TPC_2"
"TGCTTCGTCGGCTGAC"	"Exclude_hematopoietic"
"TGCTTGCGTCGTAATC"	"Exclude_hematopoietic"
"TGCTTGCTCTCACCCA"	"Exclude_hematopoietic"
"TGCTTGCTCTCGCCTA"	"Exclude_hematopoietic"
"TGGAACTAGGCTAAAT"	"Exclude_hematopoietic"
"TGGAACTAGTACGAGC"	"TPC_2"
"TGGAACTCAAATTGGA"	"Exclude_hematopoietic"
"TGGAACTTCACGGGCT"	"Exclude_hematopoietic"
"TGGAACTTCATGACAC"	"Exclude_endothelial"
"TGGAGAGAGACATATG"	"Exclude_hematopoietic"
"TGGAGAGCATGTTCAG"	"Exclude_hematopoietic"
"TGGAGAGGTGTATACC"	"Exclude_endothelial"
"TGGAGAGTCCTGTAAG"	"Exclude_hematopoietic"
"TGGAGGACAGACTGCC"	"Exclude_hematopoietic"
"TGGAGGACAGTAGAGC"	"Exclude_hematopoietic"
"TGGAGGAGTAGAGCTG"	"LOH, MTAL cell"
"TGGATCAAGAAGTGTT"	"Exclude_endothelial"
"TGGATCAAGGAACGTC"	"LOH, MTAL cell"
"TGGATCACACTATCCC"	"LOH, MTAL cell"
"TGGATCACACTGCGTG"	"Exclude_hematopoietic"
"TGGATGTAGACCACGA"	"Exclude_hematopoietic"
"TGGATGTAGGTTAGTA"	"Exclude_hematopoietic"
"TGGATGTCATATCTCT"	"Exclude_hematopoietic"
"TGGATGTGTCTGTGTA"	"Exclude_hematopoietic"
"TGGATGTGTTGGAGAC"	"Exclude_hematopoietic"
"TGGATGTTCACCGGGT"	"Exclude_hematopoietic"
"TGGATGTTCTCCTGTG"	"Exclude_hematopoietic"
"TGGCGTGAGTTAACGA"	"Exclude_hematopoietic"
"TGGCGTGGTTTAGAGA"	"Exclude_hematopoietic"
"TGGCGTGTCGGTCGAC"	"Exclude_hematopoietic"
"TGGGAAGAGAATGTTG"	"Exclude_hematopoietic"
"TGGGAAGAGAGTCAGC"	"Exclude_hematopoietic"
"TGGGAAGCATAGTCAC"	"Exclude_hematopoietic"
"TGGGAAGTCTGTTCAT"	"Exclude_hematopoietic"
"TGGGAGAGTTCGGCCA"	"Exclude_hematopoietic"
"TGGGATTCAAGTCCAT"	"IC-A"
"TGGGATTGTACTCCGG"	"Exclude_hematopoietic"
"TGGGATTGTCCTTAAG"	"Exclude_hematopoietic"
"TGGGATTGTTTACTTC"	"Exclude_hematopoietic"
"TGGGCGTAGAGTCACG"	"TPC_2"
"TGGGCTGCACGGCCAT"	"LOH, MTAL cell"
"TGGGCTGTCAAACGAA"	"Exclude_hematopoietic"
"TGGGTTAAGTTTCAGC"	"LOH, MTAL cell"
"TGGGTTACATCATTTC"	"Exclude_hematopoietic"
"TGGGTTAGTAGACTGG"	"Exclude_hematopoietic"
"TGGGTTATCACGTAGT"	"Exclude_hematopoietic"
"TGGGTTATCACTTGGA"	"Exclude_hematopoietic"
"TGGGTTATCATAAGGA"	"Exclude_hematopoietic"
"TGGTACAAGACTCCGC"	"Exclude_hematopoietic"
"TGGTACAAGTCGTTAC"	"Exclude_hematopoietic"
"TGGTACAGTAGGTTTC"	"Exclude_hematopoietic"
"TGGTACAGTTGAGAGC"	"Exclude_hematopoietic"
"TGGTACATCGGTGTTA"	"LOH, MTAL cell"
"TGGTAGTGTAAGAACT"	"Exclude_hematopoietic"
"TGGTAGTTCTCACTCG"	"Exclude_hematopoietic"
"TGGTGATAGAGAGTGA"	"Exclude_hematopoietic"
"TGGTGATGTCTCGGAC"	"Exclude_hematopoietic"
"TGGTGATTCCCGGTAG"	"Exclude_hematopoietic"
"TGGTGATTCGGATACT"	"Exclude_hematopoietic"
"TGGTTAGCACAGAGAC"	"Exclude_hematopoietic"
"TGGTTAGTCGAACCAT"	"Exclude_hematopoietic"
"TGTAACGCATCAGCGC"	"Exclude_hematopoietic"
"TGTAACGGTAGCACGA"	"Exclude_hematopoietic"
"TGTAACGGTAGTCACT"	"Exclude_hematopoietic"
"TGTAACGGTTACACTG"	"Exclude_hematopoietic"
"TGTAACGTCTGTCTCG"	"Exclude_hematopoietic"
"TGTAAGCAGTAAGCAT"	"Exclude_endothelial"
"TGTAAGCCAAGTTCCA"	"Exclude_hematopoietic"
"TGTACAGAGGCCACTC"	"Exclude_hematopoietic"
"TGTACAGAGTGTAGTA"	"LOH, MTAL cell"
"TGTACAGCAAACAGGC"	"Exclude_endothelial"
"TGTACAGCATCTAGAC"	"Exclude_hematopoietic"
"TGTACAGTCAGAGTTC"	"Exclude_hematopoietic"
"TGTACAGTCAGCTGTA"	"Exclude_hematopoietic"
"TGTACAGTCCAGCCTT"	"Exclude_hematopoietic"
"TGTAGACAGGGCAGAG"	"Exclude_endothelial"
"TGTCAGACATGCTGCG"	"Exclude_hematopoietic"
"TGTCAGAGTACATACC"	"Exclude_hematopoietic"
"TGTCAGAGTGCATACT"	"Exclude_hematopoietic"
"TGTCAGAGTGCCGTAC"	"Exclude_hematopoietic"
"TGTCAGAGTGCCTGAC"	"Exclude_hematopoietic"
"TGTCCACGTAGTTAGA"	"LOH, MTAL cell"
"TGTCCCAAGACATAAC"	"LOH, MTAL cell"
"TGTCCCAAGGATTTCC"	"LOH, MTAL cell"
"TGTCCCACAGAAGCGT"	"TPC_1"
"TGTCCTGAGTCATTGC"	"Exclude_hematopoietic"
"TGTCCTGGTACCTTCC"	"Exclude_hematopoietic"
"TGTCCTGGTGGCTCTG"	"Exclude_hematopoietic"
"TGTCCTGTCGAAGTGG"	"Exclude_hematopoietic"
"TGTGAGTAGTTGCTGT"	"TPC_1"
"TGTGAGTCACGGTAGA"	"Exclude_hematopoietic"
"TGTGAGTGTCTTCCGT"	"Exclude_hematopoietic"
"TGTGAGTTCAAGAGTA"	"Exclude_hematopoietic"
"TGTGAGTTCGACCACG"	"Exclude_hematopoietic"
"TGTGAGTTCTTTGATC"	"Exclude_hematopoietic"
"TGTGATGAGTCTAACC"	"Exclude_hematopoietic"
"TGTGATGCACAGTCCG"	"Exclude_hematopoietic"
"TGTGATGGTAAGGTCG"	"Exclude_hematopoietic"
"TGTGATGTCCCGGTAG"	"Exclude_hematopoietic"
"TGTGCGGAGAGACAAG"	"LOH, MTAL cell"
"TGTGCGGAGGATACGC"	"Exclude_hematopoietic"
"TGTGCGGAGTCCCGAC"	"TPC_2"
"TGTGCGGGTAACCCGC"	"LOH, MTAL cell"
"TGTGCGGGTAACGATA"	"Exclude_hematopoietic"
"TGTGCGGGTAGGACTG"	"Exclude_hematopoietic"
"TGTGCGGGTCAAACGG"	"Exclude_hematopoietic"
"TGTGCGGTCACCATCC"	"Exclude_endothelial"
"TGTGGCGAGCAAATCA"	"Exclude_hematopoietic"
"TGTGGCGCATTAAGCC"	"TPC_1"
"TGTGGCGTCCATAGAC"	"Exclude_hematopoietic"
"TGTGGCGTCCTCGATC"	"Exclude_hematopoietic"
"TGTGTGAAGAAGCCTG"	"Exclude_hematopoietic"
"TGTGTGACAGTTCCAA"	"Exclude_hematopoietic"
"TGTTACTCAAGAATAC"	"TPC_1"
"TGTTACTCACGTACAT"	"Exclude_endothelial"
"TGTTACTCACTACACA"	"Exclude_hematopoietic"
"TGTTACTGTCAAGTTC"	"Exclude_hematopoietic"
"TGTTACTGTGTGTCCG"	"Exclude_hematopoietic"
"TGTTCATGTGTCCCTT"	"Exclude_endothelial"
"TGTTCATGTTAATCGC"	"Exclude_hematopoietic"
"TGTTCATTCATAAGGA"	"LOH, MTAL cell"
"TGTTCATTCCGTTGGG"	"Exclude_hematopoietic"
"TGTTCCGCAGATAAAC"	"Exclude_hematopoietic"
"TGTTCCGGTTCCCACT"	"Exclude_hematopoietic"
"TGTTCCGTCGTCCTCA"	"Exclude_hematopoietic"
"TGTTCTAAGGCCCGTT"	"LOH, MTAL cell"
"TGTTCTACAGAAGTTA"	"LOH, MTAL cell"
"TGTTCTACATGACTCA"	"IC-A"
"TGTTCTAGTATGTCAC"	"Exclude_hematopoietic"
"TGTTCTAGTCCTGTTC"	"Exclude_hematopoietic"
"TGTTCTAGTCGCATGC"	"Exclude_hematopoietic"
"TGTTGAGAGACTCAAA"	"LOH, MTAL cell"
"TGTTGAGAGTAGTCAA"	"TPC_1"
"TGTTGAGCATATACCG"	"Exclude_endothelial"
"TGTTGAGCATGACACT"	"Exclude_hematopoietic"
"TGTTGAGTCCCGTTCA"	"Exclude_hematopoietic"
"TGTTGGAGTTCAGCTA"	"Exclude_hematopoietic"
"TGTTGGAGTTGCATGT"	"TPC_2"
"TGTTTGTAGCGCATCC"	"Exclude_hematopoietic"
"TGTTTGTCAACAGAGC"	"Exclude_hematopoietic"
"TGTTTGTCAGTGCGCT"	"Exclude_hematopoietic"
"TGTTTGTGTACACTCA"	"LOH, MTAL cell"
"TGTTTGTGTCTTCCGT"	"LOH, MTAL cell"
"TGTTTGTTCTTACACT"	"Exclude_hematopoietic"
"TTAATCCAGAGGATCC"	"Exclude_hematopoietic"
"TTAATCCCAGGTCAAG"	"LOH, MTAL cell"
"TTAATCCGTGGTTTAC"	"Exclude_hematopoietic"
"TTAATCCGTTCTCCTG"	"Exclude_hematopoietic"
"TTACAGGAGATGCTTC"	"TPC_2"
"TTACAGGGTCCACTCT"	"Exclude_hematopoietic"
"TTACAGGGTTTACTTC"	"Exclude_hematopoietic"
"TTACAGGTCGAACCTA"	"Exclude_hematopoietic"
"TTACCATGTGCAGTGA"	"Exclude_hematopoietic"
"TTACCGCTCTTCCTAA"	"Exclude_hematopoietic"
"TTACGCCAGGAGACCT"	"TPC_2"
"TTACGCCGTGAGACGT"	"Exclude_hematopoietic"
"TTACGTTAGTTGCGAG"	"Exclude_hematopoietic"
"TTACGTTGTCAAATCC"	"TPC_2"
"TTACGTTTCAAGCCGC"	"Exclude_hematopoietic"
"TTACGTTTCTCTTGCG"	"Exclude_hematopoietic"
"TTACTGTAGAGGTTTA"	"LOH, MTAL cell"
"TTAGGCACAAATTGGA"	"Exclude_hematopoietic"
"TTAGGCACATTGGGAG"	"Exclude_hematopoietic"
"TTAGGCAGTCCTGGTG"	"Exclude_hematopoietic"
"TTAGGCAGTTGTCTAG"	"LOH, MTAL cell"
"TTAGGCATCCTACGGG"	"TPC_2"
"TTAGGCATCGACCATA"	"TPC_2"
"TTAGGCATCGTCAACA"	"Exclude_hematopoietic"
"TTAGGGTAGCCAACCC"	"Exclude_hematopoietic"
"TTAGGGTAGCCTGAAG"	"LOH, MTAL cell"
"TTAGGGTTCAGCTTCC"	"Exclude_hematopoietic"
"TTAGTCTAGATTGGGC"	"Exclude_hematopoietic"
"TTAGTCTTCTTCGGAA"	"TPC_2"
"TTATTGCCAAGCGGAT"	"Exclude_hematopoietic"
"TTATTGCGTTGCATGT"	"Exclude_hematopoietic"
"TTATTGCTCAAGTGTC"	"Exclude_hematopoietic"
"TTATTGCTCACCTTGC"	"Exclude_hematopoietic"
"TTCAATCAGGTAAACT"	"Exclude_hematopoietic"
"TTCAATCAGTTTCGAC"	"Exclude_hematopoietic"
"TTCAATCCATAGAATG"	"Exclude_hematopoietic"
"TTCACCGAGGCTGGAT"	"Exclude_hematopoietic"
"TTCACCGTCATCCTAT"	"Exclude_hematopoietic"
"TTCACCGTCCGCTAGG"	"Exclude_hematopoietic"
"TTCACCGTCGCCTTTG"	"Exclude_hematopoietic"
"TTCACGCAGCACTTTG"	"LOH, MTAL cell"
"TTCAGGAAGGTACTGG"	"TPC_1"
"TTCAGGACATTCACAG"	"LOH, MTAL cell"
"TTCAGGAGTAGTGCGA"	"Exclude_hematopoietic"
"TTCAGGAGTGACGCCT"	"LOH, MTAL cell"
"TTCATGTGTAAGATCA"	"Exclude_hematopoietic"
"TTCATGTGTCTAGGTT"	"Exclude_hematopoietic"
"TTCATGTTCCTTGGAA"	"Exclude_hematopoietic"
"TTCATTGAGGCATGGT"	"LOH, MTAL cell"
"TTCATTGCAATAGGGC"	"Exclude_hematopoietic"
"TTCATTGCACGATTCA"	"Exclude_hematopoietic"
"TTCCAATAGACTCTAC"	"Exclude_hematopoietic"
"TTCCAATGTGCGTCGT"	"Exclude_hematopoietic"
"TTCCAATGTTAGTTCG"	"LOH, MTAL cell"
"TTCCAATGTTCCAAAC"	"Exclude_hematopoietic"
"TTCCAATTCGAATCCA"	"Exclude_hematopoietic"
"TTCCAATTCTGGTTGA"	"Exclude_hematopoietic"
"TTCCACGAGAAACTAC"	"Exclude_hematopoietic"
"TTCCACGGTCCTCAGG"	"TPC_1"
"TTCCACGGTGATAGAT"	"Exclude_hematopoietic"
"TTCCGGTAGTAGATCA"	"Exclude_hematopoietic"
"TTCCGGTCAGAACCGA"	"Exclude_hematopoietic"
"TTCCGGTCAGGAATCG"	"Exclude_hematopoietic"
"TTCCGGTCAGTAACCT"	"Exclude_hematopoietic"
"TTCCGGTGTAGCGAGT"	"Exclude_hematopoietic"
"TTCCGGTTCCATCGTC"	"TPC_2"
"TTCCGGTTCCGCAAAT"	"LOH, MTAL cell"
"TTCCGGTTCCTCAGAA"	"Exclude_hematopoietic"
"TTCCGGTTCGTGCGAC"	"Exclude_hematopoietic"
"TTCCGTGAGCGGGTAT"	"Exclude_hematopoietic"
"TTCCGTGCACACGGTC"	"Exclude_hematopoietic"
"TTCCGTGTCGCTTGCT"	"Exclude_hematopoietic"
"TTCCGTGTCTCGAACA"	"Exclude_hematopoietic"
"TTCCTAACAGGCATTT"	"Exclude_hematopoietic"
"TTCCTAATCAAGAAAC"	"Exclude_hematopoietic"
"TTCCTCTAGCCACTCG"	"Exclude_hematopoietic"
"TTCCTCTAGCGTTCCG"	"Exclude_hematopoietic"
"TTCCTCTGTTTCGATG"	"Exclude_hematopoietic"
"TTCCTCTTCGGAAGGT"	"LOH, MTAL cell"
"TTCCTCTTCTGCTGAA"	"Exclude_endothelial"
"TTCCTTCAGAAGGCTC"	"Exclude_hematopoietic"
"TTCCTTCCAATAAGGT"	"Exclude_hematopoietic"
"TTCCTTCCACCAAAGG"	"Exclude_hematopoietic"
"TTCCTTCGTAAGTTGA"	"Exclude_hematopoietic"
"TTCCTTCGTAATTAGG"	"Exclude_hematopoietic"
"TTCGATTGTGAGCAGT"	"Exclude_hematopoietic"
"TTCGATTTCAAAGGTA"	"Exclude_hematopoietic"
"TTCGCTGCAATAGAGT"	"Exclude_hematopoietic"
"TTCGCTGCACGACGAA"	"Exclude_hematopoietic"
"TTCGGTCAGCTGTACT"	"LOH, MTAL cell"
"TTCGGTCGTAACTTCG"	"Exclude_endothelial"
"TTCGGTCTCGAACCAT"	"LOH, MTAL cell"
"TTCTAACAGACTTCCA"	"Exclude_hematopoietic"
"TTCTAACCAGAGTAAT"	"Exclude_hematopoietic"
"TTCTAACGTAGCGTCC"	"Exclude_hematopoietic"
"TTCTAACTCCTGGGTG"	"TPC_1"
"TTCTAACTCGACCATA"	"Exclude_hematopoietic"
"TTCTAACTCGGCCCAA"	"Exclude_hematopoietic"
"TTCTAACTCTGAGAGG"	"Exclude_hematopoietic"
"TTCTAGTAGCGGACAT"	"Exclude_hematopoietic"
"TTCTAGTGTCGAATGG"	"Exclude_hematopoietic"
"TTCTAGTGTCGCATGC"	"Exclude_hematopoietic"
"TTCTAGTGTTCATCTT"	"IC-A"
"TTCTCTCGTCATATGC"	"Exclude_hematopoietic"
"TTCTCTCGTCCGGATC"	"Exclude_hematopoietic"
"TTCTCTCTCGCAGTGC"	"Exclude_hematopoietic"
"TTCTGTAAGATACATG"	"LOH, MTAL cell"
"TTCTGTAAGTACGTCT"	"Exclude_hematopoietic"
"TTCTGTACACACCTAA"	"PEC"
"TTCTGTAGTTCGGTCG"	"TPC_1"
"TTCTTCCAGTATAGGT"	"Exclude_hematopoietic"
"TTCTTCCGTCATCCGG"	"Exclude_hematopoietic"
"TTCTTCCTCATAGCAC"	"Exclude_hematopoietic"
"TTCTTGACAATGGCCC"	"Exclude_hematopoietic"
"TTCTTGACACAGTACT"	"Exclude_hematopoietic"
"TTCTTGAGTGAATAAC"	"Exclude_hematopoietic"
"TTCTTGAGTGAGACGT"	"Exclude_hematopoietic"
"TTCTTGATCAATGTCG"	"Exclude_hematopoietic"
"TTCTTGATCTGTGCAA"	"Exclude_hematopoietic"
"TTGAACGAGGTGGTTG"	"Exclude_hematopoietic"
"TTGAACGCAGCGGTTC"	"Exclude_hematopoietic"
"TTGAACGGTCCCGCAA"	"Exclude_hematopoietic"
"TTGAACGTCACAAGGG"	"IC-A"
"TTGAACGTCATCGGGC"	"Exclude_hematopoietic"
"TTGAACGTCTAGAGCT"	"Exclude_hematopoietic"
"TTGACCCAGACCATAA"	"Exclude_endothelial"
"TTGACCCAGAGCTTTC"	"Exclude_hematopoietic"
"TTGACCCCAGACCAGA"	"Exclude_hematopoietic"
"TTGACCCTCTAGCAAC"	"Exclude_hematopoietic"
"TTGAGTGCAGTTGTTG"	"Exclude_hematopoietic"
"TTGAGTGTCCCAGTGG"	"Exclude_hematopoietic"
"TTGATGGTCCGGTAGC"	"LOH, MTAL cell"
"TTGCATTCATGGGAAC"	"LOH, MTAL cell"
"TTGCATTGTCCACTCT"	"LOH, MTAL cell"
"TTGCCTGCACCGTCTT"	"Exclude_hematopoietic"
"TTGCCTGCAGAATTCC"	"Exclude_hematopoietic"
"TTGCCTGCAGTATTCG"	"Exclude_hematopoietic"
"TTGCCTGGTAGCTCGC"	"LOH, MTAL cell"
"TTGCCTGTCCTTCACG"	"Exclude_endothelial"
"TTGCGTCAGGCCCAAA"	"Exclude_hematopoietic"
"TTGCGTCAGTTGCGCC"	"Exclude_hematopoietic"
"TTGCGTCCACATGTTG"	"Exclude_hematopoietic"
"TTGCGTCGTTCTGACA"	"Exclude_hematopoietic"
"TTGCTGCAGGTAAGTT"	"Exclude_hematopoietic"
"TTGCTGCTCCACTTCG"	"LOH, MTAL cell"
"TTGCTGCTCTGAGGCC"	"Exclude_hematopoietic"
"TTGGATGCAAACTAGA"	"TPC_1"
"TTGGATGCACAACATC"	"Exclude_hematopoietic"
"TTGGATGGTTCGCGTG"	"Exclude_hematopoietic"
"TTGGATGTCCGCTAGG"	"TPC_1"
"TTGGATGTCGACGCGT"	"Exclude_hematopoietic"
"TTGGATGTCGGTAACT"	"Exclude_hematopoietic"
"TTGGGATAGGGACACT"	"LOH, MTAL cell"
"TTGGGATGTCCTGTTC"	"Exclude_hematopoietic"
"TTGGGATGTTGAGTCT"	"Exclude_hematopoietic"
"TTGGGATTCGTCTAAG"	"Exclude_hematopoietic"
"TTGGGATTCTCGCAGG"	"Exclude_hematopoietic"
"TTGGGCGGTAGCCAGA"	"Exclude_hematopoietic"
"TTGGGCGGTGAAAGTT"	"Exclude_hematopoietic"
"TTGGGCGGTGAATAAC"	"Exclude_hematopoietic"
"TTGGGTACATAGTCAC"	"Exclude_hematopoietic"
"TTGGGTAGTGAACTAA"	"Exclude_hematopoietic"
"TTGGGTATCTAGAGCT"	"Exclude_hematopoietic"
"TTGGGTATCTTCGCTG"	"Exclude_hematopoietic"
"TTGGTTTCACGCAAAG"	"Exclude_hematopoietic"
"TTGGTTTCATGGAGAC"	"Exclude_hematopoietic"
"TTGGTTTGTACCTTCC"	"Exclude_hematopoietic"
"TTGGTTTGTATCTCTT"	"Exclude_hematopoietic"
"TTGGTTTGTGTCGATT"	"Exclude_hematopoietic"
"TTGGTTTTCGCATGAT"	"Exclude_hematopoietic"
"TTGGTTTTCTTGATTC"	"Exclude_hematopoietic"
"TTGTGGACAAGCACCC"	"Exclude_hematopoietic"
"TTGTGGACACCCAACG"	"Exclude_hematopoietic"
"TTGTGGAGTCGGCTAC"	"TPC_2"
"TTGTGGAGTGAACTAA"	"Exclude_hematopoietic"
"TTGTGGATCGTGGGAA"	"Exclude_hematopoietic"
"TTGTGGATCTGCTTTA"	"Exclude_hematopoietic"
"TTGTGTTAGCTAATGA"	"Exclude_hematopoietic"
"TTGTGTTGTGACAGCA"	"LOH, MTAL cell"
"TTGTGTTGTGTCTCCT"	"LOH, MTAL cell"
"TTGTTCAAGCTCTTCC"	"Exclude_hematopoietic"
"TTGTTCAGTCTCAAGT"	"LOH, MTAL cell"
"TTGTTCATCCGCTAGG"	"Exclude_hematopoietic"
"TTGTTGTAGGTTACCT"	"Exclude_hematopoietic"
"TTGTTGTCAAACGGCA"	"Exclude_hematopoietic"
"TTGTTGTCAAGACCGA"	"TPC_1"
"TTGTTGTCAGGACTAG"	"Exclude_hematopoietic"
"TTGTTGTGTCTTCTAT"	"Exclude_hematopoietic"
"TTGTTTGAGGTGAGCT"	"Exclude_hematopoietic"
"TTGTTTGGTATAGGGC"	"Exclude_hematopoietic"
"TTGTTTGTCACGACTA"	"Exclude_hematopoietic"
"TTGTTTGTCATAGACC"	"Exclude_hematopoietic"
"TTTACCACACGACCTG"	"Exclude_hematopoietic"
"TTTACCACAGCTTCGG"	"Exclude_hematopoietic"
"TTTACCAGTAAGTTGA"	"Exclude_hematopoietic"
"TTTACCATCGCGTCGA"	"PEC"
"TTTACGTCAATTCTTC"	"Exclude_hematopoietic"
"TTTACGTCATCAGCTA"	"Exclude_hematopoietic"
"TTTACGTGTTCTCTAT"	"Exclude_hematopoietic"
"TTTACGTGTTTGGGAG"	"Exclude_hematopoietic"
"TTTACGTTCGGAACTT"	"Exclude_hematopoietic"
"TTTACGTTCGTCAACA"	"Exclude_hematopoietic"
"TTTACTGGTGTATACC"	"Exclude_hematopoietic"
"TTTACTGTCAAGATAG"	"Exclude_hematopoietic"
"TTTACTGTCAGCGTCG"	"TPC_1"
"TTTAGTCTCACTACTT"	"Exclude_hematopoietic"
"TTTATGCAGTAGTCAA"	"Exclude_hematopoietic"
"TTTATGCAGTGGATAT"	"Exclude_hematopoietic"
"TTTCACACACGCGCAT"	"Exclude_hematopoietic"
"TTTCACACAGGAGGTT"	"Exclude_hematopoietic"
"TTTCAGTCACGGCGTT"	"Exclude_hematopoietic"
"TTTCAGTTCACCTCAC"	"Exclude_hematopoietic"
"TTTCATGAGGCAATGC"	"LOH, MTAL cell"
"TTTCATGAGGCGATAC"	"Exclude_hematopoietic"
"TTTCATGTCACTCTTA"	"Exclude_hematopoietic"
"TTTCCTCCAACTGGTT"	"Exclude_hematopoietic"
"TTTCCTCCACATCATG"	"PEC"
"TTTCCTCCAGAATGTA"	"Exclude_hematopoietic"
"TTTCCTCCAGTTGTTG"	"Exclude_hematopoietic"
"TTTCCTCTCGTGCGAC"	"LOH, MTAL cell"
"TTTCGATAGCGAAACC"	"Exclude_hematopoietic"
"TTTCGATCATCCGAGC"	"IC-A"
"TTTCGATCATCGATGT"	"Exclude_hematopoietic"
"TTTCGATGTGGGATTG"	"Exclude_hematopoietic"
"TTTCGATGTTCGGCGT"	"Exclude_hematopoietic"
"TTTCGATTCATGAAAG"	"Exclude_hematopoietic"
"TTTGACTGTCGTATTG"	"LOH, MTAL cell"
"TTTGACTTCGGTCGAC"	"Exclude_hematopoietic"
"TTTGACTTCGTAGCTA"	"Exclude_hematopoietic"
"TTTGATCAGTCGGCAA"	"TPC_2"
"TTTGATCTCGTGGCTG"	"LOH, MTAL cell"
"TTTGGAGCAACACGTT"	"Exclude_hematopoietic"
"TTTGGAGCAATACGCT"	"Exclude_hematopoietic"
"TTTGGAGCATTAAGCC"	"Exclude_hematopoietic"
"TTTGGAGTCCATTCGC"	"IC-A"
"TTTGGAGTCGCGCCAA"	"TPC_2"
"TTTGGTTAGCGTGAGT"	"Exclude_hematopoietic"
"TTTGGTTAGTATGCAA"	"Exclude_hematopoietic"
"TTTGGTTAGTGTTCCA"	"Exclude_hematopoietic"
"TTTGGTTCAGGTGTGA"	"Exclude_hematopoietic"
"TTTGGTTTCACTCACC"	"TPC_1"
"TTTGTTGAGTGGTTCT"	"IC-A"
"TTTGTTGCATGACTTG"	"LOH, MTAL cell"
"TTTGTTGGTACAAGCG"	"Exclude_endothelial"
"TTTGTTGGTATCCTTT"	"Exclude_hematopoietic"
"TTTGTTGTCAGAGTTC"	"Exclude_hematopoietic"
